,index,0,1,count,count_0,count_1
0,000,1.48790438516857e-05,5.348708166200577e-06,10,7,3
1,005,4.400843956132392e-06,1.8979287041356905e-06,3,2,1
2,01,1.278340387257504e-05,1.8979287041356905e-06,7,6,1
3,02,2.3052039770217305e-06,1.8979287041356905e-06,3,1,2
4,03,4.400843956132392e-06,1.8979287041356905e-06,3,2,1
5,05,8.592123914353715e-06,1.8979287041356905e-06,5,4,1
6,07,6.496483935243052e-06,3.6233184351681345e-06,5,3,2
7,08,6.496483935243052e-06,1.052487735929791e-05,9,3,6
8,09,6.496483935243052e-06,5.348708166200577e-06,6,3,3
9,10,0.0006582405174386592,0.0006540952470343997,777,349,428
10,100,0.0004130506398827114,0.0004625769868897986,506,215,291
11,1000,0.00019929536201342395,0.00015373222503499084,203,102,101
12,10000,0.00014690436253565753,0.0001019705331040174,144,78,66
13,100000,0.00012175668278632962,0.00010714670229711469,137,65,72
14,1000000,2.095639979110664e-07,3.6233184351681345e-06,3,0,3
15,1000yearold,1.278340387257504e-05,3.6233184351681345e-06,8,6,2
16,100K,4.400843956132392e-06,5.348708166200577e-06,5,2,3
17,100M,4.400843956132392e-06,3.6233184351681345e-06,4,2,2
18,100bn,4.400843956132392e-06,1.8979287041356905e-06,3,2,1
19,100km,2.095639979110664e-07,3.6233184351681345e-06,3,0,3
20,100m,1.0687763893464371e-05,7.074097897233022e-06,9,5,4
21,100th,8.592123914353715e-06,1.3975656821362803e-05,12,4,8
22,100year,2.3052039770217305e-06,5.348708166200577e-06,4,1,3
23,100yearold,2.3052039770217305e-06,3.6233184351681345e-06,3,1,2
24,101,1.0687763893464371e-05,1.742643628342769e-05,17,7,10
25,102,6.496483935243052e-06,3.6233184351681345e-06,6,4,2
26,1020,2.095639979110664e-07,3.6233184351681345e-06,3,0,3
27,103,1.0687763893464371e-05,1.3975656821362803e-05,14,5,9
28,1030,2.095639979110664e-07,5.348708166200577e-06,4,1,3
29,104,4.400843956132392e-06,5.348708166200577e-06,6,2,4
30,105,1.6974683830796368e-05,1.9151826014460126e-05,19,8,11
31,106,1.0687763893464371e-05,5.348708166200577e-06,8,5,3
32,107,4.400843956132392e-06,7.074097897233022e-06,6,2,4
33,108,2.3052039770217305e-06,8.79948762826546e-06,8,3,5
34,109,8.592123914353715e-06,8.79948762826546e-06,10,4,6
35,10M,2.3052039770217305e-06,5.348708166200577e-06,4,1,3
36,10YearOld,2.095639979110664e-07,8.79948762826546e-06,6,0,6
37,10bn,2.3052039770217305e-06,5.348708166200577e-06,4,1,3
38,10day,4.400843956132392e-06,1.8979287041356905e-06,3,2,1
39,10m,8.592123914353715e-06,1.3975656821362803e-05,13,4,9
40,10th,1.0687763893464371e-05,2.087721574549256e-05,18,6,12
41,10year,2.116596378901769e-05,7.074097897233022e-06,15,11,4
42,10yearold,6.496483935243052e-06,1.2250267090330355e-05,12,3,9
43,11,0.00022863432172097337,0.0002520794397038401,284,121,163
44,110,1.278340387257504e-05,2.087721574549256e-05,19,6,13
45,1100,8.592123914353715e-06,3.6233184351681345e-06,8,4,4
46,11000,1.9070323809907035e-05,1.052487735929791e-05,16,10,6
47,110000,6.496483935243052e-06,3.6233184351681345e-06,6,4,2
48,111,2.3052039770217305e-06,3.6233184351681345e-06,5,2,3
49,111yearold,4.400843956132392e-06,1.8979287041356905e-06,3,2,1
50,112,1.0687763893464371e-05,1.3975656821362803e-05,15,6,9
51,113,6.496483935243052e-06,5.348708166200577e-06,7,4,3
52,113th,4.400843956132392e-06,1.8979287041356905e-06,3,2,1
53,114,8.592123914353715e-06,5.348708166200577e-06,7,4,3
54,114th,2.3052039770217305e-06,5.348708166200577e-06,4,1,3
55,115,1.278340387257504e-05,1.2250267090330355e-05,13,6,7
56,116,1.9070323809907035e-05,1.3975656821362803e-05,17,9,8
57,117,6.496483935243052e-06,3.6233184351681345e-06,5,3,2
58,119,2.3052039770217305e-06,7.074097897233022e-06,5,1,4
59,11YearOld,4.400843956132392e-06,1.052487735929791e-05,10,3,7
60,11th,1.278340387257504e-05,8.79948762826546e-06,12,6,6
61,11year,4.400843956132392e-06,7.074097897233022e-06,6,2,4
62,11yearold,8.592123914353715e-06,1.052487735929791e-05,11,5,6
63,12,0.0003711378403004983,0.0003141934700210085,382,187,195
64,120,4.212236358012434e-05,3.640572332478458e-05,43,20,23
65,1200,1.9070323809907035e-05,1.570104655239525e-05,22,11,11
66,12000,1.6974683830796368e-05,2.4327995207557487e-05,23,8,15
67,120000,1.9070323809907035e-05,7.074097897233022e-06,13,9,4
68,121,4.400843956132392e-06,8.79948762826546e-06,10,5,5
69,122,1.278340387257504e-05,7.074097897233022e-06,11,7,4
70,123,1.0687763893464371e-05,1.8979287041356905e-06,7,5,2
71,1237,6.496483935243052e-06,1.7253897310324457e-07,4,3,1
72,124,6.496483935243052e-06,1.052487735929791e-05,9,3,6
73,125,2.116596378901769e-05,7.074097897233022e-06,16,10,6
74,125000,4.400843956132392e-06,7.074097897233022e-06,6,2,4
75,126,4.400843956132392e-06,3.6233184351681345e-06,6,3,3
76,127,8.592123914353715e-06,1.2250267090330355e-05,11,4,7
77,128,4.400843956132392e-06,1.8979287041356905e-06,3,2,1
78,129,4.400843956132392e-06,1.052487735929791e-05,8,2,6
79,12YearOld,4.400843956132392e-06,1.052487735929791e-05,8,2,6
80,12bn,2.095639979110664e-07,5.348708166200577e-06,3,0,3
81,12hour,2.3052039770217305e-06,1.8979287041356905e-06,3,1,2
82,12m,4.400843956132392e-06,3.6233184351681345e-06,4,2,2
83,12nation,6.496483935243052e-06,1.7253897310324457e-07,3,3,0
84,12th,8.592123914353715e-06,8.79948762826546e-06,9,4,5
85,12yearold,6.496483935243052e-06,2.087721574549256e-05,15,3,12
86,13,0.00020767792192986646,0.00018651462992460717,220,105,115
87,130,1.0687763893464371e-05,2.2602605476525032e-05,23,7,16
88,1300,1.48790438516857e-05,1.3975656821362803e-05,16,8,8
89,13000,1.278340387257504e-05,1.052487735929791e-05,14,7,7
90,130000,2.326160376812834e-05,1.742643628342769e-05,21,11,10
91,131,2.3052039770217305e-06,5.348708166200577e-06,4,1,3
92,132,2.3052039770217305e-06,3.6233184351681345e-06,3,1,2
93,133,6.496483935243052e-06,7.074097897233022e-06,8,3,5
94,134,2.095639979110664e-07,7.074097897233022e-06,5,0,5
95,135,6.496483935243052e-06,1.742643628342769e-05,13,3,10
96,136,4.400843956132392e-06,3.6233184351681345e-06,4,2,2
97,137,8.592123914353715e-06,5.348708166200577e-06,7,4,3
98,138,1.0687763893464371e-05,5.348708166200577e-06,9,5,4
99,139,2.3052039770217305e-06,3.6233184351681345e-06,6,3,3
100,13YearOld,4.400843956132392e-06,7.074097897233022e-06,7,3,4
101,13bn,8.592123914353715e-06,8.79948762826546e-06,9,4,5
102,13m,2.3052039770217305e-06,5.348708166200577e-06,4,1,3
103,13th,1.6974683830796368e-05,8.79948762826546e-06,14,8,6
104,13year,2.3052039770217305e-06,3.6233184351681345e-06,3,1,2
105,13yearold,1.9070323809907035e-05,2.4327995207557487e-05,24,9,15
106,14,0.0002244430417627521,0.0001951415785797695,244,117,127
107,140,2.116596378901769e-05,2.9504164400654783e-05,35,14,21
108,1400,2.116596378901769e-05,1.2250267090330355e-05,20,11,9
109,14000,1.0687763893464371e-05,5.348708166200577e-06,8,5,3
110,140000,1.0687763893464371e-05,7.074097897233022e-06,9,5,4
111,142,6.496483935243052e-06,1.8979287041356905e-06,4,3,1
112,143,6.496483935243052e-06,5.348708166200577e-06,6,3,3
113,144,2.3052039770217305e-06,3.6233184351681345e-06,3,1,2
114,145,6.496483935243052e-06,8.79948762826546e-06,10,3,7
115,146,2.3052039770217305e-06,5.348708166200577e-06,4,1,3
116,147,4.400843956132392e-06,3.6233184351681345e-06,4,2,2
117,148,8.592123914353715e-06,1.8979287041356905e-06,6,5,1
118,149,4.400843956132392e-06,5.348708166200577e-06,5,2,3
119,14YearOld,4.400843956132392e-06,3.6233184351681345e-06,4,2,2
120,14bn,2.3052039770217305e-06,3.6233184351681345e-06,3,1,2
121,14m,2.3052039770217305e-06,5.348708166200577e-06,4,1,3
122,14th,1.0687763893464371e-05,5.348708166200577e-06,8,5,3
123,14year,2.3052039770217305e-06,3.6233184351681345e-06,4,1,3
124,14yearold,2.326160376812834e-05,2.4327995207557487e-05,29,12,17
125,15,0.00038161604019605166,0.0003728567208761114,449,208,241
126,150,8.403516316233764e-05,7.091351794543343e-05,91,45,46
127,1500,2.7452883726349685e-05,2.087721574549256e-05,29,16,13
128,15000,4.002672360101368e-05,2.2602605476525032e-05,34,20,14
129,150000,2.5357243747239038e-05,2.9504164400654783e-05,31,14,17
130,150m,6.496483935243052e-06,1.8979287041356905e-06,4,3,1
131,1516,2.3052039770217305e-06,3.6233184351681345e-06,3,1,2
132,153,1.0687763893464371e-05,7.074097897233022e-06,10,6,4
133,154,6.496483935243052e-06,7.074097897233022e-06,7,3,4
134,155,8.592123914353715e-06,5.348708166200577e-06,7,4,3
135,156,2.3052039770217305e-06,3.6233184351681345e-06,3,1,2
136,157,2.3052039770217305e-06,5.348708166200577e-06,5,2,3
137,158,6.496483935243052e-06,1.8979287041356905e-06,5,4,1
138,15YearOld,6.496483935243052e-06,1.7253897310324457e-07,3,3,0
139,15billion,4.400843956132392e-06,1.8979287041356905e-06,4,2,2
140,15bn,1.0687763893464371e-05,5.348708166200577e-06,8,5,3
141,15m,2.095639979110664e-07,3.6233184351681345e-06,3,0,3
142,15th,1.48790438516857e-05,1.2250267090330355e-05,15,7,8
143,15yearold,2.5357243747239038e-05,1.570104655239525e-05,23,12,11
144,15yrold,4.400843956132392e-06,1.8979287041356905e-06,3,2,1
145,16,0.00016157384238943198,0.0001951415785797695,220,90,130
146,160,2.326160376812834e-05,1.570104655239525e-05,22,13,9
147,1600,1.278340387257504e-05,1.9151826014460126e-05,18,7,11
148,16000,1.48790438516857e-05,1.570104655239525e-05,20,8,12
149,160000,4.400843956132392e-06,7.074097897233022e-06,7,2,5
150,161,4.400843956132392e-06,7.074097897233022e-06,7,2,5
151,165,1.0687763893464371e-05,7.074097897233022e-06,9,5,4
152,1650,4.400843956132392e-06,1.8979287041356905e-06,3,2,1
153,166,4.400843956132392e-06,1.8979287041356905e-06,3,2,1
154,167,2.3052039770217305e-06,5.348708166200577e-06,4,1,3
155,168,2.3052039770217305e-06,7.074097897233022e-06,5,1,4
156,16YearOld,4.400843956132392e-06,5.348708166200577e-06,5,2,3
157,16th,6.496483935243052e-06,7.074097897233022e-06,7,3,4
158,16yearold,2.116596378901769e-05,1.9151826014460126e-05,24,11,13
159,17,0.0001783389622223174,0.00014337988664879628,186,94,92
160,170,1.0687763893464371e-05,8.79948762826546e-06,13,8,5
161,1700,1.48790438516857e-05,7.074097897233022e-06,11,7,4
162,17000,1.278340387257504e-05,1.2250267090330355e-05,14,6,8
163,170000,4.400843956132392e-06,1.8979287041356905e-06,3,2,1
164,175,1.278340387257504e-05,1.7253897310324457e-07,6,6,0
165,175000,2.3052039770217305e-06,5.348708166200577e-06,4,1,3
166,177,4.400843956132392e-06,1.8979287041356905e-06,3,2,1
167,1776,4.400843956132392e-06,3.6233184351681345e-06,4,2,2
168,178,2.3052039770217305e-06,3.6233184351681345e-06,3,1,2
169,17YearOld,2.095639979110664e-07,7.074097897233022e-06,4,0,4
170,17bn,6.496483935243052e-06,1.7253897310324457e-07,3,3,0
171,17m,4.400843956132392e-06,3.6233184351681345e-06,5,2,3
172,17th,1.48790438516857e-05,1.052487735929791e-05,13,7,6
173,17year,6.496483935243052e-06,1.7253897310324457e-07,4,3,1
174,17yearold,2.116596378901769e-05,8.79948762826546e-06,18,12,6
175,18,0.00020348664197164515,0.00017098612234531542,226,105,121
176,180,1.278340387257504e-05,1.570104655239525e-05,19,8,11
177,1800,1.278340387257504e-05,7.074097897233022e-06,11,6,5
178,18000,6.496483935243052e-06,5.348708166200577e-06,7,4,3
179,180000,4.400843956132392e-06,5.348708166200577e-06,6,2,4
180,182,6.496483935243052e-06,5.348708166200577e-06,7,3,4
181,184,4.400843956132392e-06,3.6233184351681345e-06,4,2,2
182,185,1.0687763893464371e-05,1.570104655239525e-05,15,5,10
183,189,2.3052039770217305e-06,7.074097897233022e-06,5,1,4
184,18bn,2.3052039770217305e-06,1.8979287041356905e-06,3,2,1
185,18th,1.278340387257504e-05,7.074097897233022e-06,10,6,4
186,18yearold,8.592123914353715e-06,2.087721574549256e-05,16,4,12
187,19,0.0001154697628489974,0.0001295767688005365,146,63,83
188,190,2.3052039770217305e-06,1.3975656821362803e-05,10,1,9
189,1900,6.496483935243052e-06,3.6233184351681345e-06,6,3,3
190,19000,2.3052039770217305e-06,3.6233184351681345e-06,3,1,2
191,191,2.095639979110664e-07,5.348708166200577e-06,4,1,3
192,1911,2.3052039770217305e-06,3.6233184351681345e-06,3,1,2
193,1914,2.3052039770217305e-06,8.79948762826546e-06,6,1,5
194,1915,6.496483935243052e-06,1.3975656821362803e-05,11,3,8
195,1917,2.3052039770217305e-06,1.8979287041356905e-06,4,2,2
196,192,2.3052039770217305e-06,5.348708166200577e-06,4,1,3
197,1920,4.400843956132392e-06,8.79948762826546e-06,7,2,5
198,1928,4.400843956132392e-06,3.6233184351681345e-06,4,2,2
199,1929,2.3052039770217305e-06,5.348708166200577e-06,4,1,3
200,1930,1.278340387257504e-05,1.2250267090330355e-05,15,8,7
201,1935,2.3052039770217305e-06,3.6233184351681345e-06,3,1,2
202,1936,2.095639979110664e-07,8.79948762826546e-06,5,0,5
203,1937,8.592123914353715e-06,3.6233184351681345e-06,7,5,2
204,1939,4.400843956132392e-06,3.6233184351681345e-06,4,2,2
205,194,4.400843956132392e-06,3.6233184351681345e-06,4,2,2
206,1940,1.0687763893464371e-05,1.052487735929791e-05,13,7,6
207,1941,4.400843956132392e-06,7.074097897233022e-06,7,3,4
208,1943,2.095639979110664e-07,5.348708166200577e-06,3,0,3
209,1944,1.0687763893464371e-05,8.79948762826546e-06,10,5,5
210,1945,4.400843956132392e-06,1.052487735929791e-05,9,2,7
211,1947,6.496483935243052e-06,1.7253897310324457e-07,4,3,1
212,1948,2.3052039770217305e-06,7.074097897233022e-06,6,2,4
213,1949,4.400843956132392e-06,3.6233184351681345e-06,4,2,2
214,195,8.592123914353715e-06,3.6233184351681345e-06,6,4,2
215,1950,1.9070323809907035e-05,8.79948762826546e-06,15,9,6
216,1953,1.278340387257504e-05,3.6233184351681345e-06,8,6,2
217,1954,2.3052039770217305e-06,5.348708166200577e-06,4,1,3
218,1955,4.400843956132392e-06,1.8979287041356905e-06,3,2,1
219,1956,2.3052039770217305e-06,7.074097897233022e-06,5,1,4
220,1959,4.400843956132392e-06,1.8979287041356905e-06,4,2,2
221,196,8.592123914353715e-06,1.8979287041356905e-06,5,4,1
222,1960,1.9070323809907035e-05,2.777877466962238e-05,28,11,17
223,1961,2.3052039770217305e-06,7.074097897233022e-06,6,2,4
224,1962,6.496483935243052e-06,1.8979287041356905e-06,4,3,1
225,1963,2.3052039770217305e-06,5.348708166200577e-06,4,1,3
226,1964,1.278340387257504e-05,8.79948762826546e-06,12,6,6
227,1965,6.496483935243052e-06,7.074097897233022e-06,7,3,4
228,1966,8.592123914353715e-06,5.348708166200577e-06,7,4,3
229,1967,1.48790438516857e-05,2.2602605476525032e-05,23,8,15
230,1968,1.48790438516857e-05,5.348708166200577e-06,13,8,5
231,1969,4.400843956132392e-06,8.79948762826546e-06,7,2,5
232,1970,3.3739803663681634e-05,3.468033359375216e-05,39,16,23
233,1971,2.3052039770217305e-06,7.074097897233022e-06,5,1,4
234,1972,1.0687763893464371e-05,8.79948762826546e-06,10,5,5
235,1973,8.592123914353715e-06,1.570104655239525e-05,16,6,10
236,1974,2.095639979110664e-07,5.348708166200577e-06,4,0,4
237,1975,1.0687763893464371e-05,7.074097897233022e-06,9,5,4
238,1976,4.400843956132392e-06,5.348708166200577e-06,6,3,3
239,1977,8.592123914353715e-06,3.6233184351681345e-06,7,5,2
240,1978,8.592123914353715e-06,1.8979287041356905e-06,5,4,1
241,1979,2.3052039770217305e-06,1.3975656821362803e-05,12,3,9
242,198,1.0687763893464371e-05,1.7253897310324457e-07,5,5,0
243,1980,2.7452883726349685e-05,5.020884117304414e-05,47,16,31
244,1981,6.496483935243052e-06,3.6233184351681345e-06,5,3,2
245,1982,1.48790438516857e-05,8.79948762826546e-06,12,7,5
246,1983,1.6974683830796368e-05,5.348708166200577e-06,11,8,3
247,1984,1.6974683830796368e-05,1.570104655239525e-05,17,8,9
248,1985,1.6974683830796368e-05,7.074097897233022e-06,12,8,4
249,1986,6.496483935243052e-06,1.570104655239525e-05,12,3,9
250,1987,1.0687763893464371e-05,8.79948762826546e-06,10,5,5
251,1988,6.496483935243052e-06,1.570104655239525e-05,13,4,9
252,1989,1.48790438516857e-05,3.122955413168725e-05,29,9,20
253,1990,2.954852370546031e-05,4.1581892517881935e-05,44,14,30
254,1991,4.400843956132392e-06,1.052487735929791e-05,8,2,6
255,1992,6.496483935243052e-06,1.052487735929791e-05,9,3,6
256,1993,1.48790438516857e-05,1.2250267090330355e-05,14,7,7
257,1994,1.278340387257504e-05,2.4327995207557487e-05,24,9,15
258,1995,1.278340387257504e-05,1.570104655239525e-05,15,6,9
259,1996,1.48790438516857e-05,1.3975656821362803e-05,15,7,8
260,1997,1.9070323809907035e-05,8.79948762826546e-06,16,11,5
261,1998,2.326160376812834e-05,2.6053384938589907e-05,29,13,16
262,1999,6.496483935243052e-06,1.570104655239525e-05,14,3,11
263,19th,1.9070323809907035e-05,8.79948762826546e-06,14,9,5
264,19thcentury,6.496483935243052e-06,1.7253897310324457e-07,4,3,1
265,19yearold,1.278340387257504e-05,7.074097897233022e-06,12,8,4
266,1B,6.496483935243052e-06,1.7253897310324457e-07,4,3,1
267,1M,6.496483935243052e-06,5.348708166200577e-06,7,3,4
268,1billion,4.400843956132392e-06,1.7253897310324457e-07,3,2,1
269,1bn,2.116596378901769e-05,2.4327995207557487e-05,27,12,15
270,1m,1.48790438516857e-05,7.074097897233022e-06,16,11,5
271,1million,2.095639979110664e-07,7.074097897233022e-06,4,0,4
272,1st,0.00010080028299522283,9.161819471782287e-05,107,51,56
273,20,0.00036065964040494494,0.00047120393554496063,502,198,304
274,200,0.00015109564249387862,0.0001571830044970555,182,80,102
275,2000,0.0001259479627445509,0.00010542131256608228,140,67,73
276,20000,5.888748341300963e-05,5.5385010366141504e-05,69,33,36
277,200000,4.6313643538345614e-05,3.8131113055817005e-05,47,23,24
278,2000000,4.400843956132392e-06,3.6233184351681345e-06,4,2,2
279,2000yearold,8.592123914353715e-06,7.074097897233022e-06,8,4,4
280,2001,3.1644163684570994e-05,4.330728224891437e-05,45,17,28
281,2002,2.5357243747239038e-05,2.6053384938589907e-05,32,14,18
282,2003,4.6313643538345614e-05,4.330728224891437e-05,51,23,28
283,2004,3.3739803663681634e-05,2.777877466962238e-05,37,20,17
284,2005,4.212236358012434e-05,4.330728224891437e-05,48,21,27
285,2006,5.888748341300963e-05,6.401195902130366e-05,75,31,44
286,2007,5.260056347567764e-05,7.091351794543343e-05,71,28,43
287,2008,0.00014690436253565753,0.00012612598933847184,154,77,77
288,2009,0.00010918284291166549,0.0001036959228350498,130,58,72
289,200K,4.400843956132392e-06,1.7253897310324457e-07,4,3,1
290,200m,4.400843956132392e-06,1.8979287041356905e-06,4,2,2
291,200yearold,2.3052039770217305e-06,3.6233184351681345e-06,3,1,2
292,201,4.400843956132392e-06,1.8979287041356905e-06,3,2,1
293,2010,0.00016366948236854273,0.00014337988664879628,178,83,95
294,2011,0.0001552869224521,0.00016753534288325053,181,76,105
295,2012,0.00019510408205520246,0.0002400017115866128,261,107,154
296,2013,0.0001385218026192147,0.00014165449691776373,162,73,89
297,2014,0.00022025176180453062,0.0003245458084072032,321,117,204
298,2015,0.0002537820014703013,0.00029693957271068364,326,143,183
299,2016,0.00039838116002893705,0.0004487738690415387,515,217,298
300,2017,0.0001552869224521,0.00017271151207634748,189,79,110
301,2018,0.00010918284291166549,0.0001295767688005365,142,58,84
302,2019,1.48790438516857e-05,3.122955413168725e-05,29,9,20
303,2020,0.0001531912824729893,0.0001589083942280881,181,81,100
304,2021,2.326160376812834e-05,1.2250267090330355e-05,19,12,7
305,2022,4.4218003559234974e-05,5.3659620635109e-05,59,21,38
306,2024,1.278340387257504e-05,1.2250267090330355e-05,16,7,9
307,2025,1.6974683830796368e-05,1.2250267090330355e-05,16,8,8
308,2026,2.095639979110664e-07,5.348708166200577e-06,5,1,4
309,2030,4.4218003559234974e-05,2.9504164400654783e-05,43,21,22
310,2035,2.3052039770217305e-06,7.074097897233022e-06,7,2,5
311,2040,8.592123914353715e-06,1.052487735929791e-05,11,4,7
312,2045,6.496483935243052e-06,1.7253897310324457e-07,3,3,0
313,2050,2.326160376812834e-05,1.570104655239525e-05,23,11,12
314,206,2.3052039770217305e-06,3.6233184351681345e-06,3,1,2
315,2060,2.095639979110664e-07,3.6233184351681345e-06,3,1,2
316,208,2.3052039770217305e-06,1.8979287041356905e-06,3,2,1
317,20Week,8.592123914353715e-06,5.348708166200577e-06,7,4,3
318,20YearOld,2.095639979110664e-07,5.348708166200577e-06,3,0,3
319,20km,2.3052039770217305e-06,8.79948762826546e-06,6,1,5
320,20m,6.496483935243052e-06,1.8979287041356905e-06,4,3,1
321,20percent,2.095639979110664e-07,5.348708166200577e-06,3,0,3
322,20th,3.583544364279237e-05,1.570104655239525e-05,31,20,11
323,20thcentury,2.095639979110664e-07,3.6233184351681345e-06,3,0,3
324,20year,4.400843956132392e-06,1.052487735929791e-05,9,2,7
325,20yearold,1.48790438516857e-05,3.6233184351681345e-06,11,7,4
326,21,0.00012175668278632962,0.00012612598933847184,144,62,82
327,210,2.3052039770217305e-06,5.348708166200577e-06,5,2,3
328,2100,6.496483935243052e-06,1.052487735929791e-05,9,3,6
329,21000,1.278340387257504e-05,3.6233184351681345e-06,9,6,3
330,212,2.3052039770217305e-06,3.6233184351681345e-06,3,1,2
331,214,4.400843956132392e-06,1.8979287041356905e-06,3,2,1
332,215,2.3052039770217305e-06,1.052487735929791e-05,8,1,7
333,216,4.400843956132392e-06,1.8979287041356905e-06,4,2,2
334,218,4.400843956132392e-06,1.8979287041356905e-06,3,2,1
335,21st,3.583544364279237e-05,4.8483451442011706e-05,50,19,31
336,21stcentury,8.592123914353715e-06,1.052487735929791e-05,11,4,7
337,21yearold,6.496483935243052e-06,1.052487735929791e-05,10,3,7
338,22,0.00012385232276544028,0.00011922443041434203,144,64,80
339,220,1.278340387257504e-05,1.052487735929791e-05,12,6,6
340,2200,2.3052039770217305e-06,3.6233184351681345e-06,3,1,2
341,22000,6.496483935243052e-06,5.348708166200577e-06,8,4,4
342,225,6.496483935243052e-06,1.8979287041356905e-06,5,3,2
343,22yearold,8.592123914353715e-06,8.79948762826546e-06,10,4,6
344,23,0.00010289592297433347,0.0001019705331040174,125,55,70
345,230,2.095639979110664e-07,7.074097897233022e-06,5,0,5
346,2300,4.400843956132392e-06,8.79948762826546e-06,7,2,5
347,23000,8.592123914353715e-06,7.074097897233022e-06,8,4,4
348,231,8.592123914353715e-06,1.7253897310324457e-07,4,4,0
349,233,2.3052039770217305e-06,3.6233184351681345e-06,3,1,2
350,234,2.3052039770217305e-06,5.348708166200577e-06,5,2,3
351,235,2.3052039770217305e-06,5.348708166200577e-06,4,1,3
352,235000,2.3052039770217305e-06,3.6233184351681345e-06,3,1,2
353,238,6.496483935243052e-06,1.8979287041356905e-06,5,3,2
354,239,2.3052039770217305e-06,5.348708166200577e-06,5,1,4
355,23rd,6.496483935243052e-06,3.6233184351681345e-06,5,3,2
356,23yearold,6.496483935243052e-06,1.052487735929791e-05,9,3,6
357,23yrold,2.3052039770217305e-06,3.6233184351681345e-06,4,2,2
358,24,0.0001971997220343134,0.00013992910718673112,187,98,89
359,240,6.496483935243052e-06,1.2250267090330355e-05,13,4,9
360,2400,6.496483935243052e-06,1.570104655239525e-05,12,3,9
361,24000,2.3052039770217305e-06,7.074097897233022e-06,5,1,4
362,240000,4.400843956132392e-06,1.7253897310324457e-07,3,2,1
363,241,4.400843956132392e-06,1.7253897310324457e-07,3,2,1
364,244,4.400843956132392e-06,3.6233184351681345e-06,4,2,2
365,247,8.592123914353715e-06,1.3975656821362803e-05,16,7,9
366,248,4.400843956132392e-06,3.6233184351681345e-06,5,2,3
367,249,2.095639979110664e-07,3.6233184351681345e-06,3,1,2
368,24hour,2.095639979110664e-07,8.79948762826546e-06,6,1,5
369,24th,6.496483935243052e-06,1.8979287041356905e-06,5,4,1
370,24year,4.400843956132392e-06,1.8979287041356905e-06,3,2,1
371,24yearold,2.3052039770217305e-06,5.348708166200577e-06,4,1,3
372,25,0.0002181561218254202,0.0002313747629314509,260,118,142
373,250,4.4218003559234974e-05,3.8131113055817005e-05,48,24,24
374,2500,2.326160376812834e-05,1.9151826014460126e-05,22,11,11
375,25000,2.5357243747239038e-05,2.4327995207557487e-05,29,13,16
376,250000,3.1644163684570994e-05,3.468033359375216e-05,42,20,22
377,25m,8.592123914353715e-06,3.6233184351681345e-06,6,4,2
378,25th,1.6974683830796368e-05,1.570104655239525e-05,18,8,10
379,25yearold,4.400843956132392e-06,5.348708166200577e-06,5,2,3
380,26,9.451336305789087e-05,7.954046660059569e-05,100,47,53
381,260,4.400843956132392e-06,1.8979287041356905e-06,4,3,1
382,2600,2.3052039770217305e-06,3.6233184351681345e-06,3,1,2
383,260000,2.3052039770217305e-06,1.8979287041356905e-06,3,2,1
384,2611,2.3052039770217305e-06,3.6233184351681345e-06,3,1,2
385,262,8.592123914353715e-06,1.7253897310324457e-07,4,4,0
386,267,4.400843956132392e-06,1.8979287041356905e-06,5,2,3
387,26th,6.496483935243052e-06,3.6233184351681345e-06,5,3,2
388,26yearold,6.496483935243052e-06,5.348708166200577e-06,6,3,3
389,27,9.03220830996695e-05,8.989280498679035e-05,106,46,60
390,270,8.592123914353715e-06,7.074097897233022e-06,8,4,4
391,2700,4.400843956132392e-06,3.6233184351681345e-06,6,3,3
392,27000,2.3052039770217305e-06,7.074097897233022e-06,6,2,4
393,275,2.3052039770217305e-06,5.348708166200577e-06,4,1,3
394,27bn,6.496483935243052e-06,1.7253897310324457e-07,3,3,0
395,27th,4.400843956132392e-06,5.348708166200577e-06,5,2,3
396,27yearold,4.400843956132392e-06,3.6233184351681345e-06,4,2,2
397,28,9.870464301611217e-05,9.506897417988779e-05,109,48,61
398,280,6.496483935243052e-06,3.6233184351681345e-06,5,3,2
399,2800,1.0687763893464371e-05,5.348708166200577e-06,9,5,4
400,28000,8.592123914353715e-06,7.074097897233022e-06,11,5,6
401,28th,2.095639979110664e-07,3.6233184351681345e-06,3,0,3
402,28yearold,4.400843956132392e-06,7.074097897233022e-06,6,2,4
403,29,5.4696203454788295e-05,7.781507686956326e-05,81,30,51
404,290,4.400843956132392e-06,5.348708166200577e-06,5,2,3
405,29000,6.496483935243052e-06,1.8979287041356905e-06,4,3,1
406,29yearold,8.592123914353715e-06,1.052487735929791e-05,12,5,7
407,2C,2.3052039770217305e-06,3.6233184351681345e-06,3,1,2
408,2Day,4.400843956132392e-06,1.8979287041356905e-06,3,2,1
409,2bn,1.0687763893464371e-05,8.79948762826546e-06,10,5,5
410,2m,6.496483935243052e-06,3.6233184351681345e-06,6,3,3
411,2million,2.3052039770217305e-06,3.6233184351681345e-06,4,2,2
412,2nd,3.583544364279237e-05,5.5385010366141504e-05,52,18,34
413,2to1,2.095639979110664e-07,3.6233184351681345e-06,3,1,2
414,2yearold,2.3052039770217305e-06,1.8979287041356905e-06,3,2,1
415,30,0.0003355119606556169,0.000333172757062365,389,182,207
416,300,0.00016366948236854273,0.00012612598933847184,168,86,82
417,3000,5.888748341300963e-05,5.883578982820635e-05,70,33,37
418,30000,5.050492349656699e-05,5.020884117304414e-05,62,28,34
419,300000,5.4696203454788295e-05,3.985650278684949e-05,53,28,25
420,3000yearold,4.400843956132392e-06,1.8979287041356905e-06,3,2,1
421,306,2.3052039770217305e-06,1.8979287041356905e-06,3,1,2
422,309,4.400843956132392e-06,1.8979287041356905e-06,3,2,1
423,30million,2.095639979110664e-07,3.6233184351681345e-06,3,1,2
424,30th,2.095639979110664e-07,8.79948762826546e-06,8,1,7
425,30year,4.400843956132392e-06,1.8979287041356905e-06,6,3,3
426,30yearold,6.496483935243052e-06,1.052487735929791e-05,9,3,6
427,31,6.098312339212028e-05,6.228656929027126e-05,74,33,41
428,31000,1.6974683830796368e-05,1.8979287041356905e-06,9,8,1
429,315000,4.400843956132392e-06,1.8979287041356905e-06,3,2,1
430,31st,6.496483935243052e-06,3.6233184351681345e-06,5,3,2
431,32,6.098312339212028e-05,6.401195902130366e-05,72,31,41
432,3200,6.496483935243052e-06,5.348708166200577e-06,6,3,3
433,32000,4.400843956132392e-06,1.8979287041356905e-06,4,3,1
434,32bn,6.496483935243052e-06,1.8979287041356905e-06,4,3,1
435,32yearold,6.496483935243052e-06,3.6233184351681345e-06,6,4,2
436,33,4.4218003559234974e-05,4.50326719799468e-05,50,22,28
437,330,4.400843956132392e-06,1.052487735929791e-05,11,4,7
438,33000,6.496483935243052e-06,3.6233184351681345e-06,7,4,3
439,333,4.400843956132392e-06,1.8979287041356905e-06,3,2,1
440,336,4.400843956132392e-06,3.6233184351681345e-06,5,3,2
441,33rd,4.400843956132392e-06,1.8979287041356905e-06,4,2,2
442,33yearold,2.095639979110664e-07,3.6233184351681345e-06,3,0,3
443,34,5.050492349656699e-05,3.985650278684949e-05,51,25,26
444,340,4.400843956132392e-06,1.8979287041356905e-06,3,2,1
445,34000,2.095639979110664e-07,3.6233184351681345e-06,3,0,3
446,349,2.095639979110664e-07,5.348708166200577e-06,3,0,3
447,35,9.451336305789087e-05,9.679436391092026e-05,113,52,61
448,350,2.326160376812834e-05,1.2250267090330355e-05,23,12,11
449,3500,1.48790438516857e-05,1.570104655239525e-05,18,8,10
450,35000,1.6974683830796368e-05,1.052487735929791e-05,15,8,7
451,350000,4.400843956132392e-06,1.052487735929791e-05,8,2,6
452,355,4.400843956132392e-06,1.7253897310324457e-07,3,3,0
453,35yearold,4.400843956132392e-06,1.7253897310324457e-07,3,2,1
454,36,5.260056347567764e-05,4.8483451442011706e-05,57,25,32
455,360,6.496483935243052e-06,3.6233184351681345e-06,6,4,2
456,36000,6.496483935243052e-06,1.8979287041356905e-06,5,3,2
457,360Degree,4.400843956132392e-06,1.7253897310324457e-07,3,2,1
458,365,4.400843956132392e-06,3.6233184351681345e-06,5,3,2
459,36bn,6.496483935243052e-06,1.8979287041356905e-06,4,3,1
460,37,3.583544364279237e-05,3.122955413168725e-05,40,17,23
461,370,8.592123914353715e-06,3.6233184351681345e-06,6,4,2
462,370000,2.3052039770217305e-06,3.6233184351681345e-06,3,1,2
463,375,6.496483935243052e-06,5.348708166200577e-06,7,4,3
464,38,4.6313643538345614e-05,3.122955413168725e-05,43,22,21
465,380,8.592123914353715e-06,1.8979287041356905e-06,6,4,2
466,3800,2.3052039770217305e-06,3.6233184351681345e-06,3,1,2
467,39,1.6974683830796368e-05,3.8131113055817005e-05,34,11,23
468,390,4.400843956132392e-06,3.6233184351681345e-06,4,2,2
469,3D,2.116596378901769e-05,3.640572332478458e-05,33,12,21
470,3DPrinted,2.095639979110664e-07,3.6233184351681345e-06,3,1,2
471,3G,4.400843956132392e-06,3.6233184351681345e-06,4,2,2
472,3M,2.095639979110664e-07,3.6233184351681345e-06,3,0,3
473,3Year,4.400843956132392e-06,1.7253897310324457e-07,3,3,0
474,3YearOld,6.496483935243052e-06,7.074097897233022e-06,7,3,4
475,3bn,2.3052039770217305e-06,1.8979287041356905e-06,3,1,2
476,3day,1.0687763893464371e-05,1.7253897310324457e-07,5,5,0
477,3rd,3.1644163684570994e-05,2.6053384938589907e-05,35,19,16
478,3x,2.3052039770217305e-06,5.348708166200577e-06,4,1,3
479,3year,2.3052039770217305e-06,7.074097897233022e-06,5,1,4
480,3yearold,8.592123914353715e-06,7.074097897233022e-06,8,4,4
481,40,0.00023282560167919462,0.00028141106513139157,304,126,178
482,400,9.660900303700153e-05,7.608968713853079e-05,99,48,51
483,4000,5.050492349656699e-05,3.8131113055817005e-05,54,27,27
484,40000,1.6974683830796368e-05,3.468033359375216e-05,34,9,25
485,400000,2.326160376812834e-05,2.6053384938589907e-05,29,11,18
486,4000yearold,2.3052039770217305e-06,1.8979287041356905e-06,3,1,2
487,400m,1.0687763893464371e-05,1.7253897310324457e-07,5,5,0
488,401k,2.5357243747239038e-05,3.2954943862719716e-05,38,17,21
489,404,2.3052039770217305e-06,5.348708166200577e-06,4,1,3
490,40Year,4.400843956132392e-06,3.6233184351681345e-06,4,2,2
491,40bn,4.400843956132392e-06,1.8979287041356905e-06,3,2,1
492,40km,6.496483935243052e-06,1.7253897310324457e-07,3,3,0
493,40th,2.095639979110664e-07,5.348708166200577e-06,3,0,3
494,40year,6.496483935243052e-06,3.6233184351681345e-06,5,3,2
495,40yearold,4.400843956132392e-06,5.348708166200577e-06,6,2,4
496,41,4.212236358012434e-05,4.8483451442011706e-05,53,22,31
497,41000,6.496483935243052e-06,1.8979287041356905e-06,4,3,1
498,419,2.3052039770217305e-06,1.8979287041356905e-06,3,2,1
499,42,4.4218003559234974e-05,5.3659620635109e-05,59,25,34
500,420,2.095639979110664e-07,7.074097897233022e-06,4,0,4
501,420000,2.3052039770217305e-06,1.8979287041356905e-06,3,1,2
502,425,1.0687763893464371e-05,1.8979287041356905e-06,6,5,1
503,43,6.517440335034157e-05,6.918812821440096e-05,75,31,44
504,430,2.3052039770217305e-06,3.6233184351681345e-06,3,1,2
505,4300,4.400843956132392e-06,3.6233184351681345e-06,4,2,2
506,439,4.400843956132392e-06,1.7253897310324457e-07,3,2,1
507,43rd,4.400843956132392e-06,3.6233184351681345e-06,4,2,2
508,43yearold,2.3052039770217305e-06,1.8979287041356905e-06,3,2,1
509,44,3.583544364279237e-05,3.8131113055817005e-05,46,20,26
510,440,2.3052039770217305e-06,3.6233184351681345e-06,4,2,2
511,4400,4.400843956132392e-06,1.8979287041356905e-06,3,2,1
512,44000,4.400843956132392e-06,1.8979287041356905e-06,3,2,1
513,440000,2.3052039770217305e-06,3.6233184351681345e-06,3,1,2
514,443,2.3052039770217305e-06,1.8979287041356905e-06,3,1,2
515,447,4.400843956132392e-06,5.348708166200577e-06,9,3,6
516,448,2.3052039770217305e-06,5.348708166200577e-06,4,1,3
517,45,5.888748341300963e-05,8.299124606266055e-05,93,33,60
518,450,1.6974683830796368e-05,7.074097897233022e-06,13,8,5
519,4500,6.496483935243052e-06,1.8979287041356905e-06,6,4,2
520,45000,4.400843956132392e-06,2.087721574549256e-05,15,2,13
521,450000,2.3052039770217305e-06,5.348708166200577e-06,5,2,3
522,45th,2.3052039770217305e-06,1.2250267090330355e-05,11,4,7
523,46,3.7931083621902995e-05,3.985650278684949e-05,47,19,28
524,47,3.583544364279237e-05,3.8131113055817005e-05,44,18,26
525,47000,2.3052039770217305e-06,5.348708166200577e-06,5,1,4
526,48,5.6791843433898893e-05,3.468033359375216e-05,53,28,25
527,483,6.496483935243052e-06,1.7253897310324457e-07,4,3,1
528,48hour,2.3052039770217305e-06,5.348708166200577e-06,4,1,3
529,49,4.212236358012434e-05,2.777877466962238e-05,39,21,18
530,4YearOld,4.400843956132392e-06,3.6233184351681345e-06,5,3,2
531,4day,4.400843956132392e-06,3.6233184351681345e-06,4,2,2
532,4th,2.326160376812834e-05,2.087721574549256e-05,29,16,13
533,4yearold,4.400843956132392e-06,1.052487735929791e-05,9,3,6
534,50,0.00037532912025871974,0.0003003903521727485,394,199,195
535,500,0.00014480872255654665,0.00013130215853156914,162,82,80
536,5000,7.146132328767358e-05,7.436429740749831e-05,82,36,46
537,50000,7.565260324589493e-05,5.1934230904076595e-05,74,41,33
538,500000,4.002672360101368e-05,4.1581892517881935e-05,51,21,30
539,500K,4.400843956132392e-06,3.6233184351681345e-06,4,2,2
540,500M,2.3052039770217305e-06,3.6233184351681345e-06,3,1,2
541,500m,4.400843956132392e-06,1.8979287041356905e-06,3,2,1
542,50bn,4.400843956132392e-06,1.8979287041356905e-06,3,2,1
543,50m,4.400843956132392e-06,5.348708166200577e-06,5,2,3
544,50plu,2.3052039770217305e-06,1.8979287041356905e-06,3,1,2
545,50th,6.496483935243052e-06,1.7253897310324457e-07,3,3,0
546,50year,2.095639979110664e-07,5.348708166200577e-06,4,0,4
547,51,2.7452883726349685e-05,2.777877466962238e-05,31,13,18
548,52,2.954852370546031e-05,3.468033359375216e-05,37,16,21
549,520,4.400843956132392e-06,1.8979287041356905e-06,3,2,1
550,52000,2.3052039770217305e-06,7.074097897233022e-06,6,2,4
551,529,8.592123914353715e-06,5.348708166200577e-06,8,5,3
552,53,2.954852370546031e-05,2.9504164400654783e-05,33,15,18
553,5300,2.3052039770217305e-06,1.8979287041356905e-06,3,2,1
554,53000,4.400843956132392e-06,1.8979287041356905e-06,3,2,1
555,54,2.7452883726349685e-05,2.777877466962238e-05,35,15,20
556,540,2.3052039770217305e-06,1.8979287041356905e-06,3,1,2
557,55,2.954852370546031e-05,4.6758061710979285e-05,47,16,31
558,550,4.400843956132392e-06,1.2250267090330355e-05,9,2,7
559,5500,6.496483935243052e-06,5.348708166200577e-06,8,4,4
560,55000,2.3052039770217305e-06,3.6233184351681345e-06,3,1,2
561,56,2.116596378901769e-05,2.9504164400654783e-05,33,11,22
562,560,2.3052039770217305e-06,1.8979287041356905e-06,3,2,1
563,56yearold,4.400843956132392e-06,1.8979287041356905e-06,3,2,1
564,57,2.7452883726349685e-05,3.122955413168725e-05,40,17,23
565,570,2.095639979110664e-07,5.348708166200577e-06,3,0,3
566,577,4.400843956132392e-06,1.8979287041356905e-06,3,2,1
567,58,3.3739803663681634e-05,2.9504164400654783e-05,35,17,18
568,59,2.116596378901769e-05,1.9151826014460126e-05,24,11,13
569,5Year,2.3052039770217305e-06,1.8979287041356905e-06,3,1,2
570,5YearOld,6.496483935243052e-06,8.79948762826546e-06,9,3,6
571,5am,2.3052039770217305e-06,1.8979287041356905e-06,3,2,1
572,5bn,2.095639979110664e-07,1.2250267090330355e-05,10,1,9
573,5m,2.3052039770217305e-06,7.074097897233022e-06,5,1,4
574,5th,2.326160376812834e-05,2.087721574549256e-05,24,12,12
575,5year,8.592123914353715e-06,1.8979287041356905e-06,5,4,1
576,5yearold,2.3052039770217305e-06,5.348708166200577e-06,4,1,3
577,60,0.00020348664197164515,0.00017271151207634748,224,108,116
578,600,5.6791843433898893e-05,5.3659620635109e-05,66,29,37
579,6000,3.3739803663681634e-05,3.2954943862719716e-05,40,17,23
580,60000,2.954852370546031e-05,2.2602605476525032e-05,33,14,19
581,600000,2.116596378901769e-05,1.2250267090330355e-05,19,11,8
582,60m,8.592123914353715e-06,3.6233184351681345e-06,6,4,2
583,60th,6.496483935243052e-06,1.8979287041356905e-06,5,3,2
584,60yearold,4.400843956132392e-06,1.8979287041356905e-06,4,3,1
585,61,2.326160376812834e-05,2.9504164400654783e-05,31,12,19
586,62,3.1644163684570994e-05,2.6053384938589907e-05,33,17,16
587,62000,4.400843956132392e-06,1.8979287041356905e-06,3,2,1
588,625,2.3052039770217305e-06,3.6233184351681345e-06,3,1,2
589,63,3.3739803663681634e-05,2.4327995207557487e-05,32,16,16
590,63000,4.400843956132392e-06,1.7253897310324457e-07,3,2,1
591,64,4.840928351745632e-05,2.2602605476525032e-05,44,28,16
592,640,2.095639979110664e-07,1.052487735929791e-05,6,0,6
593,645,2.3052039770217305e-06,5.348708166200577e-06,4,1,3
594,64yearold,4.400843956132392e-06,3.6233184351681345e-06,4,2,2
595,65,5.050492349656699e-05,6.401195902130366e-05,64,26,38
596,650,1.48790438516857e-05,3.6233184351681345e-06,9,7,2
597,6500,4.400843956132392e-06,7.074097897233022e-06,6,2,4
598,65000,4.400843956132392e-06,1.8979287041356905e-06,5,2,3
599,650000,4.400843956132392e-06,3.6233184351681345e-06,4,2,2
600,66,2.5357243747239038e-05,2.777877466962238e-05,36,16,20
601,66000,2.3052039770217305e-06,1.8979287041356905e-06,3,2,1
602,67,3.7931083621902995e-05,2.4327995207557487e-05,36,20,16
603,68,2.7452883726349685e-05,2.4327995207557487e-05,29,15,14
604,680,2.3052039770217305e-06,3.6233184351681345e-06,4,1,3
605,683,2.095639979110664e-07,5.348708166200577e-06,3,0,3
606,69,2.954852370546031e-05,2.9504164400654783e-05,35,14,21
607,6Figure,2.3052039770217305e-06,3.6233184351681345e-06,3,1,2
608,6YearOld,4.400843956132392e-06,7.074097897233022e-06,8,4,4
609,6m,2.3052039770217305e-06,5.348708166200577e-06,4,1,3
610,6th,2.116596378901769e-05,1.052487735929791e-05,17,10,7
611,6yearold,2.095639979110664e-07,7.074097897233022e-06,4,0,4
612,70,0.00011337412286988677,0.00016580995315221804,174,70,104
613,700,3.583544364279237e-05,4.330728224891437e-05,45,19,26
614,7000,2.7452883726349685e-05,2.4327995207557487e-05,29,15,14
615,70000,1.6974683830796368e-05,2.087721574549256e-05,22,8,14
616,700000,1.6974683830796368e-05,1.570104655239525e-05,17,8,9
617,700m,4.400843956132392e-06,3.6233184351681345e-06,4,2,2
618,70th,2.3052039770217305e-06,5.348708166200577e-06,4,1,3
619,71,1.6974683830796368e-05,2.9504164400654783e-05,27,8,19
620,71yearold,4.400843956132392e-06,1.8979287041356905e-06,3,2,1
621,72,4.840928351745632e-05,3.8131113055817005e-05,49,24,25
622,720,4.400843956132392e-06,3.6233184351681345e-06,4,2,2
623,72Hour,4.400843956132392e-06,1.7253897310324457e-07,3,2,1
624,72hour,4.400843956132392e-06,3.6233184351681345e-06,4,2,2
625,72yearold,4.400843956132392e-06,1.8979287041356905e-06,4,2,2
626,73,3.583544364279237e-05,2.9504164400654783e-05,37,17,20
627,730,2.095639979110664e-07,5.348708166200577e-06,3,0,3
628,737,2.3052039770217305e-06,5.348708166200577e-06,5,2,3
629,74,4.4218003559234974e-05,2.9504164400654783e-05,44,23,21
630,74000,2.3052039770217305e-06,3.6233184351681345e-06,3,1,2
631,74yearold,2.3052039770217305e-06,3.6233184351681345e-06,3,1,2
632,75,0.00010080028299522283,6.056117955923882e-05,93,52,41
633,750,1.0687763893464371e-05,3.6233184351681345e-06,7,5,2
634,7500,8.592123914353715e-06,1.8979287041356905e-06,5,4,1
635,75000,6.496483935243052e-06,3.6233184351681345e-06,6,4,2
636,750000,6.496483935243052e-06,5.348708166200577e-06,6,3,3
637,75th,2.095639979110664e-07,5.348708166200577e-06,3,0,3
638,75yearold,2.095639979110664e-07,5.348708166200577e-06,4,1,3
639,76,1.9070323809907035e-05,1.9151826014460126e-05,23,11,12
640,77,3.3739803663681634e-05,4.50326719799468e-05,50,19,31
641,777,4.400843956132392e-06,3.6233184351681345e-06,4,2,2
642,78,3.583544364279237e-05,1.742643628342769e-05,36,24,12
643,780,2.3052039770217305e-06,1.8979287041356905e-06,3,1,2
644,79,2.7452883726349685e-05,2.4327995207557487e-05,27,13,14
645,7Eleven,2.095639979110664e-07,5.348708166200577e-06,3,0,3
646,7m,4.400843956132392e-06,1.8979287041356905e-06,3,2,1
647,7th,6.496483935243052e-06,7.074097897233022e-06,8,4,4
648,7yearold,4.400843956132392e-06,1.8979287041356905e-06,3,2,1
649,80,0.00013013924270277222,0.00014165449691776373,164,71,93
650,800,5.6791843433898893e-05,3.8131113055817005e-05,53,29,24
651,8000,2.5357243747239038e-05,3.122955413168725e-05,37,15,22
652,80000,1.0687763893464371e-05,1.3975656821362803e-05,14,5,9
653,800000,1.278340387257504e-05,1.3975656821362803e-05,18,8,10
654,800m,4.400843956132392e-06,3.6233184351681345e-06,4,2,2
655,804,2.095639979110664e-07,7.074097897233022e-06,4,0,4
656,80yearold,4.400843956132392e-06,5.348708166200577e-06,5,2,3
657,81,6.496483935243052e-06,1.570104655239525e-05,16,5,11
658,81yearold,4.400843956132392e-06,1.8979287041356905e-06,3,2,1
659,82,1.48790438516857e-05,1.570104655239525e-05,20,8,12
660,83,1.48790438516857e-05,1.742643628342769e-05,23,12,11
661,83000,6.496483935243052e-06,1.8979287041356905e-06,4,3,1
662,84,1.6974683830796368e-05,1.570104655239525e-05,18,9,9
663,8400,2.095639979110664e-07,5.348708166200577e-06,3,0,3
664,84000,6.496483935243052e-06,8.79948762826546e-06,8,3,5
665,84yearold,2.3052039770217305e-06,1.8979287041356905e-06,3,1,2
666,85,3.7931083621902995e-05,3.468033359375216e-05,43,21,22
667,850,4.400843956132392e-06,1.2250267090330355e-05,9,2,7
668,8500,4.400843956132392e-06,1.8979287041356905e-06,3,2,1
669,85000,2.3052039770217305e-06,3.6233184351681345e-06,5,1,4
670,86,1.9070323809907035e-05,1.052487735929791e-05,15,9,6
671,87,1.278340387257504e-05,1.9151826014460126e-05,19,6,13
672,872,6.496483935243052e-06,1.7253897310324457e-07,3,3,0
673,88,2.326160376812834e-05,2.9504164400654783e-05,31,13,18
674,88000,2.095639979110664e-07,5.348708166200577e-06,3,0,3
675,89,2.116596378901769e-05,2.777877466962238e-05,28,11,17
676,8YearOld,2.3052039770217305e-06,1.8979287041356905e-06,3,1,2
677,8bn,4.400843956132392e-06,1.8979287041356905e-06,3,2,1
678,8m,2.095639979110664e-07,5.348708166200577e-06,4,0,4
679,8th,6.496483935243052e-06,5.348708166200577e-06,7,4,3
680,8yearold,6.496483935243052e-06,3.6233184351681345e-06,6,3,3
681,90,0.0001385218026192147,0.00013302754826260141,159,77,82
682,900,2.954852370546031e-05,4.1581892517881935e-05,40,14,26
683,9000,8.592123914353715e-06,1.052487735929791e-05,16,9,7
684,90000,2.326160376812834e-05,1.742643628342769e-05,23,12,11
685,900000,8.592123914353715e-06,5.348708166200577e-06,8,5,3
686,908,2.095639979110664e-07,3.6233184351681345e-06,3,0,3
687,90day,2.3052039770217305e-06,3.6233184351681345e-06,3,1,2
688,90th,2.3052039770217305e-06,3.6233184351681345e-06,3,1,2
689,91,8.592123914353715e-06,3.122955413168725e-05,25,5,20
690,911,0.00016786076232676425,0.0001520068353039585,193,88,105
691,912,6.496483935243052e-06,1.8979287041356905e-06,4,3,1
692,92,1.6974683830796368e-05,1.3975656821362803e-05,19,10,9
693,920,4.400843956132392e-06,1.8979287041356905e-06,3,2,1
694,93,1.48790438516857e-05,2.2602605476525032e-05,21,8,13
695,93yearold,2.3052039770217305e-06,3.6233184351681345e-06,3,1,2
696,94,2.5357243747239038e-05,1.742643628342769e-05,25,12,13
697,95,2.5357243747239038e-05,3.8131113055817005e-05,38,14,24
698,950,4.400843956132392e-06,3.6233184351681345e-06,4,2,2
699,9525,4.400843956132392e-06,1.8979287041356905e-06,3,2,1
700,96,1.48790438516857e-05,2.4327995207557487e-05,21,7,14
701,97,2.5357243747239038e-05,2.087721574549256e-05,28,14,14
702,98,3.583544364279237e-05,1.3975656821362803e-05,26,18,8
703,98yearold,2.095639979110664e-07,5.348708166200577e-06,3,0,3
704,99,3.583544364279237e-05,3.985650278684949e-05,46,19,27
705,997,2.095639979110664e-07,5.348708166200577e-06,3,0,3
706,999,6.496483935243052e-06,3.6233184351681345e-06,6,4,2
707,99year,4.400843956132392e-06,1.8979287041356905e-06,3,2,1
708,9YearOld,4.400843956132392e-06,1.8979287041356905e-06,3,2,1
709,9th,1.0687763893464371e-05,1.570104655239525e-05,17,8,9
710,9year,4.400843956132392e-06,1.8979287041356905e-06,3,2,1
711,9yearold,8.592123914353715e-06,7.074097897233022e-06,8,4,4
712,A10,2.3052039770217305e-06,1.8979287041356905e-06,4,1,3
713,A320,2.3052039770217305e-06,5.348708166200577e-06,4,1,3
714,A380,2.3052039770217305e-06,7.074097897233022e-06,6,1,5
715,AAA,8.592123914353715e-06,8.79948762826546e-06,9,4,5
716,AAP,4.400843956132392e-06,1.8979287041356905e-06,3,2,1
717,AAPI,2.3052039770217305e-06,7.074097897233022e-06,5,1,4
718,AARP,8.592123914353715e-06,8.79948762826546e-06,9,4,5
719,ABC,2.954852370546031e-05,3.985650278684949e-05,43,15,28
720,ABLE,2.3052039770217305e-06,1.8979287041356905e-06,4,1,3
721,AC,4.400843956132392e-06,3.6233184351681345e-06,4,2,2
722,ACA,2.954852370546031e-05,3.468033359375216e-05,38,14,24
723,ACDC,4.400843956132392e-06,3.6233184351681345e-06,4,2,2
724,ACLU,6.517440335034157e-05,5.883578982820635e-05,70,32,38
725,ACORN,6.496483935243052e-06,1.7253897310324457e-07,3,3,0
726,ACSLaw,4.400843956132392e-06,1.7253897310324457e-07,3,2,1
727,ACT,2.3052039770217305e-06,3.6233184351681345e-06,3,1,2
728,ACTA,6.517440335034157e-05,3.122955413168725e-05,57,35,22
729,AD,2.095639979110664e-07,3.6233184351681345e-06,3,1,2
730,ADA,2.3052039770217305e-06,3.6233184351681345e-06,3,1,2
731,ADHD,2.095639979110664e-07,5.348708166200577e-06,3,0,3
732,ADL,4.400843956132392e-06,1.8979287041356905e-06,5,3,2
733,AFLCIO,8.592123914353715e-06,1.3975656821362803e-05,13,4,9
734,AFP,1.48790438516857e-05,1.742643628342769e-05,20,8,12
735,AG,2.326160376812834e-05,3.468033359375216e-05,36,11,25
736,AHCA,6.496483935243052e-06,7.074097897233022e-06,8,4,4
737,AI,6.496483935243052e-06,1.2250267090330355e-05,10,3,7
738,AID,7.774824322500554e-05,6.401195902130366e-05,86,44,42
739,AIG,6.496483935243052e-06,1.7253897310324457e-07,3,3,0
740,AIPAC,6.496483935243052e-06,1.2250267090330355e-05,12,3,9
741,AK47,1.278340387257504e-05,1.052487735929791e-05,14,8,6
742,AKA,6.496483935243052e-06,5.348708166200577e-06,6,3,3
743,AKP,1.0687763893464371e-05,1.8979287041356905e-06,6,5,1
744,AL,1.278340387257504e-05,1.742643628342769e-05,17,6,11
745,AME,4.400843956132392e-06,7.074097897233022e-06,6,2,4
746,ANC,8.592123914353715e-06,1.2250267090330355e-05,12,5,7
747,ANGELE,6.496483935243052e-06,1.8979287041356905e-06,4,3,1
748,ANOTHER,4.400843956132392e-06,3.6233184351681345e-06,4,2,2
749,AOC,2.3052039770217305e-06,3.6233184351681345e-06,3,1,2
750,AOL,1.278340387257504e-05,5.348708166200577e-06,10,7,3
751,AP,8.613080314144832e-05,9.334358444885519e-05,107,49,58
752,AR,2.095639979110664e-07,3.6233184351681345e-06,3,0,3
753,AR15,2.116596378901769e-05,2.2602605476525032e-05,24,10,14
754,ASAP,2.3052039770217305e-06,1.052487735929791e-05,7,1,6
755,ATF,2.3052039770217305e-06,8.79948762826546e-06,7,2,5
756,ATM,2.326160376812834e-05,3.122955413168725e-05,33,14,19
757,ATT,2.326160376812834e-05,2.777877466962238e-05,30,12,18
758,AU,6.496483935243052e-06,8.79948762826546e-06,8,3,5
759,AUMF,6.496483935243052e-06,7.074097897233022e-06,7,3,4
760,AUSTRALIA,4.400843956132392e-06,1.7253897310324457e-07,3,2,1
761,AWOL,4.400843956132392e-06,5.348708166200577e-06,5,2,3
762,Aaron,1.6974683830796368e-05,2.6053384938589907e-05,26,11,15
763,Abandon,1.48790438516857e-05,1.9151826014460126e-05,21,7,14
764,Abandoned,8.592123914353715e-06,2.087721574549256e-05,20,5,15
765,Abandoning,1.0687763893464371e-05,3.6233184351681345e-06,7,5,2
766,Abba,2.7452883726349685e-05,4.8483451442011706e-05,45,13,32
767,Abbey,2.3052039770217305e-06,5.348708166200577e-06,4,1,3
768,Abbot,4.400843956132392e-06,5.348708166200577e-06,5,2,3
769,Abbott,8.193952318322689e-05,6.746273848336857e-05,93,42,51
770,Abbottabad,6.496483935243052e-06,1.8979287041356905e-06,4,3,1
771,Abby,2.3052039770217305e-06,3.6233184351681345e-06,4,1,3
772,Abdel,6.496483935243052e-06,1.2250267090330355e-05,11,4,7
773,Abdelbaset,4.400843956132392e-06,3.6233184351681345e-06,4,2,2
774,Abdeslam,8.592123914353715e-06,3.6233184351681345e-06,7,4,3
775,Abducted,2.3052039770217305e-06,1.2250267090330355e-05,9,1,8
776,Abdul,1.0687763893464371e-05,7.074097897233022e-06,10,6,4
777,Abdulaziz,4.400843956132392e-06,1.8979287041356905e-06,3,2,1
778,Abdullah,5.6791843433898893e-05,3.2954943862719716e-05,48,28,20
779,Abe,1.48790438516857e-05,1.570104655239525e-05,17,7,10
780,Abedin,8.592123914353715e-06,1.052487735929791e-05,10,4,6
781,Abercrombie,6.496483935243052e-06,8.79948762826546e-06,8,3,5
782,Ability,2.116596378901769e-05,2.6053384938589907e-05,27,11,16
783,Abkhazia,8.592123914353715e-06,3.6233184351681345e-06,10,6,4
784,Ablaze,4.400843956132392e-06,1.8979287041356905e-06,3,2,1
785,Able,2.7452883726349685e-05,1.9151826014460126e-05,28,15,13
786,Aboard,2.3052039770217305e-06,5.348708166200577e-06,6,3,3
787,Abolish,8.592123914353715e-06,1.052487735929791e-05,11,4,7
788,Abolishing,2.3052039770217305e-06,3.6233184351681345e-06,3,1,2
789,Aboriginal,8.592123914353715e-06,2.087721574549256e-05,20,6,14
790,Aborigine,8.592123914353715e-06,3.6233184351681345e-06,6,4,2
791,Aborted,2.3052039770217305e-06,5.348708166200577e-06,4,1,3
792,Abortion,0.00017205204228498542,0.0002089446964280291,229,95,134
793,Abraham,1.6974683830796368e-05,1.052487735929791e-05,15,9,6
794,Abram,6.496483935243052e-06,1.2250267090330355e-05,14,4,10
795,Abroad,1.9070323809907035e-05,1.3975656821362803e-05,18,10,8
796,Abruptly,6.496483935243052e-06,1.2250267090330355e-05,11,3,8
797,Absence,1.0687763893464371e-05,5.348708166200577e-06,9,6,3
798,Absent,6.496483935243052e-06,3.6233184351681345e-06,6,4,2
799,Absenteeism,2.3052039770217305e-06,3.6233184351681345e-06,3,1,2
800,Absolute,4.400843956132392e-06,7.074097897233022e-06,7,2,5
801,Absolutely,2.5357243747239038e-05,3.122955413168725e-05,35,16,19
802,Absurd,1.0687763893464371e-05,5.348708166200577e-06,9,5,4
803,Absurdity,6.496483935243052e-06,1.7253897310324457e-07,3,3,0
804,Abu,2.5357243747239038e-05,5.1934230904076595e-05,47,14,33
805,Abuse,0.00012175668278632962,0.0001278513790695043,159,69,90
806,Abused,4.400843956132392e-06,1.2250267090330355e-05,10,2,8
807,Abuser,4.400843956132392e-06,2.9504164400654783e-05,20,2,18
808,Abusing,4.400843956132392e-06,8.79948762826546e-06,8,3,5
809,Abusive,4.400843956132392e-06,1.052487735929791e-05,10,3,7
810,Abysmal,2.3052039770217305e-06,5.348708166200577e-06,4,1,3
811,Academic,1.278340387257504e-05,8.79948762826546e-06,12,6,6
812,Academy,1.0687763893464371e-05,1.2250267090330355e-05,14,7,7
813,Acapulco,4.400843956132392e-06,1.3975656821362803e-05,11,2,9
814,Accelerate,4.400843956132392e-06,8.79948762826546e-06,8,3,5
815,Accept,5.050492349656699e-05,3.985650278684949e-05,50,24,26
816,Acceptable,2.3052039770217305e-06,5.348708166200577e-06,5,2,3
817,Acceptance,4.400843956132392e-06,1.8979287041356905e-06,3,2,1
818,Accepted,8.592123914353715e-06,7.074097897233022e-06,9,4,5
819,Accepting,1.278340387257504e-05,8.79948762826546e-06,12,6,6
820,Acces,0.00013013924270277222,0.00010542131256608228,139,68,71
821,Accessed,2.3052039770217305e-06,3.6233184351681345e-06,3,1,2
822,Accessibility,6.496483935243052e-06,1.8979287041356905e-06,4,3,1
823,Accessible,2.095639979110664e-07,1.8979287041356905e-06,3,2,1
824,Accessory,2.095639979110664e-07,3.6233184351681345e-06,4,1,3
825,Accident,1.0687763893464371e-05,1.052487735929791e-05,13,5,8
826,Accidental,4.400843956132392e-06,7.074097897233022e-06,6,2,4
827,Accidentally,1.9070323809907035e-05,1.570104655239525e-05,21,11,10
828,Acclaimed,4.400843956132392e-06,1.8979287041356905e-06,3,2,1
829,Accompany,2.3052039770217305e-06,5.348708166200577e-06,4,1,3
830,Accomplished,2.3052039770217305e-06,5.348708166200577e-06,5,1,4
831,Accomplishment,2.3052039770217305e-06,3.6233184351681345e-06,3,1,2
832,Accord,4.400843956132392e-06,2.2602605476525032e-05,15,2,13
833,According,0.00013223488268188294,0.00011922443041434203,148,73,75
834,Account,0.0001259479627445509,7.608968713853079e-05,122,65,57
835,Accountability,1.48790438516857e-05,1.742643628342769e-05,19,7,12
836,Accountable,1.278340387257504e-05,1.052487735929791e-05,15,7,8
837,Accountant,2.3052039770217305e-06,5.348708166200577e-06,4,1,3
838,Accurate,4.400843956132392e-06,7.074097897233022e-06,7,2,5
839,Accus,5.888748341300963e-05,5.711040009717395e-05,65,31,34
840,Accusation,2.116596378901769e-05,1.742643628342769e-05,22,11,11
841,Accuse,1.278340387257504e-05,8.79948762826546e-06,15,9,6
842,Accused,0.00011337412286988677,0.0001036959228350498,124,60,64
843,Accuser,2.7452883726349685e-05,3.640572332478458e-05,38,15,23
844,Accusing,1.48790438516857e-05,3.6233184351681345e-06,11,8,3
845,Aceh,4.400843956132392e-06,7.074097897233022e-06,7,2,5
846,Achievable,2.3052039770217305e-06,1.8979287041356905e-06,3,1,2
847,Achieve,1.0687763893464371e-05,7.074097897233022e-06,9,5,4
848,Achievement,6.496483935243052e-06,7.074097897233022e-06,7,3,4
849,Achieving,2.3052039770217305e-06,3.6233184351681345e-06,5,3,2
850,Achille,2.095639979110664e-07,5.348708166200577e-06,3,0,3
851,Acid,1.278340387257504e-05,8.79948762826546e-06,12,6,6
852,Acknowledge,2.116596378901769e-05,7.074097897233022e-06,14,10,4
853,Acosta,4.400843956132392e-06,8.79948762826546e-06,10,3,7
854,Acquire,6.496483935243052e-06,5.348708166200577e-06,7,4,3
855,Acquittal,6.496483935243052e-06,5.348708166200577e-06,6,3,3
856,Acquitted,2.3052039770217305e-06,5.348708166200577e-06,4,1,3
857,Acre,8.592123914353715e-06,5.348708166200577e-06,7,4,3
858,Acropoli,2.3052039770217305e-06,7.074097897233022e-06,5,1,4
859,Acros,7.565260324589493e-05,9.334358444885519e-05,97,38,59
860,Act,0.0003397032406138383,0.0002848618445934566,360,173,187
861,Acta,4.400843956132392e-06,5.348708166200577e-06,7,2,5
862,Acted,2.3052039770217305e-06,3.6233184351681345e-06,3,1,2
863,Acting,3.1644163684570994e-05,1.570104655239525e-05,26,16,10
864,Action,0.00015109564249387862,0.00018651462992460717,197,84,113
865,Active,1.0687763893464371e-05,1.9151826014460126e-05,16,5,11
866,Actively,2.095639979110664e-07,7.074097897233022e-06,4,0,4
867,Activism,1.0687763893464371e-05,2.087721574549256e-05,18,6,12
868,Activist,0.0002055822819507562,0.00020721930669699654,241,107,134
869,Activity,2.116596378901769e-05,8.79948762826546e-06,19,12,7
870,Actor,1.9070323809907035e-05,2.2602605476525032e-05,23,10,13
871,Actres,6.496483935243052e-06,7.074097897233022e-06,7,3,4
872,Actual,3.1644163684570994e-05,2.777877466962238e-05,34,17,17
873,Actually,0.00014900000251476814,0.00015373222503499084,178,83,95
874,Ad,0.0002055822819507562,0.0001968669683108019,233,105,128
875,Adam,3.3739803663681634e-05,5.5385010366141504e-05,53,18,35
876,Add,5.6791843433898893e-05,5.883578982820635e-05,69,31,38
877,Added,1.278340387257504e-05,1.2250267090330355e-05,13,6,7
878,Addict,2.095639979110664e-07,1.052487735929791e-05,6,0,6
879,Addicted,4.400843956132392e-06,7.074097897233022e-06,6,2,4
880,Addiction,2.7452883726349685e-05,3.122955413168725e-05,33,14,19
881,Adding,4.400843956132392e-06,1.570104655239525e-05,13,3,10
882,Additional,6.496483935243052e-06,1.570104655239525e-05,12,3,9
883,Addres,6.098312339212028e-05,7.608968713853079e-05,78,31,47
884,Address,1.0687763893464371e-05,1.3975656821362803e-05,13,5,8
885,Addressing,1.48790438516857e-05,7.074097897233022e-06,12,7,5
886,Adele,4.400843956132392e-06,5.348708166200577e-06,6,2,4
887,Adelson,1.9070323809907035e-05,1.052487735929791e-05,20,9,11
888,Aden,4.400843956132392e-06,7.074097897233022e-06,6,2,4
889,Adida,4.400843956132392e-06,7.074097897233022e-06,6,2,4
890,Adjustment,2.3052039770217305e-06,3.6233184351681345e-06,3,1,2
891,Adm,4.400843956132392e-06,5.348708166200577e-06,5,2,3
892,Admin,8.592123914353715e-06,1.3975656821362803e-05,13,4,9
893,Administration,0.0002726427612822975,0.0003090173008279106,348,143,205
894,Administrator,8.592123914353715e-06,1.3975656821362803e-05,13,4,9
895,Admiral,8.592123914353715e-06,1.570104655239525e-05,14,4,10
896,Admire,2.3052039770217305e-06,3.6233184351681345e-06,3,1,2
897,Admired,2.095639979110664e-07,3.6233184351681345e-06,3,0,3
898,Admission,1.0687763893464371e-05,8.79948762826546e-06,10,5,5
899,Admit,9.451336305789087e-05,9.851975364195259e-05,109,47,62
900,Admitted,1.6974683830796368e-05,7.074097897233022e-06,13,8,5
901,Admittedly,2.3052039770217305e-06,3.6233184351681345e-06,3,1,2
902,Admitting,6.496483935243052e-06,1.8979287041356905e-06,4,3,1
903,Adobe,6.496483935243052e-06,3.6233184351681345e-06,6,4,2
904,Adolf,2.116596378901769e-05,2.4327995207557487e-05,26,12,14
905,Adopt,1.278340387257504e-05,2.087721574549256e-05,23,9,14
906,Adopted,1.278340387257504e-05,5.348708166200577e-06,9,6,3
907,Adopting,8.592123914353715e-06,7.074097897233022e-06,8,4,4
908,Adoption,6.496483935243052e-06,2.777877466962238e-05,22,4,18
909,Adorable,3.583544364279237e-05,4.330728224891437e-05,47,19,28
910,Adorably,2.095639979110664e-07,7.074097897233022e-06,4,0,4
911,Adrian,6.496483935243052e-06,3.6233184351681345e-06,5,3,2
912,Adrift,4.400843956132392e-06,1.8979287041356905e-06,3,2,1
913,Adult,2.326160376812834e-05,2.6053384938589907e-05,35,16,19
914,Advance,2.116596378901769e-05,2.9504164400654783e-05,31,12,19
915,Advanced,8.592123914353715e-06,1.052487735929791e-05,11,5,6
916,Advantage,1.278340387257504e-05,2.6053384938589907e-05,21,6,15
917,Adventure,1.0687763893464371e-05,5.348708166200577e-06,9,5,4
918,Adversity,6.496483935243052e-06,3.6233184351681345e-06,5,3,2
919,Advertiser,2.3052039770217305e-06,5.348708166200577e-06,4,1,3
920,Advertising,8.592123914353715e-06,2.4327995207557487e-05,19,4,15
921,Advice,5.4696203454788295e-05,5.1934230904076595e-05,62,28,34
922,Advise,1.278340387257504e-05,5.348708166200577e-06,9,6,3
923,Advised,1.0687763893464371e-05,1.8979287041356905e-06,6,5,1
924,Adviser,7.565260324589493e-05,8.4716635793693e-05,99,42,57
925,Advising,4.400843956132392e-06,5.348708166200577e-06,5,2,3
926,Advisor,1.6974683830796368e-05,1.2250267090330355e-05,18,10,8
927,Advisory,6.496483935243052e-06,3.122955413168725e-05,22,3,19
928,Advocacy,1.6974683830796368e-05,7.074097897233022e-06,13,8,5
929,Advocate,6.72700433294523e-05,7.954046660059569e-05,82,33,49
930,Advocating,4.400843956132392e-06,1.8979287041356905e-06,3,2,1
931,Ady,2.3052039770217305e-06,7.074097897233022e-06,5,1,4
932,Aerial,4.400843956132392e-06,1.8979287041356905e-06,4,2,2
933,Aeroflot,2.095639979110664e-07,7.074097897233022e-06,4,0,4
934,Aetna,6.496483935243052e-06,8.79948762826546e-06,8,3,5
935,Affair,4.6313643538345614e-05,5.3659620635109e-05,54,23,31
936,Affect,3.1644163684570994e-05,2.4327995207557487e-05,34,16,18
937,Affected,1.6974683830796368e-05,1.052487735929791e-05,16,9,7
938,Affecting,8.592123914353715e-06,1.8979287041356905e-06,6,4,2
939,Affirm,2.095639979110664e-07,5.348708166200577e-06,3,0,3
940,Affirmative,1.0687763893464371e-05,5.348708166200577e-06,8,5,3
941,Affluent,2.3052039770217305e-06,5.348708166200577e-06,4,1,3
942,Afford,2.7452883726349685e-05,1.9151826014460126e-05,24,13,11
943,Affordability,2.3052039770217305e-06,3.6233184351681345e-06,3,1,2
944,Affordable,9.03220830996695e-05,7.436429740749831e-05,93,45,48
945,Afghan,0.0004130506398827114,0.00041944224361398707,492,221,271
946,Afghani,2.3052039770217305e-06,5.348708166200577e-06,5,2,3
947,Afghanistan,0.0005576497984413471,0.0006144112832206537,682,293,389
948,Afraid,2.5357243747239038e-05,1.3975656821362803e-05,22,14,8
949,Africa,0.0005094500789218018,0.00037630750033817615,505,261,244
950,African,0.0003019817209898466,0.0003141934700210085,358,157,201
951,AfricanAmerican,4.002672360101368e-05,4.6758061710979285e-05,49,21,28
952,Afridi,4.400843956132392e-06,3.6233184351681345e-06,4,2,2
953,After,2.3052039770217305e-06,3.6233184351681345e-06,3,1,2
954,Aftermath,2.7452883726349685e-05,2.087721574549256e-05,25,13,12
955,Afternoon,2.3052039770217305e-06,5.348708166200577e-06,4,1,3
956,Aftershock,2.095639979110664e-07,1.8979287041356905e-06,3,2,1
957,Again,6.496483935243052e-06,7.074097897233022e-06,9,3,6
958,Age,0.00010080028299522283,9.161819471782287e-05,115,53,62
959,Agency,0.0001385218026192147,0.0001847892401935746,194,73,121
960,Agendum,4.002672360101368e-05,6.401195902130366e-05,63,21,42
961,Agent,6.72700433294523e-05,7.091351794543343e-05,86,37,49
962,Aggression,4.400843956132392e-06,1.8979287041356905e-06,4,3,1
963,Aggressive,6.496483935243052e-06,1.570104655239525e-05,13,4,9
964,Aging,4.400843956132392e-06,1.570104655239525e-05,12,2,10
965,Ago,5.6791843433898893e-05,4.6758061710979285e-05,60,31,29
966,Agree,9.660900303700153e-05,9.161819471782287e-05,107,49,58
967,Agreed,4.400843956132392e-06,5.348708166200577e-06,6,2,4
968,Agreement,6.936568330856297e-05,8.126585633162811e-05,87,33,54
969,Agribusines,2.095639979110664e-07,5.348708166200577e-06,3,0,3
970,Agricultural,6.496483935243052e-06,1.8979287041356905e-06,4,3,1
971,Agriculture,1.0687763893464371e-05,2.087721574549256e-05,18,5,13
972,Ah,4.400843956132392e-06,3.6233184351681345e-06,6,4,2
973,Ahab,4.400843956132392e-06,1.8979287041356905e-06,3,2,1
974,Ahead,9.24177230787802e-05,0.00011059748175917965,122,50,72
975,Ahmad,8.592123914353715e-06,1.2250267090330355e-05,12,4,8
976,Ahmadinejad,0.00013642616264010403,0.00010024514337298497,134,70,64
977,Ahmaud,8.592123914353715e-06,1.8979287041356905e-06,6,4,2
978,Ahmed,2.954852370546031e-05,2.777877466962238e-05,34,17,17
979,Ahmet,4.400843956132392e-06,1.8979287041356905e-06,3,2,1
980,Ai,2.7452883726349685e-05,1.052487735929791e-05,23,13,10
981,Aid,0.00010080028299522283,0.00012094982014537423,134,50,84
982,Aide,6.307876337123095e-05,0.0001019705331040174,96,34,62
983,Aided,1.0687763893464371e-05,7.074097897233022e-06,9,5,4
984,Aiding,2.3052039770217305e-06,7.074097897233022e-06,6,1,5
985,Aiken,6.496483935243052e-06,1.8979287041356905e-06,5,3,2
986,Aile,1.6974683830796368e-05,1.3975656821362803e-05,16,8,8
987,Ailing,4.400843956132392e-06,3.6233184351681345e-06,6,3,3
988,Aim,5.6791843433898893e-05,7.436429740749831e-05,77,30,47
989,Aimed,6.496483935243052e-06,1.2250267090330355e-05,11,3,8
990,Aiming,2.095639979110664e-07,3.6233184351681345e-06,3,1,2
991,Aint,2.095639979110664e-07,8.79948762826546e-06,6,1,5
992,Air,0.00016576512234765329,0.0002451778807797103,244,91,153
993,AirAsia,6.496483935243052e-06,5.348708166200577e-06,9,6,3
994,Airbnb,2.116596378901769e-05,3.2954943862719716e-05,33,12,21
995,Airbu,1.0687763893464371e-05,1.3975656821362803e-05,14,5,9
996,Aircraft,1.48790438516857e-05,1.2250267090330355e-05,16,8,8
997,Aire,1.0687763893464371e-05,1.2250267090330355e-05,14,5,9
998,Airing,2.095639979110664e-07,7.074097897233022e-06,4,0,4
999,Airline,0.00010708720293255492,9.851975364195259e-05,123,55,68
1000,Airman,4.400843956132392e-06,1.7253897310324457e-07,3,2,1
1001,Airplane,1.278340387257504e-05,1.052487735929791e-05,13,6,7
1002,Airport,7.355696326678427e-05,7.436429740749831e-05,90,39,51
1003,Airspace,4.400843956132392e-06,1.8979287041356905e-06,4,3,1
1004,Airstrike,2.5357243747239038e-05,2.9504164400654783e-05,38,14,24
1005,Airway,2.116596378901769e-05,5.348708166200577e-06,14,11,3
1006,Aisle,4.400843956132392e-06,5.348708166200577e-06,6,3,3
1007,Ajit,2.3052039770217305e-06,5.348708166200577e-06,4,1,3
1008,Akbar,4.400843956132392e-06,3.6233184351681345e-06,5,3,2
1009,Akin,6.496483935243052e-06,7.074097897233022e-06,7,3,4
1010,Al,0.00021396484186719832,0.00026933333701416437,288,113,175
1011,AlJazeera,2.7452883726349685e-05,2.9504164400654783e-05,32,14,18
1012,AlQaeda,2.326160376812834e-05,2.2602605476525032e-05,27,14,13
1013,AlQaida,1.0687763893464371e-05,1.052487735929791e-05,15,6,9
1014,AlShabaab,2.3052039770217305e-06,3.6233184351681345e-06,3,1,2
1015,AlShabab,4.400843956132392e-06,1.8979287041356905e-06,3,2,1
1016,Ala,1.0687763893464371e-05,3.6233184351681345e-06,8,5,3
1017,Alaa,2.3052039770217305e-06,1.8979287041356905e-06,3,1,2
1018,Alabama,0.00012804360272366158,0.00015373222503499084,185,82,103
1019,Alamo,2.3052039770217305e-06,1.8979287041356905e-06,3,2,1
1020,Alan,3.7931083621902995e-05,2.777877466962238e-05,41,21,20
1021,Alarm,1.48790438516857e-05,2.6053384938589907e-05,23,8,15
1022,Alarmed,6.496483935243052e-06,5.348708166200577e-06,7,3,4
1023,Alarming,8.592123914353715e-06,1.3975656821362803e-05,13,4,9
1024,Alaska,5.888748341300963e-05,7.436429740749831e-05,78,33,45
1025,Alaskan,6.496483935243052e-06,5.348708166200577e-06,8,3,5
1026,Alawite,1.48790438516857e-05,1.8979287041356905e-06,8,7,1
1027,Albania,6.496483935243052e-06,3.6233184351681345e-06,6,3,3
1028,Albanian,8.592123914353715e-06,7.074097897233022e-06,8,4,4
1029,Albany,2.3052039770217305e-06,1.8979287041356905e-06,3,2,1
1030,Albert,4.400843956132392e-06,1.3975656821362803e-05,11,3,8
1031,Alberta,3.7931083621902995e-05,3.640572332478458e-05,44,22,22
1032,Alberto,1.48790438516857e-05,3.6233184351681345e-06,13,9,4
1033,Albino,4.400843956132392e-06,3.6233184351681345e-06,4,2,2
1034,Albright,1.0687763893464371e-05,5.348708166200577e-06,8,5,3
1035,Album,2.095639979110664e-07,7.074097897233022e-06,4,0,4
1036,Albuquerque,4.400843956132392e-06,1.8979287041356905e-06,3,2,1
1037,Alcohol,1.0687763893464371e-05,1.3975656821362803e-05,13,5,8
1038,Aldrin,4.400843956132392e-06,1.8979287041356905e-06,3,2,1
1039,Alec,6.496483935243052e-06,7.074097897233022e-06,8,4,4
1040,Aleppo,4.212236358012434e-05,3.2954943862719716e-05,47,25,22
1041,Alert,1.9070323809907035e-05,1.9151826014460126e-05,26,12,14
1042,Alex,4.6313643538345614e-05,4.330728224891437e-05,49,22,27
1043,Alexa,2.3052039770217305e-06,5.348708166200577e-06,4,1,3
1044,Alexander,4.002672360101368e-05,3.8131113055817005e-05,47,22,25
1045,Alexandria,2.5357243747239038e-05,3.122955413168725e-05,33,14,19
1046,Alexei,6.496483935243052e-06,7.074097897233022e-06,9,5,4
1047,Alexey,4.400843956132392e-06,1.7253897310324457e-07,3,2,1
1048,Alexi,8.592123914353715e-06,5.348708166200577e-06,7,4,3
1049,Alfred,6.496483935243052e-06,1.8979287041356905e-06,5,4,1
1050,Alga,6.496483935243052e-06,1.8979287041356905e-06,4,3,1
1051,Algeria,1.9070323809907035e-05,2.6053384938589907e-05,27,11,16
1052,Algerian,1.0687763893464371e-05,5.348708166200577e-06,8,5,3
1053,Algorithm,4.400843956132392e-06,1.7253897310324457e-07,3,2,1
1054,Ali,7.984388320411623e-05,5.3659620635109e-05,75,38,37
1055,Alibaba,6.496483935243052e-06,8.79948762826546e-06,8,3,5
1056,Alice,6.496483935243052e-06,1.052487735929791e-05,9,3,6
1057,Alicia,2.3052039770217305e-06,7.074097897233022e-06,5,1,4
1058,Alien,2.5357243747239038e-05,1.3975656821362803e-05,26,14,12
1059,Align,6.496483935243052e-06,5.348708166200577e-06,6,3,3
1060,Alike,4.400843956132392e-06,3.6233184351681345e-06,4,2,2
1061,Alison,2.3052039770217305e-06,8.79948762826546e-06,6,1,5
1062,Alito,1.0687763893464371e-05,1.7253897310324457e-07,5,5,0
1063,Alive,2.116596378901769e-05,4.1581892517881935e-05,40,12,28
1064,Aljazeera,4.400843956132392e-06,1.8979287041356905e-06,3,2,1
1065,All,4.400843956132392e-06,2.2602605476525032e-05,16,2,14
1066,AllCap,4.400843956132392e-06,1.8979287041356905e-06,3,2,1
1067,AllFemale,4.400843956132392e-06,3.6233184351681345e-06,4,2,2
1068,AllOut,2.3052039770217305e-06,3.6233184351681345e-06,3,1,2
1069,AllStar,2.3052039770217305e-06,7.074097897233022e-06,5,1,4
1070,AllTime,8.592123914353715e-06,3.6233184351681345e-06,9,5,4
1071,Allah,1.6974683830796368e-05,1.9151826014460126e-05,20,8,12
1072,Allawi,2.095639979110664e-07,5.348708166200577e-06,5,0,5
1073,Allegation,8.403516316233764e-05,8.126585633162811e-05,94,45,49
1074,Allege,1.9070323809907035e-05,8.79948762826546e-06,16,9,7
1075,Alleged,5.888748341300963e-05,6.401195902130366e-05,68,28,40
1076,Allegedly,3.583544364279237e-05,5.3659620635109e-05,54,20,34
1077,Allegiance,2.3052039770217305e-06,5.348708166200577e-06,4,1,3
1078,Alleging,8.592123914353715e-06,3.6233184351681345e-06,7,4,3
1079,Allen,1.0687763893464371e-05,2.777877466962238e-05,22,5,17
1080,Allende,4.400843956132392e-06,3.6233184351681345e-06,4,2,2
1081,Allergy,2.095639979110664e-07,7.074097897233022e-06,4,0,4
1082,Alliance,1.9070323809907035e-05,1.570104655239525e-05,19,10,9
1083,Allie,5.050492349656699e-05,5.1934230904076595e-05,56,25,31
1084,Allied,8.592123914353715e-06,3.6233184351681345e-06,6,4,2
1085,Alligator,2.3052039770217305e-06,3.6233184351681345e-06,5,3,2
1086,Allison,4.400843956132392e-06,1.7253897310324457e-07,3,2,1
1087,Allow,6.307876337123095e-05,7.436429740749831e-05,80,33,47
1088,Allowance,4.400843956132392e-06,7.074097897233022e-06,6,2,4
1089,Allowed,3.1644163684570994e-05,2.6053384938589907e-05,32,16,16
1090,Allowing,1.6974683830796368e-05,2.2602605476525032e-05,23,10,13
1091,Ally,1.278340387257504e-05,2.6053384938589907e-05,24,7,17
1092,Alma,4.400843956132392e-06,1.8979287041356905e-06,3,2,1
1093,Almighty,4.400843956132392e-06,1.8979287041356905e-06,3,2,1
1094,Almond,2.3052039770217305e-06,1.8979287041356905e-06,3,1,2
1095,Almost,0.00012175668278632962,0.0001019705331040174,132,65,67
1096,Alone,2.326160376812834e-05,2.4327995207557487e-05,28,13,15
1097,Along,3.583544364279237e-05,3.2954943862719716e-05,45,20,25
1098,Alongside,6.496483935243052e-06,5.348708166200577e-06,6,3,3
1099,Alonzo,2.095639979110664e-07,7.074097897233022e-06,4,0,4
1100,Alp,1.0687763893464371e-05,5.348708166200577e-06,9,5,4
1101,Alpha,2.3052039770217305e-06,1.8979287041356905e-06,3,2,1
1102,AlphaGo,2.095639979110664e-07,3.6233184351681345e-06,3,0,3
1103,Alphabet,1.278340387257504e-05,3.6233184351681345e-06,11,6,5
1104,Alpine,2.3052039770217305e-06,3.6233184351681345e-06,3,1,2
1105,Already,9.870464301611217e-05,0.00010714670229711469,116,52,64
1106,Alright,4.400843956132392e-06,3.6233184351681345e-06,4,2,2
1107,Also,7.565260324589493e-05,6.746273848336857e-05,79,38,41
1108,AltRight,1.6974683830796368e-05,1.3975656821362803e-05,16,8,8
1109,Alter,1.48790438516857e-05,3.6233184351681345e-06,9,7,2
1110,Alternate,2.3052039770217305e-06,5.348708166200577e-06,4,1,3
1111,Alternative,3.1644163684570994e-05,2.4327995207557487e-05,31,16,15
1112,Although,5.050492349656699e-05,2.777877466962238e-05,47,28,19
1113,Alto,2.3052039770217305e-06,1.8979287041356905e-06,3,1,2
1114,Alton,2.095639979110664e-07,1.3975656821362803e-05,8,0,8
1115,Altruism,4.400843956132392e-06,1.8979287041356905e-06,3,2,1
1116,Aluminum,6.496483935243052e-06,7.074097897233022e-06,7,3,4
1117,Alumnus,4.400843956132392e-06,3.6233184351681345e-06,6,4,2
1118,Alvarez,2.3052039770217305e-06,3.6233184351681345e-06,3,1,2
1119,Alvaro,4.400843956132392e-06,1.8979287041356905e-06,4,2,2
1120,Alway,5.6791843433898893e-05,3.985650278684949e-05,58,31,27
1121,Alzheimer,1.278340387257504e-05,2.2602605476525032e-05,23,8,15
1122,Amanda,4.400843956132392e-06,2.087721574549256e-05,15,2,13
1123,Amanpour,6.496483935243052e-06,5.348708166200577e-06,6,3,3
1124,Amateur,4.400843956132392e-06,1.2250267090330355e-05,13,4,9
1125,Amazing,5.888748341300963e-05,3.985650278684949e-05,56,32,24
1126,Amazingly,4.400843956132392e-06,1.8979287041356905e-06,4,2,2
1127,Amazon,0.0002349212416583052,0.00024345249104867797,286,129,157
1128,Amazoncom,4.400843956132392e-06,3.6233184351681345e-06,5,2,3
1129,Amazonian,6.496483935243052e-06,1.052487735929791e-05,11,5,6
1130,Ambassador,8.403516316233764e-05,7.263890767646595e-05,92,46,46
1131,Amber,2.095639979110664e-07,1.8979287041356905e-06,3,1,2
1132,Ambition,6.496483935243052e-06,7.074097897233022e-06,7,3,4
1133,Ambitiou,4.400843956132392e-06,1.3975656821362803e-05,12,3,9
1134,Ambulance,6.496483935243052e-06,3.6233184351681345e-06,5,3,2
1135,Ambush,2.095639979110664e-07,5.348708166200577e-06,3,0,3
1136,Amelia,2.095639979110664e-07,3.6233184351681345e-06,6,4,2
1137,Amend,2.095639979110664e-07,5.348708166200577e-06,4,1,3
1138,Amending,6.496483935243052e-06,1.7253897310324457e-07,3,3,0
1139,Amendment,9.451336305789087e-05,0.00012094982014537423,130,52,78
1140,AmeriCorp,6.496483935243052e-06,1.052487735929791e-05,9,3,6
1141,America,0.0011528115525087758,0.0010975204079097384,1325,610,715
1142,American,0.002076988783296577,0.0021137749594878482,2504,1117,1387
1143,AmericanIslamic,2.3052039770217305e-06,3.6233184351681345e-06,3,1,2
1144,Americanmade,6.496483935243052e-06,1.8979287041356905e-06,4,3,1
1145,Americans,8.592123914353715e-06,5.348708166200577e-06,8,5,3
1146,Americanstyle,2.3052039770217305e-06,3.6233184351681345e-06,3,1,2
1147,Amid,0.00014271308257743603,0.00017788768126944505,186,74,112
1148,Amidst,4.400843956132392e-06,1.570104655239525e-05,11,2,9
1149,Amir,2.3052039770217305e-06,3.6233184351681345e-06,4,1,3
1150,Amman,2.3052039770217305e-06,3.6233184351681345e-06,3,1,2
1151,Ammo,4.400843956132392e-06,7.074097897233022e-06,6,2,4
1152,Ammon,1.0687763893464371e-05,5.348708166200577e-06,10,6,4
1153,Ammunition,8.592123914353715e-06,5.348708166200577e-06,7,4,3
1154,Amnesia,2.095639979110664e-07,3.6233184351681345e-06,3,0,3
1155,Amnesty,9.03220830996695e-05,9.851975364195259e-05,109,49,60
1156,Amo,8.592123914353715e-06,1.8979287041356905e-06,6,4,2
1157,Amok,2.095639979110664e-07,5.348708166200577e-06,3,0,3
1158,Among,0.00010499156295344414,8.816741525575797e-05,112,52,60
1159,Amongst,2.095639979110664e-07,3.6233184351681345e-06,3,0,3
1160,Amount,1.0687763893464371e-05,1.052487735929791e-05,12,6,6
1161,Amp,6.496483935243052e-06,3.6233184351681345e-06,5,3,2
1162,Amphipoli,4.400843956132392e-06,1.8979287041356905e-06,3,2,1
1163,Amplify,4.400843956132392e-06,3.6233184351681345e-06,4,2,2
1164,Amputation,2.3052039770217305e-06,3.6233184351681345e-06,3,1,2
1165,Amputee,4.400843956132392e-06,8.79948762826546e-06,8,3,5
1166,Amsterdam,3.3739803663681634e-05,3.468033359375216e-05,37,17,20
1167,Amtrak,6.496483935243052e-06,1.8979287041356905e-06,6,5,1
1168,Amur,4.400843956132392e-06,3.6233184351681345e-06,4,2,2
1169,Amy,1.9070323809907035e-05,2.4327995207557487e-05,23,9,14
1170,An,4.400843956132392e-06,5.348708166200577e-06,5,2,3
1171,Ana,6.496483935243052e-06,3.6233184351681345e-06,5,3,2
1172,Anal,2.3052039770217305e-06,3.6233184351681345e-06,3,1,2
1173,Analogy,4.400843956132392e-06,1.8979287041356905e-06,3,2,1
1174,Analysi,2.326160376812834e-05,1.570104655239525e-05,23,13,10
1175,Analyst,1.278340387257504e-05,1.570104655239525e-05,18,7,11
1176,Analytic,2.3052039770217305e-06,8.79948762826546e-06,6,1,5
1177,Analytica,2.7452883726349685e-05,1.3975656821362803e-05,24,16,8
1178,Anarchist,4.400843956132392e-06,1.8979287041356905e-06,5,2,3
1179,Anarchy,2.3052039770217305e-06,5.348708166200577e-06,4,1,3
1180,Anatoly,4.400843956132392e-06,3.6233184351681345e-06,4,2,2
1181,Ancestor,2.3052039770217305e-06,5.348708166200577e-06,4,1,3
1182,Ancestry,2.3052039770217305e-06,7.074097897233022e-06,5,1,4
1183,Anchor,8.592123914353715e-06,1.742643628342769e-05,15,5,10
1184,Ancient,4.840928351745632e-05,5.1934230904076595e-05,60,25,35
1185,And,6.496483935243052e-06,3.6233184351681345e-06,5,3,2
1186,Ande,2.3052039770217305e-06,5.348708166200577e-06,7,3,4
1187,Ander,2.326160376812834e-05,2.2602605476525032e-05,29,13,16
1188,Andersen,2.3052039770217305e-06,3.6233184351681345e-06,3,1,2
1189,Anderson,1.48790438516857e-05,2.087721574549256e-05,22,9,13
1190,Andre,8.592123914353715e-06,5.348708166200577e-06,8,4,4
1191,Andrea,2.3052039770217305e-06,1.8979287041356905e-06,3,1,2
1192,Andreessen,6.496483935243052e-06,1.8979287041356905e-06,4,3,1
1193,Andrew,9.24177230787802e-05,0.00011404826122124471,121,47,74
1194,Android,1.6974683830796368e-05,2.6053384938589907e-05,23,8,15
1195,Andy,2.116596378901769e-05,3.2954943862719716e-05,31,10,21
1196,Anecdote,2.3052039770217305e-06,1.8979287041356905e-06,3,1,2
1197,Angel,8.592123914353715e-06,1.2250267090330355e-05,13,6,7
1198,Angela,8.613080314144832e-05,5.711040009717395e-05,86,48,38
1199,Angele,5.888748341300963e-05,5.3659620635109e-05,67,31,36
1200,Angelina,2.3052039770217305e-06,3.6233184351681345e-06,3,1,2
1201,Angelou,2.095639979110664e-07,1.052487735929791e-05,6,0,6
1202,Anger,4.4218003559234974e-05,3.468033359375216e-05,48,26,22
1203,Angered,1.0687763893464371e-05,3.6233184351681345e-06,8,6,2
1204,Anglin,2.095639979110664e-07,8.79948762826546e-06,6,0,6
1205,Anglo,4.400843956132392e-06,1.8979287041356905e-06,3,2,1
1206,Angola,8.592123914353715e-06,8.79948762826546e-06,9,4,5
1207,Angry,4.212236358012434e-05,6.746273848336857e-05,65,23,42
1208,Angst,4.400843956132392e-06,5.348708166200577e-06,5,2,3
1209,AnheuserBusch,2.3052039770217305e-06,5.348708166200577e-06,4,1,3
1210,Animal,6.936568330856297e-05,8.299124606266055e-05,88,38,50
1211,Animated,2.3052039770217305e-06,1.8979287041356905e-06,3,2,1
1212,Animation,8.592123914353715e-06,3.6233184351681345e-06,7,5,2
1213,Animatronic,2.3052039770217305e-06,3.6233184351681345e-06,4,1,3
1214,Anita,6.496483935243052e-06,1.742643628342769e-05,14,4,10
1215,Ankara,2.326160376812834e-05,2.6053384938589907e-05,27,11,16
1216,Ann,6.496483935243052e-06,2.9504164400654783e-05,23,3,20
1217,Anna,1.9070323809907035e-05,1.570104655239525e-05,18,9,9
1218,Annan,1.0687763893464371e-05,5.348708166200577e-06,10,7,3
1219,Anne,8.592123914353715e-06,1.052487735929791e-05,13,6,7
1220,Annexation,2.3052039770217305e-06,7.074097897233022e-06,5,1,4
1221,Anniversary,4.6313643538345614e-05,4.1581892517881935e-05,50,24,26
1222,Announce,0.00012385232276544028,0.00012094982014537423,142,67,75
1223,Announced,1.6974683830796368e-05,3.6233184351681345e-06,10,8,2
1224,Announcement,2.954852370546031e-05,1.9151826014460126e-05,27,14,13
1225,Announcing,6.496483935243052e-06,7.074097897233022e-06,7,3,4
1226,Annoying,8.592123914353715e-06,5.348708166200577e-06,9,5,4
1227,Annual,2.116596378901769e-05,1.3975656821362803e-05,19,10,9
1228,Annuity,4.400843956132392e-06,3.6233184351681345e-06,5,3,2
1229,Anon,2.095639979110664e-07,5.348708166200577e-06,5,1,4
1230,Anonymity,4.400843956132392e-06,3.6233184351681345e-06,4,2,2
1231,Anonymou,0.00012385232276544028,0.00012094982014537423,141,63,78
1232,Another,0.00031874684082273133,0.00035387743383475447,393,163,230
1233,Answer,7.146132328767358e-05,7.954046660059569e-05,88,37,51
1234,Answered,6.496483935243052e-06,7.074097897233022e-06,7,3,4
1235,Answering,6.496483935243052e-06,3.6233184351681345e-06,5,3,2
1236,Antarctic,2.954852370546031e-05,5.883578982820635e-05,51,15,36
1237,Antarctica,2.954852370546031e-05,2.9504164400654783e-05,36,16,20
1238,Antare,2.3052039770217305e-06,1.8979287041356905e-06,3,1,2
1239,Anthem,1.6974683830796368e-05,1.9151826014460126e-05,20,9,11
1240,Anthony,8.613080314144832e-05,6.746273848336857e-05,88,42,46
1241,Anthrax,8.592123914353715e-06,1.8979287041356905e-06,6,4,2
1242,AntiAbortion,4.4218003559234974e-05,3.2954943862719716e-05,48,23,25
1243,AntiAircraft,4.400843956132392e-06,1.8979287041356905e-06,3,2,1
1244,AntiAmerican,2.3052039770217305e-06,3.6233184351681345e-06,3,1,2
1245,AntiBullying,4.400843956132392e-06,3.6233184351681345e-06,4,2,2
1246,AntiChoice,4.400843956132392e-06,1.8979287041356905e-06,3,2,1
1247,AntiClinton,2.3052039770217305e-06,3.6233184351681345e-06,3,1,2
1248,AntiCorruption,2.3052039770217305e-06,8.79948762826546e-06,6,1,5
1249,AntiDefamation,1.6974683830796368e-05,3.6233184351681345e-06,12,8,4
1250,AntiDiscrimination,2.3052039770217305e-06,7.074097897233022e-06,5,1,4
1251,AntiDiversity,6.496483935243052e-06,1.7253897310324457e-07,4,4,0
1252,AntiDrug,2.095639979110664e-07,7.074097897233022e-06,5,1,4
1253,AntiGay,1.48790438516857e-05,2.6053384938589907e-05,28,9,19
1254,AntiGovernment,4.400843956132392e-06,7.074097897233022e-06,6,2,4
1255,AntiHomosexuality,2.3052039770217305e-06,5.348708166200577e-06,4,1,3
1256,AntiISI,2.3052039770217305e-06,5.348708166200577e-06,4,1,3
1257,AntiImmigrant,1.0687763893464371e-05,1.3975656821362803e-05,15,5,10
1258,AntiImmigration,4.400843956132392e-06,5.348708166200577e-06,5,2,3
1259,AntiIslam,4.400843956132392e-06,5.348708166200577e-06,5,2,3
1260,AntiIslamic,4.400843956132392e-06,5.348708166200577e-06,5,2,3
1261,AntiIsrael,6.496483935243052e-06,3.6233184351681345e-06,6,3,3
1262,AntiLGBT,3.1644163684570994e-05,3.640572332478458e-05,37,15,22
1263,AntiLGBTQ,1.0687763893464371e-05,8.79948762826546e-06,11,6,5
1264,AntiMuslim,4.002672360101368e-05,3.122955413168725e-05,41,20,21
1265,AntiObamacare,4.400843956132392e-06,1.7253897310324457e-07,4,3,1
1266,AntiPiracy,4.400843956132392e-06,7.074097897233022e-06,6,2,4
1267,AntiPoverty,2.095639979110664e-07,7.074097897233022e-06,5,0,5
1268,AntiProtest,2.3052039770217305e-06,3.6233184351681345e-06,3,1,2
1269,AntiScience,2.3052039770217305e-06,3.6233184351681345e-06,3,1,2
1270,AntiSemitic,1.6974683830796368e-05,2.4327995207557487e-05,27,10,17
1271,AntiSemitism,2.5357243747239038e-05,1.570104655239525e-05,25,13,12
1272,AntiSharia,2.3052039770217305e-06,3.6233184351681345e-06,3,1,2
1273,AntiTerrorism,4.400843956132392e-06,3.6233184351681345e-06,5,2,3
1274,AntiTran,8.592123914353715e-06,5.348708166200577e-06,8,4,4
1275,AntiTrump,4.4218003559234974e-05,4.50326719799468e-05,50,23,27
1276,AntiU,4.400843956132392e-06,3.6233184351681345e-06,4,2,2
1277,AntiVaccine,2.3052039770217305e-06,8.79948762826546e-06,6,1,5
1278,AntiVax,2.3052039770217305e-06,3.6233184351681345e-06,3,1,2
1279,Antiabortion,2.3052039770217305e-06,3.6233184351681345e-06,3,1,2
1280,Antibiotic,2.3052039770217305e-06,5.348708166200577e-06,4,1,3
1281,Antibioticresistant,2.3052039770217305e-06,3.6233184351681345e-06,3,1,2
1282,Antibody,2.095639979110664e-07,5.348708166200577e-06,3,0,3
1283,Anticipating,2.095639979110664e-07,5.348708166200577e-06,3,0,3
1284,Anticipation,2.095639979110664e-07,5.348708166200577e-06,4,0,4
1285,Anticorruption,4.400843956132392e-06,1.8979287041356905e-06,3,2,1
1286,Antidote,2.3052039770217305e-06,7.074097897233022e-06,5,1,4
1287,Antigay,1.0687763893464371e-05,5.348708166200577e-06,8,5,3
1288,Antigovernment,4.400843956132392e-06,7.074097897233022e-06,6,2,4
1289,Antiimmigrant,2.3052039770217305e-06,1.8979287041356905e-06,3,1,2
1290,Antipiracy,2.3052039770217305e-06,3.6233184351681345e-06,4,2,2
1291,Antiquity,4.400843956132392e-06,5.348708166200577e-06,6,3,3
1292,Antisemitism,2.095639979110664e-07,5.348708166200577e-06,3,0,3
1293,Antitrust,6.496483935243052e-06,5.348708166200577e-06,7,3,4
1294,Antivaccination,2.3052039770217305e-06,1.8979287041356905e-06,3,1,2
1295,Antiwarcom,4.400843956132392e-06,1.8979287041356905e-06,3,2,1
1296,Antoinette,2.3052039770217305e-06,3.6233184351681345e-06,3,1,2
1297,Antonin,2.326160376812834e-05,1.9151826014460126e-05,25,12,13
1298,Antonio,1.6974683830796368e-05,1.742643628342769e-05,22,10,12
1299,Antony,2.3052039770217305e-06,3.6233184351681345e-06,3,1,2
1300,Anwar,4.400843956132392e-06,8.79948762826546e-06,7,2,5
1301,Anxiety,1.0687763893464371e-05,2.087721574549256e-05,18,5,13
1302,Anxiou,4.400843956132392e-06,5.348708166200577e-06,5,2,3
1303,Any,2.3052039770217305e-06,1.8979287041356905e-06,3,2,1
1304,Anybody,2.3052039770217305e-06,7.074097897233022e-06,6,1,5
1305,Anymore,2.7452883726349685e-05,3.2954943862719716e-05,34,13,21
1306,Anyone,4.4218003559234974e-05,6.401195902130366e-05,63,25,38
1307,Anything,3.583544364279237e-05,4.8483451442011706e-05,51,18,33
1308,Anytime,2.3052039770217305e-06,1.052487735929791e-05,7,1,6
1309,Anyway,2.5357243747239038e-05,3.122955413168725e-05,31,13,18
1310,Anywhere,6.496483935243052e-06,1.3975656821362803e-05,11,3,8
1311,Apache,6.496483935243052e-06,5.348708166200577e-06,7,3,4
1312,Apart,2.116596378901769e-05,3.122955413168725e-05,29,10,19
1313,Apartheid,1.9070323809907035e-05,1.742643628342769e-05,23,9,14
1314,Apartment,1.278340387257504e-05,8.79948762826546e-06,11,6,5
1315,Ape,4.400843956132392e-06,5.348708166200577e-06,5,2,3
1316,Apocalypse,6.496483935243052e-06,8.79948762826546e-06,9,3,6
1317,Apollo,8.592123914353715e-06,8.79948762826546e-06,9,4,5
1318,Apologist,2.3052039770217305e-06,1.8979287041356905e-06,3,1,2
1319,Apologize,6.098312339212028e-05,5.020884117304414e-05,64,34,30
1320,Apology,3.3739803663681634e-05,1.742643628342769e-05,28,17,11
1321,App,6.307876337123095e-05,6.056117955923882e-05,71,34,37
1322,Appalachia,2.3052039770217305e-06,7.074097897233022e-06,5,1,4
1323,Appalling,8.592123914353715e-06,3.6233184351681345e-06,6,4,2
1324,Apparel,2.095639979110664e-07,7.074097897233022e-06,4,0,4
1325,Apparent,1.278340387257504e-05,1.052487735929791e-05,13,7,6
1326,Apparently,5.260056347567764e-05,5.1934230904076595e-05,57,26,31
1327,Appeal,0.00010080028299522283,9.506897417988779e-05,119,56,63
1328,Appealing,2.3052039770217305e-06,1.8979287041356905e-06,3,1,2
1329,Appear,5.6791843433898893e-05,6.918812821440096e-05,76,31,45
1330,Appearance,1.278340387257504e-05,1.3975656821362803e-05,14,6,8
1331,Appeared,2.3052039770217305e-06,3.6233184351681345e-06,3,1,2
1332,Appease,2.3052039770217305e-06,7.074097897233022e-06,5,1,4
1333,Applaud,6.496483935243052e-06,8.79948762826546e-06,9,3,6
1334,Applause,4.400843956132392e-06,1.8979287041356905e-06,4,2,2
1335,Apple,0.000304077360968957,0.0002503540499728076,319,152,167
1336,Applicant,4.400843956132392e-06,3.6233184351681345e-06,4,2,2
1337,Application,2.116596378901769e-05,1.2250267090330355e-05,17,10,7
1338,Applied,2.3052039770217305e-06,5.348708166200577e-06,4,1,3
1339,Apply,1.9070323809907035e-05,1.3975656821362803e-05,19,10,9
1340,Applying,6.496483935243052e-06,1.8979287041356905e-06,6,4,2
1341,Appoint,4.400843956132392e-06,8.79948762826546e-06,8,3,5
1342,Appointed,1.0687763893464371e-05,8.79948762826546e-06,10,5,5
1343,Appointee,8.592123914353715e-06,5.348708166200577e-06,8,4,4
1344,Appointing,4.400843956132392e-06,3.6233184351681345e-06,4,2,2
1345,Appointment,4.400843956132392e-06,1.3975656821362803e-05,11,3,8
1346,Appreciate,6.496483935243052e-06,1.8979287041356905e-06,4,3,1
1347,Apprentice,1.9070323809907035e-05,2.087721574549256e-05,23,9,14
1348,Approach,3.7931083621902995e-05,4.8483451442011706e-05,50,20,30
1349,Appropriate,4.400843956132392e-06,7.074097897233022e-06,7,3,4
1350,Appropriation,4.400843956132392e-06,1.8979287041356905e-06,4,2,2
1351,Approval,3.1644163684570994e-05,3.2954943862719716e-05,42,22,20
1352,Approve,5.888748341300963e-05,6.573734875233614e-05,74,31,43
1353,Approved,8.592123914353715e-06,5.348708166200577e-06,9,5,4
1354,Approving,6.496483935243052e-06,1.8979287041356905e-06,4,3,1
1355,Approximately,4.400843956132392e-06,7.074097897233022e-06,6,2,4
1356,April,0.00015738256243121094,0.00015028144557292604,178,79,99
1357,Ara,2.3052039770217305e-06,7.074097897233022e-06,5,1,4
1358,Arab,0.0003229381207809529,0.00029521418297965093,362,166,196
1359,ArabAmerican,4.400843956132392e-06,3.6233184351681345e-06,4,2,2
1360,ArabIsraeli,2.3052039770217305e-06,1.8979287041356905e-06,3,1,2
1361,Arabia,0.0003962855200498262,0.0003711313311450788,450,204,246
1362,Arabian,2.954852370546031e-05,2.6053384938589907e-05,32,15,17
1363,Arabic,2.954852370546031e-05,2.6053384938589907e-05,32,15,17
1364,Arafat,1.48790438516857e-05,1.3975656821362803e-05,15,7,8
1365,Arbery,6.496483935243052e-06,1.8979287041356905e-06,6,3,3
1366,Arch,2.095639979110664e-07,5.348708166200577e-06,3,0,3
1367,Archaeologist,2.954852370546031e-05,3.8131113055817005e-05,41,17,24
1368,Archaic,4.400843956132392e-06,1.8979287041356905e-06,3,2,1
1369,Archbishop,3.583544364279237e-05,1.570104655239525e-05,27,17,10
1370,Archeologist,8.592123914353715e-06,5.348708166200577e-06,7,4,3
1371,Archie,4.400843956132392e-06,3.6233184351681345e-06,4,2,2
1372,Architect,6.496483935243052e-06,7.074097897233022e-06,9,5,4
1373,Archive,1.278340387257504e-05,7.074097897233022e-06,11,6,5
1374,Arctic,0.00013013924270277222,0.00011922443041434203,147,70,77
1375,Are,2.095639979110664e-07,5.348708166200577e-06,3,0,3
1376,Area,4.840928351745632e-05,4.1581892517881935e-05,52,27,25
1377,Aren,1.0687763893464371e-05,1.742643628342769e-05,17,6,11
1378,Arena,4.400843956132392e-06,1.8979287041356905e-06,3,2,1
1379,Argentina,0.00010499156295344414,0.0001364783277246665,143,55,88
1380,Argentine,5.4696203454788295e-05,3.985650278684949e-05,51,28,23
1381,Argentinian,1.0687763893464371e-05,1.052487735929791e-05,12,5,7
1382,Argue,1.9070323809907035e-05,1.2250267090330355e-05,20,10,10
1383,Arguing,1.0687763893464371e-05,1.8979287041356905e-06,6,5,1
1384,Argument,4.212236358012434e-05,3.985650278684949e-05,46,21,25
1385,Arianna,4.400843956132392e-06,5.348708166200577e-06,6,2,4
1386,Ariel,8.592123914353715e-06,1.8979287041356905e-06,5,4,1
1387,Arizona,0.00011966104280721883,9.851975364195259e-05,133,66,67
1388,Ark,2.3052039770217305e-06,1.7253897310324457e-07,3,2,1
1389,Arkansa,2.5357243747239038e-05,5.883578982820635e-05,57,20,37
1390,Arkansan,2.095639979110664e-07,5.348708166200577e-06,3,0,3
1391,Arlington,4.400843956132392e-06,7.074097897233022e-06,7,3,4
1392,Arm,6.098312339212028e-05,7.608968713853079e-05,83,34,49
1393,Armageddon,2.3052039770217305e-06,5.348708166200577e-06,4,1,3
1394,Armed,6.936568330856297e-05,6.401195902130366e-05,81,40,41
1395,Armenia,2.7452883726349685e-05,2.4327995207557487e-05,28,13,15
1396,Armenian,8.403516316233764e-05,6.573734875233614e-05,85,41,44
1397,Arming,4.400843956132392e-06,8.79948762826546e-06,8,3,5
1398,Armored,2.3052039770217305e-06,3.6233184351681345e-06,3,1,2
1399,Armstrong,4.400843956132392e-06,3.6233184351681345e-06,4,2,2
1400,Army,0.00027683404124051843,0.0002451778807797103,309,150,159
1401,Arne,4.400843956132392e-06,3.6233184351681345e-06,4,2,2
1402,Arnold,6.496483935243052e-06,1.3975656821362803e-05,12,4,8
1403,Around,0.00010918284291166549,0.00011577365095227703,130,58,72
1404,Arpaio,3.583544364279237e-05,5.1934230904076595e-05,52,19,33
1405,Arrest,8.822644312055891e-05,0.00010714670229711469,120,50,70
1406,Arrested,0.00011337412286988677,0.0001364783277246665,144,60,84
1407,Arresting,8.592123914353715e-06,3.6233184351681345e-06,6,4,2
1408,Arrival,1.0687763893464371e-05,1.3975656821362803e-05,15,7,8
1409,Arrive,1.48790438516857e-05,1.052487735929791e-05,15,8,7
1410,Arrived,4.400843956132392e-06,5.348708166200577e-06,6,2,4
1411,Arriving,4.400843956132392e-06,3.6233184351681345e-06,4,2,2
1412,Arrogance,4.400843956132392e-06,3.6233184351681345e-06,4,2,2
1413,Arrogant,4.400843956132392e-06,3.6233184351681345e-06,4,2,2
1414,Arrow,2.3052039770217305e-06,3.6233184351681345e-06,4,1,3
1415,Arsenal,4.400843956132392e-06,5.348708166200577e-06,7,3,4
1416,Arson,2.3052039770217305e-06,3.6233184351681345e-06,3,1,2
1417,Art,7.146132328767358e-05,7.608968713853079e-05,85,35,50
1418,Arthur,4.400843956132392e-06,7.074097897233022e-06,7,2,5
1419,Article,2.7452883726349685e-05,3.640572332478458e-05,39,15,24
1420,Artifact,2.095639979110664e-07,3.6233184351681345e-06,3,1,2
1421,Artificial,1.0687763893464371e-05,7.074097897233022e-06,11,5,6
1422,Artist,4.4218003559234974e-05,2.9504164400654783e-05,41,22,19
1423,Arundhati,6.496483935243052e-06,5.348708166200577e-06,6,3,3
1424,As,6.496483935243052e-06,8.79948762826546e-06,9,3,6
1425,Asbesto,4.400843956132392e-06,3.6233184351681345e-06,4,2,2
1426,Ash,8.592123914353715e-06,1.9151826014460126e-05,15,4,11
1427,Ashamed,8.592123914353715e-06,8.79948762826546e-06,15,7,8
1428,Ashkelon,2.3052039770217305e-06,3.6233184351681345e-06,3,1,2
1429,Ashley,3.3739803663681634e-05,7.074097897233022e-06,21,17,4
1430,Ashraf,2.3052039770217305e-06,5.348708166200577e-06,5,2,3
1431,Ashton,4.400843956132392e-06,5.348708166200577e-06,5,2,3
1432,Asia,0.00014061744259832545,0.00011404826122124471,151,74,77
1433,AsiaPacific,4.400843956132392e-06,1.8979287041356905e-06,4,3,1
1434,Asian,0.00014690436253565753,0.00011232287149021227,146,77,69
1435,AsianAmerican,2.326160376812834e-05,4.50326719799468e-05,40,14,26
1436,Aside,1.0687763893464371e-05,1.570104655239525e-05,16,5,11
1437,Ask,0.0002244430417627521,0.00020376852723493182,248,120,128
1438,Asked,7.355696326678427e-05,7.954046660059569e-05,91,39,52
1439,Asking,3.1644163684570994e-05,3.985650278684949e-05,39,16,23
1440,Asleep,4.400843956132392e-06,5.348708166200577e-06,5,2,3
1441,Asmaa,2.3052039770217305e-06,1.8979287041356905e-06,3,2,1
1442,Aspen,6.496483935243052e-06,3.6233184351681345e-06,5,3,2
1443,Asperger,6.496483935243052e-06,1.8979287041356905e-06,5,3,2
1444,Aspiring,4.400843956132392e-06,1.8979287041356905e-06,3,2,1
1445,Assad,0.00014480872255654665,0.00015028144557292604,167,73,94
1446,Assail,6.496483935243052e-06,1.8979287041356905e-06,5,4,1
1447,Assam,6.496483935243052e-06,5.348708166200577e-06,6,3,3
1448,Assange,0.0002265386817418625,0.00027450950620726186,310,125,185
1449,Assassin,6.496483935243052e-06,1.7253897310324457e-07,3,3,0
1450,Assassinate,4.400843956132392e-06,1.8979287041356905e-06,3,2,1
1451,Assassinated,4.400843956132392e-06,3.6233184351681345e-06,4,2,2
1452,Assassination,1.0687763893464371e-05,1.3975656821362803e-05,17,6,11
1453,Assault,0.00012804360272366158,7.781507686956326e-05,116,62,54
1454,Assaulted,1.0687763893464371e-05,1.3975656821362803e-05,13,5,8
1455,Assaulting,1.48790438516857e-05,8.79948762826546e-06,14,8,6
1456,Assembly,4.840928351745632e-05,5.020884117304414e-05,59,26,33
1457,Assemblyman,2.3052039770217305e-06,3.6233184351681345e-06,4,1,3
1458,Assert,2.3052039770217305e-06,3.6233184351681345e-06,3,1,2
1459,Assessment,4.400843956132392e-06,1.052487735929791e-05,9,2,7
1460,Asset,2.116596378901769e-05,1.570104655239525e-05,20,10,10
1461,Assigned,2.3052039770217305e-06,1.8979287041356905e-06,3,2,1
1462,Assistance,1.48790438516857e-05,1.570104655239525e-05,17,8,9
1463,Assistant,1.48790438516857e-05,1.2250267090330355e-05,15,7,8
1464,Assisted,6.496483935243052e-06,1.052487735929791e-05,9,3,6
1465,Associate,6.496483935243052e-06,1.9151826014460126e-05,14,3,11
1466,Associated,2.7452883726349685e-05,3.468033359375216e-05,37,15,22
1467,Association,5.260056347567764e-05,5.1934230904076595e-05,65,26,39
1468,Assume,6.496483935243052e-06,7.074097897233022e-06,7,3,4
1469,Assuming,4.400843956132392e-06,3.6233184351681345e-06,4,2,2
1470,Assyrian,1.48790438516857e-05,3.6233184351681345e-06,13,8,5
1471,Asteroid,1.0687763893464371e-05,1.570104655239525e-05,15,6,9
1472,Astonished,4.400843956132392e-06,1.8979287041356905e-06,3,2,1
1473,Astounding,2.3052039770217305e-06,1.8979287041356905e-06,3,1,2
1474,AstraZeneca,4.400843956132392e-06,1.8979287041356905e-06,3,2,1
1475,Astronaut,2.5357243747239038e-05,4.6758061710979285e-05,42,12,30
1476,Astronomer,2.5357243747239038e-05,2.2602605476525032e-05,29,13,16
1477,Astrophysicist,2.3052039770217305e-06,5.348708166200577e-06,4,1,3
1478,Astute,4.400843956132392e-06,1.8979287041356905e-06,3,2,1
1479,Asylum,4.002672360101368e-05,2.777877466962238e-05,37,20,17
1480,AsylumSeeker,1.0687763893464371e-05,5.348708166200577e-06,9,5,4
1481,Ate,2.3052039770217305e-06,3.6233184351681345e-06,3,1,2
1482,Atheism,6.496483935243052e-06,1.8979287041356905e-06,5,3,2
1483,Atheist,2.326160376812834e-05,2.6053384938589907e-05,29,13,16
1484,Athen,4.212236358012434e-05,5.1934230904076595e-05,59,25,34
1485,Athenian,4.400843956132392e-06,3.6233184351681345e-06,5,3,2
1486,Athlete,1.0687763893464371e-05,2.087721574549256e-05,22,8,14
1487,Atla,1.278340387257504e-05,3.6233184351681345e-06,8,6,2
1488,Atlanta,1.9070323809907035e-05,1.3975656821362803e-05,19,10,9
1489,Atlanti,2.3052039770217305e-06,5.348708166200577e-06,4,1,3
1490,Atlantic,5.4696203454788295e-05,6.228656929027126e-05,72,29,43
1491,Atmosphere,2.3052039770217305e-06,3.6233184351681345e-06,5,3,2
1492,Atmospheric,2.3052039770217305e-06,3.6233184351681345e-06,4,1,3
1493,Atom,2.3052039770217305e-06,5.348708166200577e-06,4,1,3
1494,Atomic,6.496483935243052e-06,1.052487735929791e-05,11,4,7
1495,Atop,2.3052039770217305e-06,3.6233184351681345e-06,3,1,2
1496,Atrocity,4.400843956132392e-06,1.052487735929791e-05,8,2,6
1497,Attack,0.0004801111192142529,0.00046602776635186325,561,253,308
1498,Attacked,3.1644163684570994e-05,3.468033359375216e-05,37,16,21
1499,Attacker,1.9070323809907035e-05,1.742643628342769e-05,19,9,10
1500,Attacking,5.260056347567764e-05,2.6053384938589907e-05,43,28,15
1501,Attempt,7.146132328767358e-05,7.263890767646595e-05,85,38,47
1502,Attempted,1.0687763893464371e-05,1.570104655239525e-05,15,5,10
1503,Attenborough,1.0687763893464371e-05,1.3975656821362803e-05,15,6,9
1504,Attend,1.278340387257504e-05,1.742643628342769e-05,20,9,11
1505,Attendance,4.400843956132392e-06,1.7253897310324457e-07,3,3,0
1506,Attendant,4.400843956132392e-06,3.6233184351681345e-06,5,3,2
1507,Attended,8.592123914353715e-06,1.7253897310324457e-07,5,5,0
1508,Attendee,8.592123914353715e-06,7.074097897233022e-06,8,4,4
1509,Attending,2.095639979110664e-07,3.6233184351681345e-06,3,0,3
1510,Attention,1.9070323809907035e-05,5.020884117304414e-05,48,14,34
1511,Attitude,1.48790438516857e-05,1.742643628342769e-05,20,9,11
1512,Attorney,0.0002055822819507562,0.00019341618884873702,235,109,126
1513,Attract,2.3052039770217305e-06,7.074097897233022e-06,7,2,5
1514,Attracting,2.3052039770217305e-06,3.6233184351681345e-06,3,1,2
1515,Attractive,2.3052039770217305e-06,1.7253897310324457e-07,3,2,1
1516,Au,2.3052039770217305e-06,3.6233184351681345e-06,3,1,2
1517,Auckland,6.496483935243052e-06,1.052487735929791e-05,9,3,6
1518,Auction,1.9070323809907035e-05,1.742643628342769e-05,23,11,12
1519,Auctioned,4.400843956132392e-06,1.8979287041356905e-06,3,2,1
1520,Audi,6.496483935243052e-06,1.052487735929791e-05,11,4,7
1521,Audience,1.0687763893464371e-05,7.074097897233022e-06,9,5,4
1522,Audio,8.592123914353715e-06,1.2250267090330355e-05,11,4,7
1523,Audit,1.48790438516857e-05,7.074097897233022e-06,13,8,5
1524,Audited,8.592123914353715e-06,1.8979287041356905e-06,5,4,1
1525,Auditor,6.496483935243052e-06,1.8979287041356905e-06,4,3,1
1526,Aug,1.6974683830796368e-05,2.2602605476525032e-05,25,10,15
1527,August,9.24177230787802e-05,0.00010024514337298497,113,49,64
1528,Aung,2.954852370546031e-05,1.052487735929791e-05,21,14,7
1529,Aurora,6.496483935243052e-06,3.6233184351681345e-06,6,4,2
1530,Auschwitz,2.116596378901769e-05,4.330728224891437e-05,37,11,26
1531,Aussie,2.116596378901769e-05,2.6053384938589907e-05,30,14,16
1532,Austerity,2.116596378901769e-05,2.2602605476525032e-05,29,12,17
1533,Austin,2.5357243747239038e-05,2.9504164400654783e-05,31,13,18
1534,Australia,0.0005199282788173553,0.0005091625096276747,593,271,322
1535,Australian,0.0005262151987546874,0.0005057117301656093,611,277,334
1536,Austria,3.3739803663681634e-05,4.330728224891437e-05,45,18,27
1537,Austrian,2.326160376812834e-05,2.4327995207557487e-05,25,11,14
1538,Authentic,6.496483935243052e-06,3.6233184351681345e-06,5,3,2
1539,Author,2.7452883726349685e-05,4.1581892517881935e-05,39,15,24
1540,Authoritarian,1.0687763893464371e-05,5.348708166200577e-06,8,5,3
1541,Authoritarianism,6.496483935243052e-06,1.8979287041356905e-06,6,3,3
1542,Authority,0.00010918284291166549,0.00012267520987640663,139,61,78
1543,Authorization,8.592123914353715e-06,1.3975656821362803e-05,13,4,9
1544,Authorize,4.400843956132392e-06,5.348708166200577e-06,6,2,4
1545,Autism,2.7452883726349685e-05,2.777877466962238e-05,31,13,18
1546,Autistic,4.400843956132392e-06,3.6233184351681345e-06,4,2,2
1547,Auto,1.6974683830796368e-05,1.570104655239525e-05,20,9,11
1548,Automaker,4.400843956132392e-06,5.348708166200577e-06,6,2,4
1549,Automated,4.400843956132392e-06,3.6233184351681345e-06,4,2,2
1550,Automatic,8.592123914353715e-06,1.8979287041356905e-06,6,4,2
1551,Automatically,4.400843956132392e-06,8.79948762826546e-06,7,2,5
1552,Automobile,2.095639979110664e-07,3.6233184351681345e-06,3,0,3
1553,Autonomou,2.3052039770217305e-06,3.6233184351681345e-06,3,1,2
1554,Autonomy,2.095639979110664e-07,5.348708166200577e-06,3,0,3
1555,Autopilot,2.3052039770217305e-06,1.2250267090330355e-05,9,2,7
1556,Autopsy,8.592123914353715e-06,5.348708166200577e-06,8,4,4
1557,Available,8.592123914353715e-06,1.8979287041356905e-06,5,4,1
1558,Avalanche,4.400843956132392e-06,5.348708166200577e-06,5,2,3
1559,Avenatti,1.278340387257504e-05,3.6233184351681345e-06,8,6,2
1560,Avenue,1.278340387257504e-05,3.6233184351681345e-06,8,6,2
1561,Average,1.48790438516857e-05,3.122955413168725e-05,27,7,20
1562,Avert,1.6974683830796368e-05,8.79948762826546e-06,14,9,5
1563,Averting,6.496483935243052e-06,1.8979287041356905e-06,5,3,2
1564,Aviation,2.3052039770217305e-06,5.348708166200577e-06,5,1,4
1565,Avigdor,4.400843956132392e-06,8.79948762826546e-06,7,2,5
1566,Aviv,2.954852370546031e-05,2.2602605476525032e-05,29,14,15
1567,Avocado,6.496483935243052e-06,1.7253897310324457e-07,3,3,0
1568,Avoid,9.03220830996695e-05,9.334358444885519e-05,107,46,61
1569,Avoided,6.496483935243052e-06,8.79948762826546e-06,8,3,5
1570,Avoiding,8.592123914353715e-06,8.79948762826546e-06,13,5,8
1571,Await,6.496483935243052e-06,8.79948762826546e-06,9,4,5
1572,Awaiting,1.0687763893464371e-05,1.7253897310324457e-07,5,5,0
1573,Awakened,4.400843956132392e-06,1.8979287041356905e-06,3,2,1
1574,Awakening,4.400843956132392e-06,3.6233184351681345e-06,4,2,2
1575,Award,4.002672360101368e-05,3.468033359375216e-05,45,22,23
1576,Awarded,8.592123914353715e-06,5.348708166200577e-06,8,4,4
1577,Awardwinning,4.400843956132392e-06,3.6233184351681345e-06,4,2,2
1578,Aware,2.3052039770217305e-06,3.6233184351681345e-06,3,1,2
1579,Awarenes,2.5357243747239038e-05,2.2602605476525032e-05,29,15,14
1580,Away,0.00012385232276544028,0.00012267520987640663,147,67,80
1581,Awe,2.3052039770217305e-06,3.6233184351681345e-06,5,2,3
1582,Awesome,1.9070323809907035e-05,1.570104655239525e-05,20,11,9
1583,Awful,2.116596378901769e-05,1.742643628342769e-05,20,10,10
1584,Awfully,2.3052039770217305e-06,3.6233184351681345e-06,3,1,2
1585,Awkward,1.48790438516857e-05,2.6053384938589907e-05,26,9,17
1586,Awkwardly,2.3052039770217305e-06,1.8979287041356905e-06,3,1,2
1587,Awry,2.3052039770217305e-06,7.074097897233022e-06,5,1,4
1588,Awww,2.3052039770217305e-06,1.8979287041356905e-06,4,2,2
1589,Ax,2.3052039770217305e-06,5.348708166200577e-06,4,1,3
1590,Axe,8.592123914353715e-06,3.6233184351681345e-06,6,4,2
1591,Axelrod,2.095639979110664e-07,5.348708166200577e-06,3,0,3
1592,Axi,4.400843956132392e-06,5.348708166200577e-06,5,2,3
1593,Axing,2.095639979110664e-07,7.074097897233022e-06,4,0,4
1594,Ayaan,6.496483935243052e-06,1.7253897310324457e-07,3,3,0
1595,Ayanna,2.3052039770217305e-06,8.79948762826546e-06,7,2,5
1596,Ayatollah,4.002672360101368e-05,2.6053384938589907e-05,37,20,17
1597,Ayotte,1.0687763893464371e-05,7.074097897233022e-06,10,6,4
1598,Azar,2.3052039770217305e-06,3.6233184351681345e-06,3,1,2
1599,Azerbaijan,2.326160376812834e-05,2.2602605476525032e-05,28,11,17
1600,Azerbaijani,2.3052039770217305e-06,5.348708166200577e-06,4,1,3
1601,Aziz,8.592123914353715e-06,7.074097897233022e-06,8,4,4
1602,B2,2.095639979110664e-07,7.074097897233022e-06,4,0,4
1603,B2B,2.095639979110664e-07,8.79948762826546e-06,5,0,5
1604,B52,2.095639979110664e-07,1.2250267090330355e-05,7,0,7
1605,BAD,2.095639979110664e-07,3.6233184351681345e-06,3,0,3
1606,BBC,0.00048430239917247403,0.0004315199717312144,523,256,267
1607,BBQ,1.278340387257504e-05,1.8979287041356905e-06,7,6,1
1608,BC,5.050492349656699e-05,4.6758061710979285e-05,57,30,27
1609,BD,2.3052039770217305e-06,3.6233184351681345e-06,3,1,2
1610,BERLIN,2.3052039770217305e-06,3.6233184351681345e-06,4,1,3
1611,BFF,1.0687763893464371e-05,7.074097897233022e-06,9,5,4
1612,BHP,2.3052039770217305e-06,3.6233184351681345e-06,6,1,5
1613,BIG,1.0687763893464371e-05,8.79948762826546e-06,10,5,5
1614,BILLION,4.400843956132392e-06,1.052487735929791e-05,8,2,6
1615,BJP,2.095639979110664e-07,5.348708166200577e-06,3,0,3
1616,BMW,8.592123914353715e-06,1.2250267090330355e-05,15,5,10
1617,BNP,1.0687763893464371e-05,2.087721574549256e-05,26,12,14
1618,BOSTON,4.400843956132392e-06,1.8979287041356905e-06,3,2,1
1619,BP,0.00011127848289077625,8.644202552472544e-05,117,58,59
1620,BREAKING,3.3739803663681634e-05,2.2602605476525032e-05,32,16,16
1621,BREIN,4.400843956132392e-06,1.7253897310324457e-07,3,3,0
1622,BRIC,1.278340387257504e-05,1.742643628342769e-05,16,6,10
1623,BRUSSEL,2.095639979110664e-07,5.348708166200577e-06,3,0,3
1624,BSkyB,1.278340387257504e-05,3.6233184351681345e-06,8,6,2
1625,BT,8.592123914353715e-06,3.6233184351681345e-06,7,4,3
1626,BTselem,2.3052039770217305e-06,5.348708166200577e-06,4,1,3
1627,BUK,4.400843956132392e-06,1.8979287041356905e-06,3,2,1
1628,Baby,0.0001259479627445509,8.989280498679035e-05,129,68,61
1629,Bachelor,2.3052039770217305e-06,7.074097897233022e-06,7,3,4
1630,Bachmann,1.6974683830796368e-05,3.6233184351681345e-06,11,9,2
1631,Back,0.00047382419927692067,0.0004884578328552848,572,250,322
1632,Backbone,4.400843956132392e-06,1.8979287041356905e-06,4,2,2
1633,Backdoor,2.3052039770217305e-06,3.6233184351681345e-06,3,1,2
1634,Backed,8.592123914353715e-06,1.3975656821362803e-05,17,6,11
1635,Backer,1.278340387257504e-05,2.087721574549256e-05,20,7,13
1636,Backfire,1.6974683830796368e-05,1.570104655239525e-05,20,9,11
1637,Backfiring,2.3052039770217305e-06,5.348708166200577e-06,4,1,3
1638,Background,2.116596378901769e-05,1.742643628342769e-05,25,14,11
1639,Backing,2.7452883726349685e-05,2.777877466962238e-05,34,16,18
1640,Backlash,2.326160376812834e-05,3.122955413168725e-05,34,14,20
1641,Backlog,4.400843956132392e-06,3.6233184351681345e-06,4,2,2
1642,Backpack,4.400843956132392e-06,5.348708166200577e-06,5,2,3
1643,Backpedal,2.3052039770217305e-06,5.348708166200577e-06,4,1,3
1644,BacktoSchool,6.496483935243052e-06,1.8979287041356905e-06,4,3,1
1645,Backtrack,4.400843956132392e-06,3.6233184351681345e-06,5,2,3
1646,Backward,4.400843956132392e-06,5.348708166200577e-06,5,2,3
1647,Backyard,2.095639979110664e-07,5.348708166200577e-06,3,0,3
1648,Bacon,1.0687763893464371e-05,1.2250267090330355e-05,13,5,8
1649,Bacterium,6.496483935243052e-06,5.348708166200577e-06,6,3,3
1650,Bad,0.0001971997220343134,0.0002020431375038992,231,101,130
1651,Badas,4.400843956132392e-06,5.348708166200577e-06,5,2,3
1652,Badawi,6.496483935243052e-06,7.074097897233022e-06,7,3,4
1653,Bader,2.7452883726349685e-05,3.985650278684949e-05,39,13,26
1654,Badge,4.400843956132392e-06,3.6233184351681345e-06,4,2,2
1655,Badly,6.496483935243052e-06,1.570104655239525e-05,12,3,9
1656,Bae,2.3052039770217305e-06,3.6233184351681345e-06,3,1,2
1657,Baffle,6.496483935243052e-06,1.7253897310324457e-07,3,3,0
1658,Baffled,8.592123914353715e-06,1.8979287041356905e-06,5,4,1
1659,Bag,1.9070323809907035e-05,2.777877466962238e-05,26,9,17
1660,Baghdad,7.565260324589493e-05,8.989280498679035e-05,100,43,57
1661,Baghdadi,2.3052039770217305e-06,8.79948762826546e-06,7,1,6
1662,Bagram,8.592123914353715e-06,5.348708166200577e-06,9,6,3
1663,Bahama,8.592123914353715e-06,7.074097897233022e-06,10,6,4
1664,Bahrain,0.00013013924270277222,8.4716635793693e-05,122,65,57
1665,Bahraini,1.6974683830796368e-05,1.570104655239525e-05,17,8,9
1666,Bail,2.326160376812834e-05,2.2602605476525032e-05,27,11,16
1667,Bailed,2.3052039770217305e-06,3.6233184351681345e-06,3,1,2
1668,Bailing,6.496483935243052e-06,1.7253897310324457e-07,3,3,0
1669,Bailout,2.326160376812834e-05,1.9151826014460126e-05,23,11,12
1670,Bait,6.496483935243052e-06,7.074097897233022e-06,7,3,4
1671,Baja,4.400843956132392e-06,1.8979287041356905e-06,4,3,1
1672,Baker,2.5357243747239038e-05,5.348708166200577e-06,18,12,6
1673,Bakery,2.3052039770217305e-06,5.348708166200577e-06,4,1,3
1674,Bakr,4.400843956132392e-06,7.074097897233022e-06,6,2,4
1675,Baku,2.095639979110664e-07,3.6233184351681345e-06,3,0,3
1676,Balance,1.6974683830796368e-05,2.087721574549256e-05,25,12,13
1677,Balanced,4.400843956132392e-06,1.8979287041356905e-06,3,2,1
1678,Balancing,6.496483935243052e-06,5.348708166200577e-06,6,3,3
1679,Balcerzak,2.3052039770217305e-06,3.6233184351681345e-06,3,1,2
1680,Bald,2.3052039770217305e-06,3.6233184351681345e-06,3,1,2
1681,Baldwin,1.48790438516857e-05,1.742643628342769e-05,20,9,11
1682,Bale,2.095639979110664e-07,3.6233184351681345e-06,4,2,2
1683,Bali,1.9070323809907035e-05,7.074097897233022e-06,15,11,4
1684,Balk,2.3052039770217305e-06,3.6233184351681345e-06,3,1,2
1685,Balkan,1.0687763893464371e-05,1.052487735929791e-05,11,5,6
1686,Ball,1.278340387257504e-05,2.9504164400654783e-05,25,8,17
1687,Ballet,2.3052039770217305e-06,3.6233184351681345e-06,3,1,2
1688,Ballistic,4.400843956132392e-06,1.8979287041356905e-06,3,2,1
1689,Balloon,4.400843956132392e-06,7.074097897233022e-06,7,2,5
1690,Ballot,6.098312339212028e-05,4.330728224891437e-05,65,31,34
1691,Baltic,2.326160376812834e-05,2.777877466962238e-05,35,12,23
1692,Baltimore,5.050492349656699e-05,4.1581892517881935e-05,58,25,33
1693,Bamako,2.095639979110664e-07,5.348708166200577e-06,3,0,3
1694,Ban,0.0005031631589844702,0.00047120393554496063,568,266,302
1695,Banana,4.400843956132392e-06,3.6233184351681345e-06,4,2,2
1696,Band,2.326160376812834e-05,2.4327995207557487e-05,26,11,15
1697,Bang,1.0687763893464371e-05,1.3975656821362803e-05,15,5,10
1698,Bangalore,8.592123914353715e-06,1.8979287041356905e-06,5,4,1
1699,Bangkok,3.7931083621902995e-05,3.122955413168725e-05,37,19,18
1700,Bangladesh,9.24177230787802e-05,0.0001036959228350498,113,49,64
1701,Bangladeshi,2.116596378901769e-05,2.6053384938589907e-05,28,11,17
1702,Bank,0.0006414753976057738,0.0006506444675723349,763,353,410
1703,Banker,4.6313643538345614e-05,4.6758061710979285e-05,50,23,27
1704,Banking,4.212236358012434e-05,3.640572332478458e-05,48,24,24
1705,Bankrupt,1.0687763893464371e-05,7.074097897233022e-06,11,7,4
1706,Bankruptcy,2.954852370546031e-05,3.8131113055817005e-05,42,19,23
1707,Banksy,4.400843956132392e-06,1.8979287041356905e-06,3,2,1
1708,Banned,5.4696203454788295e-05,3.2954943862719716e-05,47,26,21
1709,Banner,4.400843956132392e-06,1.3975656821362803e-05,10,2,8
1710,Banning,4.002672360101368e-05,3.8131113055817005e-05,42,20,22
1711,Bannon,4.212236358012434e-05,0.00015373222503499084,122,26,96
1712,Baptist,4.400843956132392e-06,8.79948762826546e-06,7,2,5
1713,Bar,4.212236358012434e-05,3.985650278684949e-05,49,21,28
1714,Barack,0.00022025176180453062,0.00020031774777286686,252,124,128
1715,Barak,6.496483935243052e-06,5.348708166200577e-06,8,4,4
1716,Barbara,1.6974683830796368e-05,3.2954943862719716e-05,32,9,23
1717,Barbaric,2.095639979110664e-07,1.8979287041356905e-06,3,1,2
1718,Barber,6.496483935243052e-06,3.6233184351681345e-06,5,3,2
1719,Barcelona,1.9070323809907035e-05,1.9151826014460126e-05,24,12,12
1720,Barclay,3.1644163684570994e-05,1.2250267090330355e-05,24,17,7
1721,Bare,4.400843956132392e-06,5.348708166200577e-06,6,3,3
1722,Barely,1.0687763893464371e-05,1.742643628342769e-05,18,7,11
1723,Barent,2.3052039770217305e-06,3.6233184351681345e-06,3,1,2
1724,Bargain,4.400843956132392e-06,3.6233184351681345e-06,4,2,2
1725,Bari,2.095639979110664e-07,7.074097897233022e-06,4,0,4
1726,Barney,4.400843956132392e-06,5.348708166200577e-06,6,2,4
1727,Barometer,6.496483935243052e-06,1.8979287041356905e-06,4,3,1
1728,Baron,1.278340387257504e-05,5.348708166200577e-06,10,7,3
1729,Barr,1.6974683830796368e-05,1.2250267090330355e-05,18,8,10
1730,Barrage,6.496483935243052e-06,5.348708166200577e-06,6,3,3
1731,Barred,6.496483935243052e-06,1.052487735929791e-05,13,6,7
1732,Barrel,6.496483935243052e-06,1.2250267090330355e-05,11,4,7
1733,Barrett,1.48790438516857e-05,5.348708166200577e-06,10,7,3
1734,Barricade,6.496483935243052e-06,3.6233184351681345e-06,5,3,2
1735,Barrier,7.146132328767358e-05,8.299124606266055e-05,87,36,51
1736,Barring,4.400843956132392e-06,5.348708166200577e-06,7,4,3
1737,Barron,2.3052039770217305e-06,7.074097897233022e-06,5,1,4
1738,Barry,1.0687763893464371e-05,2.087721574549256e-05,17,5,12
1739,Bartender,6.496483935243052e-06,1.8979287041356905e-06,4,3,1
1740,Barton,8.592123914353715e-06,3.6233184351681345e-06,7,5,2
1741,Bas,4.400843956132392e-06,5.348708166200577e-06,5,2,3
1742,Base,5.888748341300963e-05,5.020884117304414e-05,63,31,32
1743,Baseball,2.5357243747239038e-05,1.9151826014460126e-05,25,14,11
1744,Based,3.1644163684570994e-05,4.330728224891437e-05,41,16,25
1745,Baseles,4.400843956132392e-06,1.7253897310324457e-07,3,2,1
1746,Basement,1.0687763893464371e-05,1.7253897310324457e-07,5,5,0
1747,Bash,1.6974683830796368e-05,1.052487735929791e-05,15,8,7
1748,Bashar,6.72700433294523e-05,3.985650278684949e-05,60,32,28
1749,Bashed,2.3052039770217305e-06,3.6233184351681345e-06,3,1,2
1750,Bashing,4.400843956132392e-06,7.074097897233022e-06,6,2,4
1751,Bashir,4.400843956132392e-06,5.348708166200577e-06,7,3,4
1752,Basi,2.3052039770217305e-06,3.6233184351681345e-06,3,1,2
1753,Basic,2.7452883726349685e-05,2.9504164400654783e-05,33,14,19
1754,Basically,2.7452883726349685e-05,1.9151826014460126e-05,28,16,12
1755,Basij,1.0687763893464371e-05,3.6233184351681345e-06,7,5,2
1756,Basin,6.496483935243052e-06,1.8979287041356905e-06,7,3,4
1757,Basketball,6.496483935243052e-06,3.6233184351681345e-06,8,3,5
1758,Basque,6.496483935243052e-06,7.074097897233022e-06,7,3,4
1759,Bassem,4.400843956132392e-06,3.6233184351681345e-06,4,2,2
1760,Bastard,2.3052039770217305e-06,7.074097897233022e-06,5,1,4
1761,Bastille,4.400843956132392e-06,3.6233184351681345e-06,4,2,2
1762,Bastion,4.400843956132392e-06,1.8979287041356905e-06,3,2,1
1763,Bat,1.0687763893464371e-05,1.742643628342769e-05,15,5,10
1764,Bataclan,2.3052039770217305e-06,3.6233184351681345e-06,4,1,3
1765,Bath,2.095639979110664e-07,1.3975656821362803e-05,8,0,8
1766,Bathroom,5.260056347567764e-05,6.228656929027126e-05,68,26,42
1767,Batman,4.400843956132392e-06,1.052487735929791e-05,8,2,6
1768,Baton,6.496483935243052e-06,1.8979287041356905e-06,5,3,2
1769,Battalion,2.095639979110664e-07,3.6233184351681345e-06,3,0,3
1770,Battery,1.0687763893464371e-05,1.2250267090330355e-05,16,6,10
1771,Battle,0.00011337412286988677,0.00012440059960743937,139,57,82
1772,Battlefield,6.496483935243052e-06,3.6233184351681345e-06,5,3,2
1773,Battlefront,4.400843956132392e-06,1.8979287041356905e-06,3,2,1
1774,Battleground,1.9070323809907035e-05,1.570104655239525e-05,19,10,9
1775,Battling,1.0687763893464371e-05,1.2250267090330355e-05,13,5,8
1776,Baumgartner,4.400843956132392e-06,1.8979287041356905e-06,3,2,1
1777,Bavaria,6.496483935243052e-06,7.074097897233022e-06,8,3,5
1778,Bavarian,4.400843956132392e-06,3.6233184351681345e-06,5,2,3
1779,Baxter,4.400843956132392e-06,1.7253897310324457e-07,3,3,0
1780,Bay,0.00020348664197164515,0.00016753534288325053,206,101,105
1781,Bayer,2.326160376812834e-05,7.074097897233022e-06,19,11,8
1782,Bayh,6.496483935243052e-06,1.052487735929791e-05,10,4,6
1783,Beach,4.4218003559234974e-05,4.6758061710979285e-05,50,21,29
1784,Beam,6.496483935243052e-06,3.6233184351681345e-06,5,3,2
1785,Bean,1.0687763893464371e-05,7.074097897233022e-06,10,5,5
1786,Bear,3.7931083621902995e-05,3.985650278684949e-05,46,20,26
1787,Bearing,2.3052039770217305e-06,3.6233184351681345e-06,3,1,2
1788,Beast,8.592123914353715e-06,1.2250267090330355e-05,11,4,7
1789,Beat,5.260056347567764e-05,5.020884117304414e-05,62,29,33
1790,Beaten,1.6974683830796368e-05,1.9151826014460126e-05,19,8,11
1791,Beating,1.48790438516857e-05,2.087721574549256e-05,22,7,15
1792,Beatle,2.3052039770217305e-06,5.348708166200577e-06,4,1,3
1793,Beau,6.496483935243052e-06,1.2250267090330355e-05,10,3,7
1794,Beauregard,2.095639979110664e-07,7.074097897233022e-06,4,0,4
1795,Beautiful,2.954852370546031e-05,3.640572332478458e-05,39,17,22
1796,Beauty,1.9070323809907035e-05,1.570104655239525e-05,19,9,10
1797,Became,4.212236358012434e-05,2.777877466962238e-05,41,20,21
1798,Because,4.400843956132392e-06,1.8979287041356905e-06,3,2,1
1799,Becerra,4.400843956132392e-06,5.348708166200577e-06,6,2,4
1800,Beck,1.6974683830796368e-05,1.2250267090330355e-05,19,12,7
1801,Becky,2.095639979110664e-07,5.348708166200577e-06,3,0,3
1802,Become,0.00016786076232676425,0.0001571830044970555,189,93,96
1803,Becoming,4.212236358012434e-05,3.640572332478458e-05,46,23,23
1804,Bed,1.0687763893464371e-05,2.4327995207557487e-05,19,5,14
1805,Bedford,2.3052039770217305e-06,5.348708166200577e-06,5,1,4
1806,Bedouin,1.0687763893464371e-05,1.9151826014460126e-05,21,7,14
1807,Bee,2.326160376812834e-05,2.6053384938589907e-05,29,11,18
1808,Beef,6.496483935243052e-06,5.348708166200577e-06,7,3,4
1809,Beer,1.9070323809907035e-05,3.2954943862719716e-05,29,9,20
1810,Beethoven,2.3052039770217305e-06,5.348708166200577e-06,4,1,3
1811,Beg,2.116596378901769e-05,1.3975656821362803e-05,20,12,8
1812,Began,4.400843956132392e-06,1.2250267090330355e-05,9,2,7
1813,Begging,1.278340387257504e-05,3.6233184351681345e-06,8,6,2
1814,Begin,8.403516316233764e-05,5.883578982820635e-05,82,43,39
1815,Beginner,2.3052039770217305e-06,3.6233184351681345e-06,3,1,2
1816,Beginning,2.7452883726349685e-05,1.9151826014460126e-05,27,16,11
1817,Begrudgingly,2.3052039770217305e-06,5.348708166200577e-06,4,1,3
1818,Begun,1.0687763893464371e-05,1.3975656821362803e-05,15,6,9
1819,Behalf,6.496483935243052e-06,1.8979287041356905e-06,4,3,1
1820,Behan,2.3052039770217305e-06,1.8979287041356905e-06,3,1,2
1821,Behaving,2.3052039770217305e-06,1.8979287041356905e-06,3,2,1
1822,Behavior,3.3739803663681634e-05,2.6053384938589907e-05,32,16,16
1823,Behead,6.496483935243052e-06,5.348708166200577e-06,9,3,6
1824,Beheaded,1.9070323809907035e-05,8.79948762826546e-06,15,10,5
1825,Beheading,6.496483935243052e-06,3.6233184351681345e-06,5,3,2
1826,Behind,0.00014271308257743603,0.00017616229153841266,194,79,115
1827,Behold,1.0687763893464371e-05,7.074097897233022e-06,10,6,4
1828,Behring,1.278340387257504e-05,1.3975656821362803e-05,18,8,10
1829,Beijing,0.00020767792192986646,0.0001278513790695043,186,107,79
1830,Being,6.496483935243052e-06,5.348708166200577e-06,6,3,3
1831,Beirut,3.1644163684570994e-05,1.052487735929791e-05,21,15,6
1832,Bel,8.592123914353715e-06,1.8979287041356905e-06,5,4,1
1833,Belaru,2.326160376812834e-05,2.087721574549256e-05,26,14,12
1834,Belarusian,2.3052039770217305e-06,3.6233184351681345e-06,3,1,2
1835,Belarussian,2.3052039770217305e-06,5.348708166200577e-06,4,1,3
1836,Belated,2.3052039770217305e-06,1.8979287041356905e-06,3,2,1
1837,Belfast,1.6974683830796368e-05,1.2250267090330355e-05,15,8,7
1838,BelfastTelegraphcouk,2.095639979110664e-07,5.348708166200577e-06,3,0,3
1839,Belgian,8.613080314144832e-05,4.6758061710979285e-05,71,42,29
1840,Belgium,7.565260324589493e-05,5.1934230904076595e-05,72,40,32
1841,Belgrade,2.3052039770217305e-06,1.8979287041356905e-06,4,2,2
1842,Belief,4.400843956132392e-06,1.2250267090330355e-05,13,4,9
1843,Believe,9.03220830996695e-05,0.00010542131256608228,116,48,68
1844,Believed,1.278340387257504e-05,5.348708166200577e-06,10,7,3
1845,Belize,4.400843956132392e-06,3.6233184351681345e-06,4,2,2
1846,Bell,3.1644163684570994e-05,1.570104655239525e-05,26,15,11
1847,Belly,2.3052039770217305e-06,3.6233184351681345e-06,4,1,3
1848,Belong,4.400843956132392e-06,1.052487735929791e-05,10,4,6
1849,Belonging,2.3052039770217305e-06,1.8979287041356905e-06,3,2,1
1850,Beloved,1.278340387257504e-05,1.052487735929791e-05,14,7,7
1851,Belt,1.0687763893464371e-05,1.3975656821362803e-05,16,6,10
1852,Beltway,6.496483935243052e-06,7.074097897233022e-06,7,3,4
1853,Bemoan,2.3052039770217305e-06,3.6233184351681345e-06,3,1,2
1854,Ben,0.00014900000251476814,0.00013992910718673112,170,80,90
1855,Benazir,4.400843956132392e-06,5.348708166200577e-06,5,2,3
1856,Bench,4.400843956132392e-06,3.6233184351681345e-06,6,4,2
1857,Benchmark,4.400843956132392e-06,1.8979287041356905e-06,3,2,1
1858,Bend,4.400843956132392e-06,1.052487735929791e-05,8,2,6
1859,Beneath,6.496483935243052e-06,5.348708166200577e-06,7,3,4
1860,Benedict,4.002672360101368e-05,3.468033359375216e-05,42,20,22
1861,Benefit,7.565260324589493e-05,6.918812821440096e-05,87,41,46
1862,Benefited,8.592123914353715e-06,1.8979287041356905e-06,5,4,1
1863,Bengal,6.496483935243052e-06,1.052487735929791e-05,9,3,6
1864,Benghazi,5.260056347567764e-05,0.00010024514337298497,95,31,64
1865,Benioff,4.400843956132392e-06,1.8979287041356905e-06,3,2,1
1866,Benito,2.095639979110664e-07,3.6233184351681345e-06,4,1,3
1867,Benjamin,4.212236358012434e-05,4.1581892517881935e-05,50,21,29
1868,Bennett,2.3052039770217305e-06,7.074097897233022e-06,6,1,5
1869,Bentley,6.496483935243052e-06,3.6233184351681345e-06,5,3,2
1870,Berber,4.400843956132392e-06,3.6233184351681345e-06,4,2,2
1871,Beret,6.496483935243052e-06,1.7253897310324457e-07,4,4,0
1872,Bergdahl,4.400843956132392e-06,8.79948762826546e-06,12,4,8
1873,Berger,4.400843956132392e-06,1.8979287041356905e-06,4,3,1
1874,Berkeley,1.278340387257504e-05,2.9504164400654783e-05,23,6,17
1875,Berkshire,8.592123914353715e-06,1.8979287041356905e-06,5,4,1
1876,Berlin,0.00013642616264010403,8.644202552472544e-05,124,68,56
1877,Berlusconi,9.24177230787802e-05,0.00010024514337298497,115,47,68
1878,Bermuda,2.3052039770217305e-06,5.348708166200577e-06,4,1,3
1879,Bern,2.326160376812834e-05,1.570104655239525e-05,27,13,14
1880,Bernanke,2.3052039770217305e-06,3.6233184351681345e-06,3,1,2
1881,Bernard,6.496483935243052e-06,1.2250267090330355e-05,11,3,8
1882,Bernardino,2.5357243747239038e-05,3.122955413168725e-05,39,20,19
1883,BernersLee,1.278340387257504e-05,7.074097897233022e-06,10,6,4
1884,Bernie,0.0006519535975013272,0.0005057117301656093,662,328,334
1885,Bernstein,8.592123914353715e-06,1.3975656821362803e-05,13,5,8
1886,Berta,4.400843956132392e-06,5.348708166200577e-06,8,2,6
1887,Beside,1.278340387257504e-05,1.9151826014460126e-05,18,6,12
1888,Best,0.0002055822819507562,0.0002400017115866128,260,112,148
1889,Bestselling,4.400843956132392e-06,1.8979287041356905e-06,3,2,1
1890,Bet,2.326160376812834e-05,2.2602605476525032e-05,30,14,16
1891,Beth,2.3052039770217305e-06,3.6233184351681345e-06,3,1,2
1892,Bethesda,2.3052039770217305e-06,3.6233184351681345e-06,3,1,2
1893,Bethlehem,6.496483935243052e-06,5.348708166200577e-06,7,3,4
1894,Beto,6.496483935243052e-06,1.742643628342769e-05,16,5,11
1895,Betray,1.0687763893464371e-05,1.7253897310324457e-07,5,5,0
1896,Betrayal,1.0687763893464371e-05,3.6233184351681345e-06,7,5,2
1897,Betrayed,6.496483935243052e-06,5.348708166200577e-06,6,3,3
1898,Betsy,3.583544364279237e-05,5.3659620635109e-05,59,23,36
1899,Better,0.00015738256243121094,0.00017616229153841266,197,79,118
1900,Betting,6.496483935243052e-06,5.348708166200577e-06,7,3,4
1901,Betty,6.496483935243052e-06,7.074097897233022e-06,7,3,4
1902,Beverly,4.400843956132392e-06,8.79948762826546e-06,9,4,5
1903,Bevin,8.592123914353715e-06,7.074097897233022e-06,10,5,5
1904,Beware,1.6974683830796368e-05,1.9151826014460126e-05,22,9,13
1905,Beyonce,2.3052039770217305e-06,7.074097897233022e-06,6,1,5
1906,Beyoncé,4.400843956132392e-06,5.348708166200577e-06,8,3,5
1907,Beyond,5.6791843433898893e-05,7.954046660059569e-05,77,27,50
1908,Bezo,1.48790438516857e-05,2.2602605476525032e-05,23,9,14
1909,Bharara,4.400843956132392e-06,5.348708166200577e-06,8,5,3
1910,Bhopal,1.9070323809907035e-05,1.052487735929791e-05,15,9,6
1911,Bhutan,4.400843956132392e-06,3.6233184351681345e-06,4,2,2
1912,Bhutto,8.592123914353715e-06,8.79948762826546e-06,9,4,5
1913,Bia,1.0687763893464371e-05,1.742643628342769e-05,17,5,12
1914,Biased,6.496483935243052e-06,8.79948762826546e-06,8,3,5
1915,Bibi,2.326160376812834e-05,1.8979287041356905e-06,15,13,2
1916,Bible,4.212236358012434e-05,2.9504164400654783e-05,40,22,18
1917,Biblical,2.3052039770217305e-06,3.6233184351681345e-06,3,1,2
1918,Bid,7.774824322500554e-05,7.436429740749831e-05,88,40,48
1919,Biden,0.00043610267965292894,0.0005678257604827774,583,232,351
1920,Bieber,2.3052039770217305e-06,5.348708166200577e-06,4,1,3
1921,Big,0.0005031631589844702,0.000507437119896642,598,261,337
1922,Bigger,2.954852370546031e-05,3.640572332478458e-05,38,14,24
1923,Biggest,0.00011337412286988677,0.00013130215853156914,142,59,83
1924,Bigly,6.496483935243052e-06,3.6233184351681345e-06,5,3,2
1925,Bigot,1.278340387257504e-05,1.052487735929791e-05,14,6,8
1926,Bigoted,6.496483935243052e-06,5.348708166200577e-06,6,3,3
1927,Bigotry,1.48790438516857e-05,1.3975656821362803e-05,15,7,8
1928,Bihar,2.3052039770217305e-06,3.6233184351681345e-06,3,1,2
1929,Bijan,2.3052039770217305e-06,1.8979287041356905e-06,3,2,1
1930,Bike,1.278340387257504e-05,1.3975656821362803e-05,15,6,9
1931,Biker,6.496483935243052e-06,1.8979287041356905e-06,4,3,1
1932,Bikini,2.3052039770217305e-06,5.348708166200577e-06,4,1,3
1933,Bilderberg,2.326160376812834e-05,8.79948762826546e-06,19,13,6
1934,Bile,4.400843956132392e-06,5.348708166200577e-06,7,2,5
1935,Bill,0.0008636132353915039,0.0009008259785720393,1051,459,592
1936,BillMoyerscom,1.0687763893464371e-05,1.570104655239525e-05,16,7,9
1937,Billboard,6.496483935243052e-06,1.2250267090330355e-05,12,5,7
1938,Billing,2.3052039770217305e-06,3.6233184351681345e-06,4,2,2
1939,Billion,0.00027892968121962896,0.00025553021916590484,308,142,166
1940,Billionaire,8.403516316233764e-05,8.4716635793693e-05,106,47,59
1941,Billiton,2.3052039770217305e-06,1.8979287041356905e-06,3,1,2
1942,Billy,1.0687763893464371e-05,1.3975656821362803e-05,13,5,8
1943,Bin,9.451336305789087e-05,5.5385010366141504e-05,86,47,39
1944,Bind,2.095639979110664e-07,7.074097897233022e-06,4,0,4
1945,Bing,6.496483935243052e-06,3.6233184351681345e-06,6,4,2
1946,Binge,6.496483935243052e-06,1.8979287041356905e-06,4,3,1
1947,Binyam,8.592123914353715e-06,3.6233184351681345e-06,6,4,2
1948,Binyamin,1.0687763893464371e-05,3.6233184351681345e-06,7,5,2
1949,Bio,2.3052039770217305e-06,7.074097897233022e-06,5,1,4
1950,Biodiversity,6.496483935243052e-06,1.7253897310324457e-07,3,3,0
1951,Biographer,2.3052039770217305e-06,3.6233184351681345e-06,3,1,2
1952,Biological,1.0687763893464371e-05,3.6233184351681345e-06,7,5,2
1953,Biometric,2.3052039770217305e-06,3.6233184351681345e-06,3,1,2
1954,Bipartisan,3.583544364279237e-05,5.711040009717395e-05,52,17,35
1955,Bipartisanship,6.496483935243052e-06,5.348708166200577e-06,7,4,3
1956,Bird,2.5357243747239038e-05,3.640572332478458e-05,38,14,24
1957,Birmingham,6.496483935243052e-06,1.570104655239525e-05,12,3,9
1958,Birth,6.72700433294523e-05,6.401195902130366e-05,79,37,42
1959,Birthday,3.7931083621902995e-05,3.2954943862719716e-05,40,20,20
1960,Birther,3.583544364279237e-05,1.9151826014460126e-05,32,18,14
1961,Birtherism,4.400843956132392e-06,5.348708166200577e-06,5,2,3
1962,Birthright,1.0687763893464371e-05,1.8979287041356905e-06,6,5,1
1963,Birx,2.3052039770217305e-06,3.6233184351681345e-06,3,1,2
1964,Bishop,2.7452883726349685e-05,2.6053384938589907e-05,31,15,16
1965,Bistro,2.3052039770217305e-06,1.8979287041356905e-06,3,2,1
1966,Bit,1.48790438516857e-05,1.9151826014460126e-05,19,7,12
1967,BitTorrent,8.592123914353715e-06,1.052487735929791e-05,10,4,6
1968,Bitch,6.496483935243052e-06,3.6233184351681345e-06,6,3,3
1969,Bitcoin,5.4696203454788295e-05,3.468033359375216e-05,50,27,23
1970,Bite,8.592123914353715e-06,8.79948762826546e-06,9,4,5
1971,Biting,2.3052039770217305e-06,3.6233184351681345e-06,3,1,2
1972,Bitter,4.400843956132392e-06,8.79948762826546e-06,7,2,5
1973,Bizarre,2.5357243747239038e-05,3.8131113055817005e-05,39,15,24
1974,Black,0.00041095499990360083,0.0005005355609725121,547,224,323
1975,BlackBerry,6.496483935243052e-06,1.570104655239525e-05,12,3,9
1976,BlackLivesMatter,2.3052039770217305e-06,1.8979287041356905e-06,3,1,2
1977,BlackRock,2.3052039770217305e-06,5.348708166200577e-06,4,1,3
1978,Blackburn,6.496483935243052e-06,1.7253897310324457e-07,3,3,0
1979,Blackface,4.400843956132392e-06,3.6233184351681345e-06,5,2,3
1980,Blacklist,1.278340387257504e-05,3.6233184351681345e-06,8,6,2
1981,Blackmail,4.400843956132392e-06,7.074097897233022e-06,6,2,4
1982,Blackout,4.400843956132392e-06,1.570104655239525e-05,11,2,9
1983,Blackpool,2.3052039770217305e-06,3.6233184351681345e-06,3,1,2
1984,Blackwater,4.002672360101368e-05,5.020884117304414e-05,52,21,31
1985,Blagojevich,4.400843956132392e-06,3.6233184351681345e-06,4,2,2
1986,Blair,0.0001259479627445509,0.00012440059960743937,150,72,78
1987,Blake,2.116596378901769e-05,2.9504164400654783e-05,27,10,17
1988,Blame,0.00013013924270277222,0.00011232287149021227,149,72,77
1989,Blamed,1.9070323809907035e-05,1.3975656821362803e-05,17,9,8
1990,Blaming,1.6974683830796368e-05,1.570104655239525e-05,19,9,10
1991,Blanc,4.400843956132392e-06,1.8979287041356905e-06,3,2,1
1992,Bland,1.0687763893464371e-05,1.2250267090330355e-05,12,5,7
1993,Blank,6.496483935243052e-06,5.348708166200577e-06,10,5,5
1994,Blankenship,1.278340387257504e-05,1.2250267090330355e-05,14,7,7
1995,Blanket,2.095639979110664e-07,1.3975656821362803e-05,9,1,8
1996,Blankfein,8.592123914353715e-06,1.7253897310324457e-07,4,4,0
1997,Blasey,8.592123914353715e-06,8.79948762826546e-06,10,4,6
1998,Blasio,2.5357243747239038e-05,3.2954943862719716e-05,34,15,19
1999,Blasphemy,8.592123914353715e-06,1.052487735929791e-05,11,4,7
2000,Blast,9.660900303700153e-05,9.506897417988779e-05,107,47,60
2001,Blasted,4.400843956132392e-06,1.052487735929791e-05,8,2,6
2002,Blasting,6.496483935243052e-06,1.7253897310324457e-07,3,3,0
2003,Blatter,1.0687763893464371e-05,1.742643628342769e-05,17,5,12
2004,Blaze,6.496483935243052e-06,5.348708166200577e-06,6,3,3
2005,Blazer,2.3052039770217305e-06,3.6233184351681345e-06,3,1,2
2006,Bleak,2.3052039770217305e-06,3.6233184351681345e-06,4,2,2
2007,Bleeding,4.400843956132392e-06,8.79948762826546e-06,8,2,6
2008,Bles,2.3052039770217305e-06,3.6233184351681345e-06,3,1,2
2009,Blessed,4.400843956132392e-06,1.8979287041356905e-06,3,2,1
2010,Blessing,8.592123914353715e-06,1.7253897310324457e-07,5,4,1
2011,Blew,6.496483935243052e-06,5.348708166200577e-06,7,3,4
2012,Blind,4.212236358012434e-05,3.2954943862719716e-05,41,20,21
2013,Blindnes,4.400843956132392e-06,1.8979287041356905e-06,4,3,1
2014,Blindsided,2.3052039770217305e-06,5.348708166200577e-06,4,1,3
2015,Bling,6.496483935243052e-06,1.8979287041356905e-06,4,3,1
2016,Blink,4.400843956132392e-06,1.8979287041356905e-06,3,2,1
2017,Blinken,2.3052039770217305e-06,3.6233184351681345e-06,3,1,2
2018,Blis,2.095639979110664e-07,5.348708166200577e-06,3,0,3
2019,Blistering,8.592123914353715e-06,7.074097897233022e-06,9,4,5
2020,Blitz,1.278340387257504e-05,5.348708166200577e-06,9,6,3
2021,Blitzer,4.400843956132392e-06,1.8979287041356905e-06,3,2,1
2022,Blix,8.592123914353715e-06,1.7253897310324457e-07,4,4,0
2023,Blizzard,8.592123914353715e-06,7.074097897233022e-06,8,4,4
2024,Bln,6.496483935243052e-06,1.7253897310324457e-07,3,3,0
2025,Bloc,8.592123914353715e-06,5.348708166200577e-06,8,4,4
2026,Block,0.00015109564249387862,0.00019341618884873702,210,84,126
2027,Blockade,1.278340387257504e-05,1.570104655239525e-05,17,8,9
2028,Blocked,2.7452883726349685e-05,2.9504164400654783e-05,33,14,19
2029,Blocking,4.002672360101368e-05,2.777877466962238e-05,38,20,18
2030,Blog,1.6974683830796368e-05,2.2602605476525032e-05,22,8,14
2031,Blogger,2.326160376812834e-05,1.9151826014460126e-05,25,13,12
2032,Blond,2.095639979110664e-07,5.348708166200577e-06,3,0,3
2033,Blood,3.1644163684570994e-05,3.640572332478458e-05,39,16,23
2034,Bloodied,2.3052039770217305e-06,3.6233184351681345e-06,3,1,2
2035,Bloodshed,6.496483935243052e-06,1.8979287041356905e-06,4,3,1
2036,Bloody,1.48790438516857e-05,2.087721574549256e-05,23,8,15
2037,Bloom,4.400843956132392e-06,8.79948762826546e-06,7,2,5
2038,Bloomberg,3.7931083621902995e-05,3.640572332478458e-05,42,20,22
2039,Blow,5.6791843433898893e-05,6.918812821440096e-05,74,29,45
2040,Blowback,6.496483935243052e-06,3.6233184351681345e-06,5,3,2
2041,Blowing,4.400843956132392e-06,1.8979287041356905e-06,4,2,2
2042,Blown,4.400843956132392e-06,7.074097897233022e-06,6,2,4
2043,Blue,3.7931083621902995e-05,5.1934230904076595e-05,53,18,35
2044,Bluefin,2.3052039770217305e-06,8.79948762826546e-06,8,1,7
2045,Bluegras,6.496483935243052e-06,1.7253897310324457e-07,3,3,0
2046,Blueprint,4.400843956132392e-06,7.074097897233022e-06,6,2,4
2047,Bluff,6.496483935243052e-06,1.8979287041356905e-06,5,4,1
2048,Blumenthal,8.592123914353715e-06,1.052487735929791e-05,10,4,6
2049,Blunder,2.3052039770217305e-06,8.79948762826546e-06,7,1,6
2050,Blunt,6.496483935243052e-06,1.2250267090330355e-05,12,5,7
2051,Bluster,2.3052039770217305e-06,5.348708166200577e-06,4,1,3
2052,Bo,1.278340387257504e-05,1.052487735929791e-05,14,8,6
2053,Board,8.403516316233764e-05,9.161819471782287e-05,107,49,58
2054,Boardroom,4.400843956132392e-06,7.074097897233022e-06,8,2,6
2055,Boast,2.116596378901769e-05,1.3975656821362803e-05,20,12,8
2056,Boat,2.326160376812834e-05,3.2954943862719716e-05,32,11,21
2057,Bob,8.403516316233764e-05,7.781507686956326e-05,94,44,50
2058,Bobbi,4.400843956132392e-06,3.6233184351681345e-06,4,2,2
2059,Bobby,2.326160376812834e-05,1.2250267090330355e-05,20,12,8
2060,Body,0.00010289592297433347,9.851975364195259e-05,117,53,64
2061,BodySlammed,2.095639979110664e-07,3.6233184351681345e-06,3,0,3
2062,Bodyguard,1.0687763893464371e-05,3.6233184351681345e-06,7,5,2
2063,Boebert,8.592123914353715e-06,8.79948762826546e-06,11,6,5
2064,Boehner,8.822644312055891e-05,8.644202552472544e-05,99,42,57
2065,Boeing,1.48790438516857e-05,3.2954943862719716e-05,31,10,21
2066,Bog,2.3052039770217305e-06,1.8979287041356905e-06,3,1,2
2067,Bogg,4.400843956132392e-06,1.8979287041356905e-06,3,2,1
2068,Bogota,4.400843956132392e-06,1.7253897310324457e-07,3,3,0
2069,Bogu,1.0687763893464371e-05,2.2602605476525032e-05,20,7,13
2070,Boko,8.822644312055891e-05,7.608968713853079e-05,94,43,51
2071,Bold,8.592123914353715e-06,1.742643628342769e-05,16,5,11
2072,Boldest,4.400843956132392e-06,1.8979287041356905e-06,3,2,1
2073,Bolivia,6.098312339212028e-05,5.5385010366141504e-05,69,31,38
2074,Bolivian,1.6974683830796368e-05,3.640572332478458e-05,33,8,25
2075,Bollywood,1.278340387257504e-05,1.8979287041356905e-06,8,6,2
2076,Bolshevik,2.3052039770217305e-06,5.348708166200577e-06,4,1,3
2077,Bolsonaro,2.3052039770217305e-06,3.6233184351681345e-06,3,1,2
2078,Bolt,4.400843956132392e-06,1.8979287041356905e-06,5,3,2
2079,Bolton,1.9070323809907035e-05,3.122955413168725e-05,30,10,20
2080,Bom,6.496483935243052e-06,1.8979287041356905e-06,5,4,1
2081,Bomb,0.0001343305226609934,0.00011404826122124471,144,69,75
2082,Bombarded,4.400843956132392e-06,1.8979287041356905e-06,4,3,1
2083,Bombay,2.095639979110664e-07,5.348708166200577e-06,3,0,3
2084,Bombed,8.592123914353715e-06,7.074097897233022e-06,8,4,4
2085,Bomber,2.5357243747239038e-05,2.2602605476525032e-05,28,12,16
2086,Bombing,4.4218003559234974e-05,5.711040009717395e-05,60,24,36
2087,Bombshell,8.592123914353715e-06,1.2250267090330355e-05,15,6,9
2088,Bond,1.9070323809907035e-05,2.6053384938589907e-05,28,10,18
2089,Bone,1.6974683830796368e-05,1.3975656821362803e-05,18,10,8
2090,Bonker,1.278340387257504e-05,1.052487735929791e-05,13,6,7
2091,Bono,2.3052039770217305e-06,8.79948762826546e-06,6,1,5
2092,Bonu,2.5357243747239038e-05,1.2250267090330355e-05,19,12,7
2093,Bonus,1.48790438516857e-05,1.052487735929791e-05,13,7,6
2094,Boo,1.278340387257504e-05,1.8979287041356905e-06,7,6,1
2095,Booed,1.278340387257504e-05,1.052487735929791e-05,12,6,6
2096,Book,6.72700433294523e-05,0.00011059748175917965,112,40,72
2097,Booked,4.400843956132392e-06,1.8979287041356905e-06,4,3,1
2098,Booker,8.592123914353715e-06,1.2250267090330355e-05,14,6,8
2099,Bookie,2.095639979110664e-07,3.6233184351681345e-06,3,1,2
2100,Bookstore,2.3052039770217305e-06,5.348708166200577e-06,4,1,3
2101,Boom,1.9070323809907035e-05,2.9504164400654783e-05,27,9,18
2102,Boomer,1.278340387257504e-05,5.348708166200577e-06,13,8,5
2103,Booming,1.278340387257504e-05,3.6233184351681345e-06,8,6,2
2104,Boon,8.592123914353715e-06,1.8979287041356905e-06,5,4,1
2105,Boondoggle,8.592123914353715e-06,5.348708166200577e-06,7,4,3
2106,Boost,8.403516316233764e-05,5.883578982820635e-05,84,46,38
2107,Boosted,2.3052039770217305e-06,3.6233184351681345e-06,4,2,2
2108,Booster,1.0687763893464371e-05,7.074097897233022e-06,10,5,5
2109,Boosting,8.592123914353715e-06,5.348708166200577e-06,7,4,3
2110,Boot,1.6974683830796368e-05,1.742643628342769e-05,19,8,11
2111,Booted,2.095639979110664e-07,5.348708166200577e-06,5,0,5
2112,Booth,2.095639979110664e-07,5.348708166200577e-06,3,0,3
2113,Booze,8.592123914353715e-06,5.348708166200577e-06,7,4,3
2114,Borden,2.3052039770217305e-06,1.8979287041356905e-06,4,1,3
2115,Border,0.0002160604818463093,0.00024172710131764556,272,113,159
2116,Bored,6.496483935243052e-06,8.79948762826546e-06,8,3,5
2117,Boredom,2.3052039770217305e-06,3.6233184351681345e-06,3,1,2
2118,Bori,1.9070323809907035e-05,3.2954943862719716e-05,29,9,20
2119,Boring,6.496483935243052e-06,1.3975656821362803e-05,14,3,11
2120,Born,3.3739803663681634e-05,2.9504164400654783e-05,36,17,19
2121,Borneo,1.278340387257504e-05,7.074097897233022e-06,11,6,5
2122,Borno,2.3052039770217305e-06,3.6233184351681345e-06,4,1,3
2123,Borough,8.592123914353715e-06,1.7253897310324457e-07,4,4,0
2124,Borrow,2.3052039770217305e-06,7.074097897233022e-06,6,2,4
2125,Borrower,1.48790438516857e-05,1.570104655239525e-05,18,9,9
2126,Borrowing,1.278340387257504e-05,1.7253897310324457e-07,6,6,0
2127,Bos,2.5357243747239038e-05,4.50326719799468e-05,46,14,32
2128,Bosnia,1.6974683830796368e-05,2.2602605476525032e-05,23,10,13
2129,Bosnian,1.9070323809907035e-05,1.9151826014460126e-05,24,11,13
2130,Boss,1.48790438516857e-05,2.087721574549256e-05,22,10,12
2131,Boston,6.098312339212028e-05,7.781507686956326e-05,89,35,54
2132,Bostoncom,2.095639979110664e-07,1.8979287041356905e-06,3,2,1
2133,Bot,6.496483935243052e-06,7.074097897233022e-06,7,3,4
2134,Botched,4.400843956132392e-06,1.052487735929791e-05,10,4,6
2135,Bother,4.400843956132392e-06,1.8979287041356905e-06,3,2,1
2136,Bothered,4.400843956132392e-06,1.8979287041356905e-06,3,2,1
2137,Botswana,1.278340387257504e-05,2.2602605476525032e-05,20,7,13
2138,Bottle,1.9070323809907035e-05,1.2250267090330355e-05,16,9,7
2139,Bottled,4.400843956132392e-06,1.8979287041356905e-06,3,2,1
2140,Bottom,4.400843956132392e-06,2.2602605476525032e-05,15,2,13
2141,Bought,1.48790438516857e-05,1.3975656821362803e-05,18,8,10
2142,Boulder,1.0687763893464371e-05,1.8979287041356905e-06,7,6,1
2143,Bounce,2.3052039770217305e-06,8.79948762826546e-06,7,2,5
2144,Bound,6.496483935243052e-06,8.79948762826546e-06,8,3,5
2145,Boundary,4.400843956132392e-06,1.8979287041356905e-06,3,2,1
2146,Bounty,6.496483935243052e-06,5.348708166200577e-06,7,3,4
2147,Bout,6.496483935243052e-06,1.7253897310324457e-07,4,3,1
2148,Bow,4.400843956132392e-06,7.074097897233022e-06,7,2,5
2149,Bowe,2.3052039770217305e-06,7.074097897233022e-06,7,1,6
2150,Bowie,4.400843956132392e-06,3.6233184351681345e-06,4,2,2
2151,Bowl,4.840928351745632e-05,3.2954943862719716e-05,43,23,20
2152,Bowling,6.496483935243052e-06,8.79948762826546e-06,8,3,5
2153,Bowser,6.496483935243052e-06,1.7253897310324457e-07,3,3,0
2154,Box,2.326160376812834e-05,2.6053384938589907e-05,31,11,20
2155,Boxer,8.592123914353715e-06,7.074097897233022e-06,8,4,4
2156,Boy,0.00014690436253565753,0.00014510527637982858,166,74,92
2157,Boycott,4.002672360101368e-05,3.985650278684949e-05,45,20,25
2158,Boycotting,4.400843956132392e-06,5.348708166200577e-06,7,3,4
2159,Boyfriend,6.496483935243052e-06,7.074097897233022e-06,7,3,4
2160,Boyle,6.496483935243052e-06,1.7253897310324457e-07,3,3,0
2161,Bra,2.3052039770217305e-06,3.6233184351681345e-06,3,1,2
2162,Brace,3.583544364279237e-05,1.570104655239525e-05,32,20,12
2163,Bracing,4.400843956132392e-06,5.348708166200577e-06,5,2,3
2164,Bracket,2.095639979110664e-07,3.6233184351681345e-06,3,0,3
2165,Brad,4.400843956132392e-06,3.6233184351681345e-06,8,4,4
2166,Bradbury,4.400843956132392e-06,3.6233184351681345e-06,4,2,2
2167,Bradford,2.3052039770217305e-06,5.348708166200577e-06,4,1,3
2168,Bradley,2.116596378901769e-05,2.777877466962238e-05,31,11,20
2169,Brady,8.592123914353715e-06,1.742643628342769e-05,15,4,11
2170,Brag,1.9070323809907035e-05,5.348708166200577e-06,15,10,5
2171,Bragg,2.3052039770217305e-06,1.8979287041356905e-06,3,1,2
2172,Bragged,4.400843956132392e-06,7.074097897233022e-06,7,3,4
2173,Bragging,8.592123914353715e-06,8.79948762826546e-06,10,4,6
2174,Brain,6.517440335034157e-05,3.8131113055817005e-05,56,34,22
2175,Brake,4.400843956132392e-06,5.348708166200577e-06,6,3,3
2176,Branch,1.278340387257504e-05,8.79948762826546e-06,12,6,6
2177,Brand,4.4218003559234974e-05,4.50326719799468e-05,53,25,28
2178,Brandi,2.095639979110664e-07,3.6233184351681345e-06,3,0,3
2179,Branding,2.3052039770217305e-06,3.6233184351681345e-06,8,3,5
2180,Brandon,6.496483935243052e-06,1.8979287041356905e-06,4,3,1
2181,Branson,1.48790438516857e-05,1.9151826014460126e-05,20,8,12
2182,Brarbunga,2.3052039770217305e-06,3.6233184351681345e-06,3,1,2
2183,Brasil,2.095639979110664e-07,3.6233184351681345e-06,3,0,3
2184,Brasilia,2.3052039770217305e-06,3.6233184351681345e-06,3,1,2
2185,Brat,6.496483935243052e-06,7.074097897233022e-06,7,3,4
2186,Bratton,8.592123914353715e-06,5.348708166200577e-06,7,4,3
2187,Brave,2.326160376812834e-05,1.2250267090330355e-05,19,11,8
2188,Bravo,4.400843956132392e-06,7.074097897233022e-06,6,2,4
2189,Brawl,4.400843956132392e-06,5.348708166200577e-06,7,4,3
2190,Brazen,4.400843956132392e-06,3.6233184351681345e-06,4,2,2
2191,Brazil,0.0003229381207809529,0.00032799658786926807,377,168,209
2192,Brazile,4.400843956132392e-06,8.79948762826546e-06,8,2,6
2193,Brazilian,0.00011756540282810809,0.00011232287149021227,137,67,70
2194,Brazillian,2.3052039770217305e-06,3.6233184351681345e-06,3,1,2
2195,Breach,2.5357243747239038e-05,2.777877466962238e-05,29,13,16
2196,Breached,2.095639979110664e-07,5.348708166200577e-06,3,0,3
2197,Bread,8.592123914353715e-06,5.348708166200577e-06,7,4,3
2198,Break,0.00013223488268188294,0.0001295767688005365,161,79,82
2199,Breakfast,4.400843956132392e-06,1.2250267090330355e-05,9,2,7
2200,Breaking,5.4696203454788295e-05,4.8483451442011706e-05,54,26,28
2201,Breakthrough,1.6974683830796368e-05,1.052487735929791e-05,15,8,7
2202,Breakup,4.400843956132392e-06,1.8979287041356905e-06,3,2,1
2203,Breast,1.48790438516857e-05,1.052487735929791e-05,15,7,8
2204,Breastfeeding,8.592123914353715e-06,1.8979287041356905e-06,5,4,1
2205,Breath,6.496483935243052e-06,1.8979287041356905e-06,6,4,2
2206,Breathalyzer,4.400843956132392e-06,1.8979287041356905e-06,3,2,1
2207,Breathe,1.278340387257504e-05,1.052487735929791e-05,12,6,6
2208,Breathing,4.400843956132392e-06,5.348708166200577e-06,7,4,3
2209,Breathtaking,8.592123914353715e-06,5.348708166200577e-06,8,4,4
2210,Breed,2.3052039770217305e-06,1.2250267090330355e-05,10,2,8
2211,Breeding,2.095639979110664e-07,3.6233184351681345e-06,3,1,2
2212,Brega,6.496483935243052e-06,5.348708166200577e-06,6,3,3
2213,Breitbart,1.9070323809907035e-05,3.122955413168725e-05,27,9,18
2214,Breivik,4.4218003559234974e-05,3.2954943862719716e-05,46,24,22
2215,Brennan,1.278340387257504e-05,1.742643628342769e-05,17,6,11
2216,Brent,2.3052039770217305e-06,3.6233184351681345e-06,3,1,2
2217,Breonna,2.095639979110664e-07,1.2250267090330355e-05,8,1,7
2218,Bret,4.400843956132392e-06,3.6233184351681345e-06,4,2,2
2219,Brett,2.116596378901769e-05,8.79948762826546e-06,17,12,5
2220,Brew,4.400843956132392e-06,1.8979287041356905e-06,3,2,1
2221,Brewer,2.3052039770217305e-06,5.348708166200577e-06,5,1,4
2222,Brewery,2.3052039770217305e-06,3.6233184351681345e-06,3,1,2
2223,Brewing,2.095639979110664e-07,7.074097897233022e-06,4,0,4
2224,Brexit,8.403516316233764e-05,3.985650278684949e-05,70,42,28
2225,Breyer,2.3052039770217305e-06,8.79948762826546e-06,7,1,6
2226,Brian,4.4218003559234974e-05,4.6758061710979285e-05,55,24,31
2227,Bribe,6.496483935243052e-06,1.3975656821362803e-05,11,3,8
2228,Bribery,1.6974683830796368e-05,1.3975656821362803e-05,19,10,9
2229,Bribing,2.3052039770217305e-06,3.6233184351681345e-06,3,1,2
2230,Brick,4.400843956132392e-06,5.348708166200577e-06,8,4,4
2231,Bride,1.0687763893464371e-05,1.742643628342769e-05,15,5,10
2232,Bridge,3.3739803663681634e-05,3.640572332478458e-05,39,16,23
2233,Bridgegate,6.496483935243052e-06,1.3975656821362803e-05,12,3,9
2234,Bridging,6.496483935243052e-06,1.8979287041356905e-06,4,3,1
2235,Brief,2.116596378901769e-05,1.052487735929791e-05,16,10,6
2236,Briefing,3.583544364279237e-05,1.742643628342769e-05,31,19,12
2237,Briefly,6.496483935243052e-06,8.79948762826546e-06,10,3,7
2238,Brigade,2.3052039770217305e-06,5.348708166200577e-06,4,1,3
2239,Brighten,6.496483935243052e-06,1.8979287041356905e-06,4,3,1
2240,Brighter,4.400843956132392e-06,5.348708166200577e-06,6,2,4
2241,Brighton,2.095639979110664e-07,3.6233184351681345e-06,3,1,2
2242,Brilliant,1.278340387257504e-05,1.570104655239525e-05,18,7,11
2243,Bring,0.00014271308257743603,9.506897417988779e-05,138,76,62
2244,Bringing,1.6974683830796368e-05,2.9504164400654783e-05,29,11,18
2245,Brink,1.6974683830796368e-05,8.79948762826546e-06,13,8,5
2246,Brisbane,8.592123914353715e-06,1.2250267090330355e-05,11,4,7
2247,Briskman,2.3052039770217305e-06,1.8979287041356905e-06,3,1,2
2248,Bristol,1.278340387257504e-05,1.052487735929791e-05,13,6,7
2249,Brit,3.1644163684570994e-05,2.2602605476525032e-05,29,15,14
2250,Britain,0.0004947805990680274,0.0004315199717312144,541,258,283
2251,Britian,4.400843956132392e-06,1.8979287041356905e-06,4,2,2
2252,British,0.0007839789161852989,0.0007420901233170544,890,410,480
2253,Britishborn,2.095639979110664e-07,5.348708166200577e-06,3,0,3
2254,Britney,8.592123914353715e-06,7.074097897233022e-06,8,4,4
2255,Briton,4.6313643538345614e-05,5.883578982820635e-05,60,24,36
2256,Brittany,2.3052039770217305e-06,1.7253897310324457e-07,5,2,3
2257,Bro,8.592123914353715e-06,8.79948762826546e-06,9,4,5
2258,Broad,1.48790438516857e-05,5.348708166200577e-06,10,7,3
2259,Broadband,1.0687763893464371e-05,1.3975656821362803e-05,13,5,8
2260,Broadcast,8.592123914353715e-06,8.79948762826546e-06,12,4,8
2261,Broadcaster,2.3052039770217305e-06,5.348708166200577e-06,4,1,3
2262,Broadcasting,8.592123914353715e-06,2.087721574549256e-05,16,4,12
2263,Broader,4.400843956132392e-06,5.348708166200577e-06,6,3,3
2264,Broadly,4.400843956132392e-06,1.8979287041356905e-06,3,2,1
2265,Broadway,6.496483935243052e-06,3.6233184351681345e-06,5,3,2
2266,Broadwell,2.095639979110664e-07,7.074097897233022e-06,4,0,4
2267,Brock,4.400843956132392e-06,1.2250267090330355e-05,10,2,8
2268,Broidy,2.3052039770217305e-06,3.6233184351681345e-06,3,1,2
2269,Broke,1.48790438516857e-05,3.122955413168725e-05,27,9,18
2270,Broken,2.954852370546031e-05,3.8131113055817005e-05,40,16,24
2271,Broker,1.0687763893464371e-05,3.6233184351681345e-06,9,6,3
2272,Brokered,2.3052039770217305e-06,3.6233184351681345e-06,3,1,2
2273,Bromance,4.400843956132392e-06,3.6233184351681345e-06,4,2,2
2274,Bronx,2.3052039770217305e-06,1.8979287041356905e-06,3,1,2
2275,Bronze,4.400843956132392e-06,1.8979287041356905e-06,4,2,2
2276,Brook,4.6313643538345614e-05,1.9151826014460126e-05,35,23,12
2277,Brooke,2.3052039770217305e-06,3.6233184351681345e-06,3,1,2
2278,Brooker,6.496483935243052e-06,1.8979287041356905e-06,5,3,2
2279,Brooking,6.496483935243052e-06,1.8979287041356905e-06,4,3,1
2280,Brooklyn,2.326160376812834e-05,1.9151826014460126e-05,24,13,11
2281,Brothel,6.496483935243052e-06,1.8979287041356905e-06,5,4,1
2282,Brother,6.72700433294523e-05,8.989280498679035e-05,94,39,55
2283,Brotherhood,6.517440335034157e-05,6.056117955923882e-05,70,34,36
2284,Brought,2.116596378901769e-05,1.3975656821362803e-05,21,10,11
2285,Brown,0.0001531912824729893,0.00017098612234531542,195,83,112
2286,Brownback,4.400843956132392e-06,1.052487735929791e-05,9,2,7
2287,Browser,4.400843956132392e-06,1.8979287041356905e-06,6,3,3
2288,Bruce,1.48790438516857e-05,2.6053384938589907e-05,25,10,15
2289,Brunei,2.3052039770217305e-06,1.2250267090330355e-05,8,1,7
2290,Bruno,4.400843956132392e-06,1.8979287041356905e-06,3,2,1
2291,Brunswick,6.496483935243052e-06,1.8979287041356905e-06,5,3,2
2292,Brush,6.496483935243052e-06,1.8979287041356905e-06,6,3,3
2293,Brussel,8.403516316233764e-05,6.918812821440096e-05,83,41,42
2294,Brutal,1.48790438516857e-05,3.2954943862719716e-05,26,7,19
2295,Brutality,1.0687763893464371e-05,1.570104655239525e-05,16,6,10
2296,Brutally,4.400843956132392e-06,3.6233184351681345e-06,4,2,2
2297,Bryan,4.400843956132392e-06,8.79948762826546e-06,7,2,5
2298,Bryant,4.400843956132392e-06,1.052487735929791e-05,11,3,8
2299,Bryce,2.3052039770217305e-06,5.348708166200577e-06,4,1,3
2300,Brzezinski,8.592123914353715e-06,7.074097897233022e-06,8,4,4
2301,Bu,4.212236358012434e-05,3.2954943862719716e-05,43,24,19
2302,Bubble,2.116596378901769e-05,1.742643628342769e-05,25,14,11
2303,Bubonic,4.400843956132392e-06,3.6233184351681345e-06,5,3,2
2304,Buchanan,2.3052039770217305e-06,5.348708166200577e-06,4,1,3
2305,Bucharest,6.496483935243052e-06,8.79948762826546e-06,8,3,5
2306,Buck,1.0687763893464371e-05,1.742643628342769e-05,17,6,11
2307,Bucket,1.0687763893464371e-05,1.742643628342769e-05,16,5,11
2308,Buckingham,8.592123914353715e-06,5.348708166200577e-06,7,4,3
2309,Buckle,2.3052039770217305e-06,7.074097897233022e-06,7,1,6
2310,Budapest,4.400843956132392e-06,5.348708166200577e-06,5,2,3
2311,Buddha,1.6974683830796368e-05,1.3975656821362803e-05,17,9,8
2312,Buddhism,4.400843956132392e-06,1.8979287041356905e-06,3,2,1
2313,Buddhist,5.260056347567764e-05,2.4327995207557487e-05,43,27,16
2314,Buddy,8.592123914353715e-06,1.9151826014460126e-05,17,6,11
2315,Budget,0.0001552869224521,0.00015028144557292604,179,85,94
2316,Budweiser,4.400843956132392e-06,7.074097897233022e-06,6,2,4
2317,Bueno,1.0687763893464371e-05,1.2250267090330355e-05,14,5,9
2318,Buff,4.400843956132392e-06,1.8979287041356905e-06,3,2,1
2319,Buffalo,1.6974683830796368e-05,1.742643628342769e-05,19,9,10
2320,Buffer,6.496483935243052e-06,7.074097897233022e-06,7,3,4
2321,Buffett,4.840928351745632e-05,2.6053384938589907e-05,42,25,17
2322,Bug,8.592123914353715e-06,1.9151826014460126e-05,15,4,11
2323,Build,8.613080314144832e-05,7.608968713853079e-05,96,44,52
2324,Builder,2.3052039770217305e-06,5.348708166200577e-06,4,1,3
2325,Building,9.660900303700153e-05,9.506897417988779e-05,111,51,60
2326,Built,1.6974683830796368e-05,1.742643628342769e-05,23,12,11
2327,Bulgaria,3.1644163684570994e-05,3.468033359375216e-05,40,15,25
2328,Bulgarian,1.9070323809907035e-05,1.052487735929791e-05,15,9,6
2329,Bulk,4.400843956132392e-06,1.8979287041356905e-06,3,2,1
2330,Bull,2.116596378901769e-05,2.9504164400654783e-05,32,11,21
2331,Bulldog,6.496483935243052e-06,1.7253897310324457e-07,4,4,0
2332,Bullet,1.48790438516857e-05,1.9151826014460126e-05,18,7,11
2333,Bulletin,4.400843956132392e-06,1.8979287041356905e-06,3,2,1
2334,Bulletproof,2.3052039770217305e-06,3.6233184351681345e-06,4,2,2
2335,Bullied,8.592123914353715e-06,7.074097897233022e-06,8,4,4
2336,Bullst,8.592123914353715e-06,8.79948762826546e-06,9,4,5
2337,Bully,1.6974683830796368e-05,2.6053384938589907e-05,25,9,16
2338,Bullying,1.48790438516857e-05,1.9151826014460126e-05,21,10,11
2339,Bumble,2.3052039770217305e-06,3.6233184351681345e-06,3,1,2
2340,Bumblebee,4.400843956132392e-06,1.8979287041356905e-06,3,2,1
2341,Bump,1.9070323809907035e-05,3.122955413168725e-05,30,12,18
2342,Bumped,2.3052039770217305e-06,3.6233184351681345e-06,3,1,2
2343,Bunch,8.592123914353715e-06,1.9151826014460126e-05,15,4,11
2344,Bundestag,8.592123914353715e-06,3.6233184351681345e-06,6,4,2
2345,Bundle,4.400843956132392e-06,1.7253897310324457e-07,3,2,1
2346,Bundler,2.3052039770217305e-06,5.348708166200577e-06,5,1,4
2347,Bundy,2.116596378901769e-05,2.087721574549256e-05,24,11,13
2348,Bunker,4.400843956132392e-06,3.6233184351681345e-06,4,2,2
2349,Bunny,8.592123914353715e-06,1.7253897310324457e-07,4,4,0
2350,Burden,6.496483935243052e-06,5.348708166200577e-06,7,4,3
2351,Bureau,5.050492349656699e-05,6.918812821440096e-05,69,27,42
2352,Bureaucracy,6.496483935243052e-06,1.8979287041356905e-06,4,3,1
2353,Bureaucrat,4.400843956132392e-06,1.8979287041356905e-06,3,2,1
2354,Burger,1.9070323809907035e-05,2.2602605476525032e-05,26,10,16
2355,Burial,1.0687763893464371e-05,3.6233184351681345e-06,7,5,2
2356,Buried,1.0687763893464371e-05,1.052487735929791e-05,12,5,7
2357,Burka,8.592123914353715e-06,8.79948762826546e-06,10,5,5
2358,Burke,4.400843956132392e-06,1.8979287041356905e-06,4,2,2
2359,Burkina,6.496483935243052e-06,1.7253897310324457e-07,10,9,1
2360,Burma,5.888748341300963e-05,4.330728224891437e-05,60,32,28
2361,Burmese,6.496483935243052e-06,7.074097897233022e-06,8,4,4
2362,Burn,5.260056347567764e-05,3.640572332478458e-05,53,28,25
2363,Burned,1.9070323809907035e-05,1.742643628342769e-05,19,9,10
2364,Burning,3.1644163684570994e-05,2.4327995207557487e-05,36,20,16
2365,Burnout,4.400843956132392e-06,5.348708166200577e-06,5,2,3
2366,Burqa,8.592123914353715e-06,5.348708166200577e-06,7,4,3
2367,Burr,2.326160376812834e-05,5.348708166200577e-06,14,11,3
2368,Burrito,1.0687763893464371e-05,3.6233184351681345e-06,7,5,2
2369,Burst,6.496483935243052e-06,3.6233184351681345e-06,6,3,3
2370,Burundi,1.0687763893464371e-05,7.074097897233022e-06,11,6,5
2371,Burwell,8.592123914353715e-06,5.348708166200577e-06,7,4,3
2372,Bury,4.400843956132392e-06,3.6233184351681345e-06,4,2,2
2373,Burying,4.400843956132392e-06,3.6233184351681345e-06,4,2,2
2374,Bus,8.592123914353715e-06,1.7253897310324457e-07,7,5,2
2375,Bush,0.0004507721595067034,0.0003780328900692085,482,241,241
2376,BushEra,4.400843956132392e-06,5.348708166200577e-06,6,2,4
2377,Bushfire,6.496483935243052e-06,1.7253897310324457e-07,3,3,0
2378,Busines,0.0003522770804885024,0.0003141934700210085,390,186,204
2379,Business,3.7931083621902995e-05,2.9504164400654783e-05,40,20,20
2380,Businessman,4.400843956132392e-06,1.570104655239525e-05,13,3,10
2381,Businessweek,6.496483935243052e-06,3.6233184351681345e-06,6,4,2
2382,Bust,1.6974683830796368e-05,1.052487735929791e-05,14,8,6
2383,Busted,1.6974683830796368e-05,1.052487735929791e-05,14,8,6
2384,Buster,4.400843956132392e-06,3.6233184351681345e-06,4,2,2
2385,Busy,6.496483935243052e-06,7.074097897233022e-06,9,5,4
2386,But,4.400843956132392e-06,5.348708166200577e-06,5,2,3
2387,Butcher,4.400843956132392e-06,1.8979287041356905e-06,3,2,1
2388,Butler,1.6974683830796368e-05,3.6233184351681345e-06,13,10,3
2389,Butt,1.278340387257504e-05,1.7253897310324457e-07,7,6,1
2390,Butter,6.496483935243052e-06,1.8979287041356905e-06,5,3,2
2391,Butterfly,4.400843956132392e-06,5.348708166200577e-06,6,2,4
2392,Buttigieg,8.592123914353715e-06,2.777877466962238e-05,23,4,19
2393,Button,6.496483935243052e-06,2.4327995207557487e-05,24,3,21
2394,Buy,0.00012804360272366158,0.00016580995315221804,166,62,104
2395,Buyer,4.400843956132392e-06,1.052487735929791e-05,9,2,7
2396,Buying,5.050492349656699e-05,4.50326719799468e-05,57,30,27
2397,Buzz,1.48790438516857e-05,7.074097897233022e-06,12,8,4
2398,BuzzFeed,1.0687763893464371e-05,3.6233184351681345e-06,8,6,2
2399,By,2.3052039770217305e-06,3.6233184351681345e-06,3,1,2
2400,Byrne,4.400843956132392e-06,1.8979287041356905e-06,3,2,1
2401,Byron,4.400843956132392e-06,1.8979287041356905e-06,3,2,1
2402,Bystander,2.095639979110664e-07,7.074097897233022e-06,5,0,5
2403,C11,2.095639979110664e-07,3.6233184351681345e-06,3,1,2
2404,C51,4.400843956132392e-06,5.348708166200577e-06,7,2,5
2405,CA,8.592123914353715e-06,3.6233184351681345e-06,6,4,2
2406,CAIR,4.400843956132392e-06,1.8979287041356905e-06,3,2,1
2407,CAR,2.3052039770217305e-06,5.348708166200577e-06,4,1,3
2408,CB,3.1644163684570994e-05,1.9151826014460126e-05,29,17,12
2409,CBC,2.7452883726349685e-05,1.2250267090330355e-05,24,14,10
2410,CBO,1.9070323809907035e-05,2.777877466962238e-05,25,9,16
2411,CBP,2.095639979110664e-07,7.074097897233022e-06,4,0,4
2412,CCTV,1.0687763893464371e-05,2.777877466962238e-05,25,7,18
2413,CD,6.496483935243052e-06,7.074097897233022e-06,8,3,5
2414,CDC,3.3739803663681634e-05,4.50326719799468e-05,51,19,32
2415,CEO,0.00036065964040494494,0.0003400743159864947,416,194,222
2416,CERN,4.400843956132392e-06,7.074097897233022e-06,6,2,4
2417,CFO,4.400843956132392e-06,3.6233184351681345e-06,4,2,2
2418,CFPB,1.48790438516857e-05,2.2602605476525032e-05,21,7,14
2419,CHINA,2.3052039770217305e-06,7.074097897233022e-06,7,2,5
2420,CHIP,2.3052039770217305e-06,3.6233184351681345e-06,5,2,3
2421,CIA,0.00033132068069739577,0.0003642297722209491,418,174,244
2422,CISPA,2.3052039770217305e-06,1.8979287041356905e-06,3,1,2
2423,CITY,8.592123914353715e-06,3.6233184351681345e-06,8,5,3
2424,CLEVELAND,2.3052039770217305e-06,3.6233184351681345e-06,3,1,2
2425,CMO,4.400843956132392e-06,5.348708166200577e-06,5,2,3
2426,CNBC,1.48790438516857e-05,8.79948762826546e-06,12,7,5
2427,CNN,0.00018043460220142793,0.0001951415785797695,230,98,132
2428,CNNcom,4.6313643538345614e-05,4.330728224891437e-05,53,23,30
2429,CO2,3.3739803663681634e-05,2.087721574549256e-05,32,16,16
2430,COO,6.496483935243052e-06,1.7253897310324457e-07,4,4,0
2431,COVID,2.116596378901769e-05,2.4327995207557487e-05,27,10,17
2432,COVID19,0.00010708720293255492,0.00015028144557292604,153,55,98
2433,CP,2.095639979110664e-07,7.074097897233022e-06,4,0,4
2434,CPAC,1.48790438516857e-05,1.9151826014460126e-05,20,8,12
2435,CSEC,4.400843956132392e-06,1.8979287041356905e-06,3,2,1
2436,CSMonitorcom,2.3052039770217305e-06,3.6233184351681345e-06,3,1,2
2437,CSPAN,2.3052039770217305e-06,1.8979287041356905e-06,3,1,2
2438,CSR,8.592123914353715e-06,5.348708166200577e-06,7,4,3
2439,CSuite,2.095639979110664e-07,1.2250267090330355e-05,7,0,7
2440,CTV,4.400843956132392e-06,5.348708166200577e-06,5,2,3
2441,CV,1.278340387257504e-05,7.074097897233022e-06,11,6,5
2442,Cab,2.3052039770217305e-06,3.6233184351681345e-06,4,2,2
2443,Cabinet,4.6313643538345614e-05,7.263890767646595e-05,80,29,51
2444,Cable,5.6791843433898893e-05,3.640572332478458e-05,53,28,25
2445,Cablegate,8.592123914353715e-06,1.7253897310324457e-07,5,5,0
2446,Cache,4.400843956132392e-06,1.8979287041356905e-06,3,2,1
2447,Cadbury,8.592123914353715e-06,1.7253897310324457e-07,4,4,0
2448,Cadet,2.095639979110664e-07,3.6233184351681345e-06,4,2,2
2449,Cadillac,6.496483935243052e-06,7.074097897233022e-06,7,3,4
2450,Caesar,4.400843956132392e-06,5.348708166200577e-06,5,2,3
2451,Cafe,8.592123914353715e-06,1.3975656821362803e-05,13,4,9
2452,Cage,6.496483935243052e-06,1.8979287041356905e-06,5,4,1
2453,Caico,2.3052039770217305e-06,3.6233184351681345e-06,3,1,2
2454,Cairo,7.984388320411623e-05,0.00010714670229711469,108,39,69
2455,Cake,1.0687763893464371e-05,8.79948762826546e-06,11,5,6
2456,Calai,8.592123914353715e-06,1.9151826014460126e-05,16,4,12
2457,Calculate,4.400843956132392e-06,3.6233184351681345e-06,4,2,2
2458,Calculator,4.400843956132392e-06,1.8979287041356905e-06,3,2,1
2459,Caldern,4.400843956132392e-06,3.6233184351681345e-06,5,2,3
2460,Calderon,6.496483935243052e-06,1.3975656821362803e-05,11,3,8
2461,Calendar,6.496483935243052e-06,8.79948762826546e-06,8,3,5
2462,Calf,2.3052039770217305e-06,3.6233184351681345e-06,3,1,2
2463,Calgary,6.496483935243052e-06,7.074097897233022e-06,8,3,5
2464,Calif,4.400843956132392e-06,1.052487735929791e-05,10,3,7
2465,California,0.0004151462798618222,0.0004798308842001228,531,224,307
2466,Californian,6.496483935243052e-06,1.3975656821362803e-05,14,3,11
2467,Caliph,2.095639979110664e-07,5.348708166200577e-06,3,0,3
2468,Caliphate,4.400843956132392e-06,1.8979287041356905e-06,3,2,1
2469,Call,0.0005471715985457941,0.0005902558269861991,687,296,391
2470,Called,9.870464301611217e-05,6.746273848336857e-05,94,51,43
2471,Caller,4.400843956132392e-06,3.6233184351681345e-06,5,2,3
2472,Calling,6.72700433294523e-05,7.091351794543343e-05,79,36,43
2473,Calm,8.592123914353715e-06,8.79948762826546e-06,12,6,6
2474,Calorie,2.3052039770217305e-06,3.6233184351681345e-06,4,2,2
2475,Cam,1.0687763893464371e-05,1.7253897310324457e-07,5,5,0
2476,Cambodia,3.3739803663681634e-05,2.2602605476525032e-05,34,18,16
2477,Cambodian,2.5357243747239038e-05,1.9151826014460126e-05,28,14,14
2478,Cambridge,4.002672360101368e-05,2.2602605476525032e-05,36,22,14
2479,Came,3.583544364279237e-05,3.985650278684949e-05,44,20,24
2480,Camel,4.400843956132392e-06,5.348708166200577e-06,6,2,4
2481,Camera,4.6313643538345614e-05,3.468033359375216e-05,50,27,23
2482,Camerawoman,6.496483935243052e-06,1.7253897310324457e-07,3,3,0
2483,Cameron,0.00016576512234765329,0.00014510527637982858,187,86,101
2484,Cameroon,1.9070323809907035e-05,2.777877466962238e-05,27,9,18
2485,Camorra,6.496483935243052e-06,1.7253897310324457e-07,3,3,0
2486,Camp,9.24177230787802e-05,6.573734875233614e-05,93,46,47
2487,Campaign,0.0005534585184831261,0.000529867186400064,632,290,342
2488,Campaigner,8.592123914353715e-06,1.2250267090330355e-05,14,6,8
2489,Campaigning,6.496483935243052e-06,7.074097897233022e-06,8,3,5
2490,Campbell,2.116596378901769e-05,1.2250267090330355e-05,17,10,7
2491,Campu,2.954852370546031e-05,1.9151826014460126e-05,28,14,14
2492,Campus,4.400843956132392e-06,1.7253897310324457e-07,3,3,0
2493,Can,3.3739803663681634e-05,5.020884117304414e-05,49,17,32
2494,Canada,0.0006666230773551017,0.0006316651805309781,764,354,410
2495,Canadian,0.0005073544389426916,0.0005609242015586476,615,260,355
2496,Canal,2.116596378901769e-05,1.2250267090330355e-05,18,10,8
2497,Canaveral,2.3052039770217305e-06,3.6233184351681345e-06,3,1,2
2498,Canberra,4.400843956132392e-06,3.6233184351681345e-06,5,3,2
2499,Cancel,3.7931083621902995e-05,4.50326719799468e-05,46,19,27
2500,Canceled,8.592123914353715e-06,1.052487735929791e-05,13,4,9
2501,Canceling,1.0687763893464371e-05,5.348708166200577e-06,8,5,3
2502,Cancellation,4.400843956132392e-06,3.6233184351681345e-06,4,2,2
2503,Cancelled,4.400843956132392e-06,1.8979287041356905e-06,5,2,3
2504,Cancer,0.00011756540282810809,0.00011922443041434203,135,58,77
2505,Candidacy,8.592123914353715e-06,7.074097897233022e-06,10,5,5
2506,Candidate,0.0003271294007391747,0.0003038411316348131,389,182,207
2507,Candle,2.3052039770217305e-06,3.6233184351681345e-06,3,1,2
2508,Candy,1.0687763893464371e-05,3.6233184351681345e-06,8,5,3
2509,Canine,4.400843956132392e-06,5.348708166200577e-06,5,2,3
2510,Cannabi,2.116596378901769e-05,3.468033359375216e-05,33,11,22
2511,Canne,4.400843956132392e-06,1.8979287041356905e-06,3,2,1
2512,Canned,2.3052039770217305e-06,5.348708166200577e-06,4,1,3
2513,Cannon,4.400843956132392e-06,8.79948762826546e-06,8,3,5
2514,Cannot,3.583544364279237e-05,1.742643628342769e-05,30,20,10
2515,Cant,0.00021396484186719832,0.00022274781427628854,264,119,145
2516,Canterbury,8.592123914353715e-06,5.348708166200577e-06,7,4,3
2517,Cantor,1.6974683830796368e-05,7.074097897233022e-06,14,9,5
2518,Canyon,1.6974683830796368e-05,5.348708166200577e-06,12,8,4
2519,Cap,1.0687763893464371e-05,8.79948762826546e-06,15,7,8
2520,Capability,4.400843956132392e-06,1.3975656821362803e-05,11,2,9
2521,Capable,4.400843956132392e-06,1.8979287041356905e-06,4,3,1
2522,Cape,2.326160376812834e-05,1.2250267090330355e-05,18,11,7
2523,Capita,2.3052039770217305e-06,1.8979287041356905e-06,3,2,1
2524,Capital,5.260056347567764e-05,4.330728224891437e-05,57,27,30
2525,Capitalism,1.6974683830796368e-05,1.3975656821362803e-05,20,10,10
2526,Capitalist,6.496483935243052e-06,1.8979287041356905e-06,6,4,2
2527,Capito,4.400843956132392e-06,1.052487735929791e-05,8,2,6
2528,Capitol,0.0001741476822640959,0.00016235917369015308,196,90,106
2529,Capsule,4.400843956132392e-06,3.6233184351681345e-06,4,2,2
2530,Capt,4.400843956132392e-06,3.6233184351681345e-06,4,2,2
2531,Captain,1.6974683830796368e-05,1.9151826014460126e-05,23,9,14
2532,Captive,4.400843956132392e-06,7.074097897233022e-06,6,2,4
2533,Captivity,4.400843956132392e-06,1.8979287041356905e-06,3,2,1
2534,Capture,2.954852370546031e-05,2.777877466962238e-05,38,20,18
2535,Captured,1.6974683830796368e-05,1.2250267090330355e-05,17,9,8
2536,Capturing,2.3052039770217305e-06,1.8979287041356905e-06,3,1,2
2537,Car,0.00020767792192986646,0.0001571830044970555,222,116,106
2538,Caraca,8.592123914353715e-06,5.348708166200577e-06,7,4,3
2539,Caravan,8.592123914353715e-06,7.074097897233022e-06,8,4,4
2540,Carbide,4.400843956132392e-06,3.6233184351681345e-06,4,2,2
2541,Carbon,4.002672360101368e-05,4.1581892517881935e-05,45,19,26
2542,Card,0.00013642616264010403,0.00011577365095227703,141,68,73
2543,Cardboard,2.095639979110664e-07,5.348708166200577e-06,4,0,4
2544,Cardinal,2.116596378901769e-05,8.79948762826546e-06,17,12,5
2545,Care,0.0005911800381071181,0.0005005355609725121,636,301,335
2546,Career,4.212236358012434e-05,5.020884117304414e-05,52,21,31
2547,Careful,1.0687763893464371e-05,8.79948762826546e-06,10,5,5
2548,Carefully,2.3052039770217305e-06,1.7253897310324457e-07,3,2,1
2549,Caregiver,2.3052039770217305e-06,5.348708166200577e-06,5,2,3
2550,Carey,2.095639979110664e-07,7.074097897233022e-06,4,0,4
2551,Cargo,1.0687763893464371e-05,8.79948762826546e-06,11,6,5
2552,Caribbean,2.954852370546031e-05,1.9151826014460126e-05,30,15,15
2553,Caring,1.278340387257504e-05,1.052487735929791e-05,13,7,6
2554,Carl,3.3739803663681634e-05,2.777877466962238e-05,36,18,18
2555,Carla,4.400843956132392e-06,5.348708166200577e-06,5,2,3
2556,Carlo,2.326160376812834e-05,1.570104655239525e-05,27,15,12
2557,Carlson,2.5357243747239038e-05,2.2602605476525032e-05,26,12,14
2558,Carly,7.146132328767358e-05,3.122955413168725e-05,55,37,18
2559,Carmaker,4.400843956132392e-06,3.6233184351681345e-06,5,3,2
2560,Carman,4.400843956132392e-06,1.2250267090330355e-05,10,2,8
2561,Carnage,2.3052039770217305e-06,3.6233184351681345e-06,3,1,2
2562,Carnegie,2.3052039770217305e-06,3.6233184351681345e-06,3,1,2
2563,Carney,2.095639979110664e-07,1.8979287041356905e-06,3,2,1
2564,Carnival,4.400843956132392e-06,8.79948762826546e-06,9,2,7
2565,Carol,2.3052039770217305e-06,5.348708166200577e-06,6,1,5
2566,Carolina,0.00020139100199253443,0.0002503540499728076,267,104,163
2567,Caroline,6.496483935243052e-06,5.348708166200577e-06,7,3,4
2568,Carolyn,4.400843956132392e-06,7.074097897233022e-06,7,2,5
2569,Carpet,4.400843956132392e-06,7.074097897233022e-06,7,2,5
2570,Carr,2.3052039770217305e-06,7.074097897233022e-06,5,1,4
2571,Carradine,2.3052039770217305e-06,3.6233184351681345e-06,3,1,2
2572,Carrie,1.0687763893464371e-05,3.6233184351681345e-06,9,6,3
2573,Carried,4.400843956132392e-06,1.742643628342769e-05,13,3,10
2574,Carrier,2.5357243747239038e-05,2.087721574549256e-05,27,13,14
2575,Carroll,2.095639979110664e-07,1.742643628342769e-05,10,0,10
2576,Carry,4.212236358012434e-05,2.777877466962238e-05,37,20,17
2577,Carrying,2.116596378901769e-05,7.074097897233022e-06,15,11,4
2578,Carson,0.00013013924270277222,0.00012267520987640663,151,73,78
2579,Cart,6.496483935243052e-06,1.7253897310324457e-07,4,4,0
2580,Carta,2.095639979110664e-07,3.6233184351681345e-06,3,1,2
2581,Cartel,1.9070323809907035e-05,4.330728224891437e-05,35,9,26
2582,Carter,6.098312339212028e-05,6.056117955923882e-05,67,30,37
2583,Cartoon,1.0687763893464371e-05,1.570104655239525e-05,15,6,9
2584,Cartoonist,4.400843956132392e-06,3.6233184351681345e-06,5,2,3
2585,Case,0.00024330380157474795,0.0002727841164762295,309,136,173
2586,Casey,4.400843956132392e-06,8.79948762826546e-06,8,3,5
2587,Cash,5.050492349656699e-05,5.5385010366141504e-05,61,25,36
2588,Cashier,1.0687763893464371e-05,1.7253897310324457e-07,6,6,0
2589,Casino,1.0687763893464371e-05,1.9151826014460126e-05,17,5,12
2590,Caspian,6.496483935243052e-06,5.348708166200577e-06,7,3,4
2591,Cassidy,8.592123914353715e-06,7.074097897233022e-06,9,4,5
2592,Cast,3.3739803663681634e-05,2.777877466962238e-05,36,17,19
2593,Caster,2.3052039770217305e-06,1.8979287041356905e-06,3,1,2
2594,Castile,2.3052039770217305e-06,1.2250267090330355e-05,10,1,9
2595,Casting,4.400843956132392e-06,1.8979287041356905e-06,5,3,2
2596,Castle,2.3052039770217305e-06,1.2250267090330355e-05,10,1,9
2597,Castro,5.4696203454788295e-05,7.263890767646595e-05,71,27,44
2598,Casually,2.3052039770217305e-06,5.348708166200577e-06,4,1,3
2599,Casualty,6.496483935243052e-06,1.052487735929791e-05,11,5,6
2600,Cat,6.098312339212028e-05,6.401195902130366e-05,74,34,40
2601,Catalan,1.278340387257504e-05,8.79948762826546e-06,11,6,5
2602,Catalonia,1.9070323809907035e-05,7.074097897233022e-06,14,9,5
2603,Catastrophe,1.9070323809907035e-05,5.348708166200577e-06,12,9,3
2604,Catastrophic,8.592123914353715e-06,8.79948762826546e-06,9,4,5
2605,Catch,3.583544364279237e-05,2.6053384938589907e-05,35,19,16
2606,Catching,8.592123914353715e-06,1.570104655239525e-05,13,4,9
2607,Category,8.592123914353715e-06,1.052487735929791e-05,10,4,6
2608,Cathedral,8.592123914353715e-06,5.348708166200577e-06,8,5,3
2609,Catherine,6.496483935243052e-06,5.348708166200577e-06,6,3,3
2610,Catholic,0.0002642602013658546,0.0002175716450831913,277,137,140
2611,Catholicism,2.3052039770217305e-06,5.348708166200577e-06,4,1,3
2612,Cathy,2.095639979110664e-07,3.6233184351681345e-06,3,0,3
2613,Cattle,4.400843956132392e-06,3.6233184351681345e-06,4,2,2
2614,Caucasu,1.6974683830796368e-05,8.79948762826546e-06,13,8,5
2615,Caucu,8.403516316233764e-05,7.436429740749831e-05,89,44,45
2616,Caucus,1.6974683830796368e-05,1.052487735929791e-05,15,9,6
2617,Caught,4.4218003559234974e-05,5.020884117304414e-05,53,21,32
2618,Cause,6.517440335034157e-05,8.989280498679035e-05,90,34,56
2619,Caused,1.48790438516857e-05,1.570104655239525e-05,17,7,10
2620,Causing,4.400843956132392e-06,1.570104655239525e-05,11,2,9
2621,Caution,8.592123914353715e-06,5.348708166200577e-06,7,4,3
2622,Cautiou,2.3052039770217305e-06,5.348708166200577e-06,4,1,3
2623,Cavalier,2.095639979110664e-07,7.074097897233022e-06,4,0,4
2624,Cave,1.0687763893464371e-05,1.9151826014460126e-05,18,5,13
2625,Caveat,2.3052039770217305e-06,3.6233184351681345e-06,3,1,2
2626,Cawthorn,2.095639979110664e-07,7.074097897233022e-06,5,1,4
2627,Cayman,4.400843956132392e-06,7.074097897233022e-06,6,2,4
2628,Ccere,8.592123914353715e-06,3.6233184351681345e-06,8,4,4
2629,Cease,4.400843956132392e-06,1.8979287041356905e-06,3,2,1
2630,CeaseFire,1.0687763893464371e-05,3.6233184351681345e-06,7,5,2
2631,Ceasefire,4.400843956132392e-06,1.2250267090330355e-05,11,3,8
2632,Cecil,1.6974683830796368e-05,1.3975656821362803e-05,17,9,8
2633,Cecile,4.400843956132392e-06,5.348708166200577e-06,6,3,3
2634,Cecilia,4.400843956132392e-06,1.7253897310324457e-07,3,3,0
2635,Ceiling,1.9070323809907035e-05,1.742643628342769e-05,19,9,10
2636,Celeb,2.3052039770217305e-06,8.79948762826546e-06,6,1,5
2637,Celebrate,4.4218003559234974e-05,5.5385010366141504e-05,58,23,35
2638,Celebrated,8.592123914353715e-06,3.6233184351681345e-06,6,4,2
2639,Celebrating,2.326160376812834e-05,2.087721574549256e-05,25,11,14
2640,Celebration,1.278340387257504e-05,1.052487735929791e-05,13,6,7
2641,Celebrity,3.1644163684570994e-05,2.777877466962238e-05,35,17,18
2642,Cell,4.002672360101368e-05,2.9504164400654783e-05,40,23,17
2643,Cellphone,1.6974683830796368e-05,1.2250267090330355e-05,15,8,7
2644,Celsiu,6.496483935243052e-06,8.79948762826546e-06,10,3,7
2645,Celtic,4.400843956132392e-06,5.348708166200577e-06,5,2,3
2646,Cement,8.592123914353715e-06,7.074097897233022e-06,8,4,4
2647,Cemented,2.3052039770217305e-06,3.6233184351681345e-06,3,1,2
2648,Cemetery,1.0687763893464371e-05,8.79948762826546e-06,12,6,6
2649,Censor,1.48790438516857e-05,1.3975656821362803e-05,15,7,8
2650,Censored,2.095639979110664e-07,5.348708166200577e-06,3,0,3
2651,Censoring,2.3052039770217305e-06,3.6233184351681345e-06,3,1,2
2652,Censorship,2.954852370546031e-05,1.570104655239525e-05,29,16,13
2653,Censu,3.3739803663681634e-05,3.468033359375216e-05,40,16,24
2654,Censure,2.095639979110664e-07,7.074097897233022e-06,4,0,4
2655,Cent,4.400843956132392e-06,8.79948762826546e-06,8,2,6
2656,Centennial,6.496483935243052e-06,1.7253897310324457e-07,3,3,0
2657,Center,0.00012175668278632962,0.00011922443041434203,139,65,74
2658,Central,0.00011756540282810809,0.0001295767688005365,144,65,79
2659,Centre,1.278340387257504e-05,2.6053384938589907e-05,22,6,16
2660,Centrist,6.496483935243052e-06,3.6233184351681345e-06,5,3,2
2661,CenturiesOld,2.3052039770217305e-06,3.6233184351681345e-06,3,1,2
2662,Century,4.002672360101368e-05,5.020884117304414e-05,51,21,30
2663,CenturyOld,4.400843956132392e-06,3.6233184351681345e-06,4,2,2
2664,Cere,1.0687763893464371e-05,5.348708166200577e-06,8,5,3
2665,Cereal,4.400843956132392e-06,1.8979287041356905e-06,4,3,1
2666,Cerebral,2.3052039770217305e-06,8.79948762826546e-06,8,3,5
2667,Ceremony,6.496483935243052e-06,1.570104655239525e-05,13,3,10
2668,Cern,2.3052039770217305e-06,1.8979287041356905e-06,3,2,1
2669,Certain,1.48790438516857e-05,1.2250267090330355e-05,15,8,7
2670,Certainly,8.592123914353715e-06,1.052487735929791e-05,11,4,7
2671,Certificate,1.0687763893464371e-05,1.2250267090330355e-05,15,7,8
2672,Cesar,1.278340387257504e-05,1.8979287041356905e-06,7,6,1
2673,Cesium,4.400843956132392e-06,1.8979287041356905e-06,3,2,1
2674,Cha,2.095639979110664e-07,5.348708166200577e-06,3,0,3
2675,Chad,1.278340387257504e-05,2.087721574549256e-05,22,7,15
2676,Chafee,2.3052039770217305e-06,7.074097897233022e-06,5,1,4
2677,Chaffetz,2.116596378901769e-05,2.9504164400654783e-05,31,11,20
2678,Chain,2.7452883726349685e-05,1.2250267090330355e-05,23,14,9
2679,Chair,5.888748341300963e-05,8.644202552472544e-05,87,30,57
2680,Chairman,5.260056347567764e-05,5.711040009717395e-05,66,28,38
2681,Chairmanship,2.095639979110664e-07,5.348708166200577e-06,3,0,3
2682,Chaka,6.496483935243052e-06,1.8979287041356905e-06,4,3,1
2683,Challenge,0.00011756540282810809,0.0001485560558418934,165,66,99
2684,Challenged,1.48790438516857e-05,8.79948762826546e-06,13,7,6
2685,Challenger,4.002672360101368e-05,5.3659620635109e-05,50,19,31
2686,Challenging,2.326160376812834e-05,3.6233184351681345e-06,15,12,3
2687,Chamber,3.3739803663681634e-05,1.052487735929791e-05,23,17,6
2688,Champ,2.3052039770217305e-06,3.6233184351681345e-06,4,2,2
2689,Champion,3.1644163684570994e-05,3.468033359375216e-05,35,15,20
2690,Championship,2.116596378901769e-05,7.074097897233022e-06,15,10,5
2691,Chan,8.592123914353715e-06,5.348708166200577e-06,9,6,3
2692,Chance,5.888748341300963e-05,6.401195902130366e-05,72,31,41
2693,Chancellor,5.888748341300963e-05,3.985650278684949e-05,57,30,27
2694,Change,0.0004402939596111501,0.0004936340020483826,555,246,309
2695,Changed,4.840928351745632e-05,5.5385010366141504e-05,61,27,34
2696,Changeorg,4.400843956132392e-06,1.8979287041356905e-06,4,3,1
2697,Changer,4.400843956132392e-06,5.348708166200577e-06,5,2,3
2698,Changing,3.7931083621902995e-05,5.3659620635109e-05,56,21,35
2699,Channel,4.840928351745632e-05,5.1934230904076595e-05,64,30,34
2700,Chant,1.0687763893464371e-05,5.348708166200577e-06,8,5,3
2701,Chanting,2.095639979110664e-07,3.6233184351681345e-06,4,1,3
2702,Chao,6.517440335034157e-05,3.640572332478458e-05,59,32,27
2703,Chaotic,2.3052039770217305e-06,5.348708166200577e-06,5,1,4
2704,Chapel,4.400843956132392e-06,5.348708166200577e-06,7,2,5
2705,Chaplain,8.592123914353715e-06,7.074097897233022e-06,11,6,5
2706,Chapman,2.3052039770217305e-06,5.348708166200577e-06,4,1,3
2707,Chapo,1.278340387257504e-05,1.742643628342769e-05,18,7,11
2708,Chapter,1.48790438516857e-05,1.742643628342769e-05,18,8,10
2709,Character,1.6974683830796368e-05,1.3975656821362803e-05,19,9,10
2710,Charge,0.00014900000251476814,0.00014165449691776373,164,77,87
2711,Charged,6.936568330856297e-05,8.299124606266055e-05,90,37,53
2712,Charging,1.0687763893464371e-05,5.348708166200577e-06,9,5,4
2713,Charitable,1.6974683830796368e-05,1.570104655239525e-05,21,10,11
2714,Charity,6.517440335034157e-05,7.263890767646595e-05,78,33,45
2715,Charle,4.840928351745632e-05,5.883578982820635e-05,62,28,34
2716,Charleston,2.954852370546031e-05,4.330728224891437e-05,40,14,26
2717,Charlie,8.822644312055891e-05,6.573734875233614e-05,87,44,43
2718,Charlotte,1.9070323809907035e-05,1.2250267090330355e-05,17,9,8
2719,Charlottesville,6.517440335034157e-05,0.00010542131256608228,109,46,63
2720,Charm,8.592123914353715e-06,3.6233184351681345e-06,6,4,2
2721,Charon,2.095639979110664e-07,5.348708166200577e-06,4,0,4
2722,Charred,2.3052039770217305e-06,1.8979287041356905e-06,3,1,2
2723,Chart,1.278340387257504e-05,2.6053384938589907e-05,26,8,18
2724,Charter,2.326160376812834e-05,1.570104655239525e-05,22,12,10
2725,Chase,3.3739803663681634e-05,2.6053384938589907e-05,32,16,16
2726,Chasing,6.496483935243052e-06,1.7253897310324457e-07,3,3,0
2727,Chastise,6.496483935243052e-06,3.6233184351681345e-06,5,3,2
2728,Chat,1.278340387257504e-05,1.2250267090330355e-05,17,7,10
2729,Chattanooga,1.0687763893464371e-05,1.8979287041356905e-06,6,5,1
2730,Chatter,4.400843956132392e-06,3.6233184351681345e-06,4,2,2
2731,Chauvin,2.095639979110664e-07,1.2250267090330355e-05,8,0,8
2732,Chavez,8.613080314144832e-05,7.091351794543343e-05,93,47,46
2733,Cheap,2.7452883726349685e-05,2.777877466962238e-05,30,13,17
2734,Cheaper,1.48790438516857e-05,1.742643628342769e-05,20,9,11
2735,Cheapest,4.400843956132392e-06,5.348708166200577e-06,5,2,3
2736,Cheat,6.496483935243052e-06,5.348708166200577e-06,7,3,4
2737,Cheating,4.400843956132392e-06,1.052487735929791e-05,8,2,6
2738,Chechen,1.278340387257504e-05,1.742643628342769e-05,18,6,12
2739,Chechnya,2.116596378901769e-05,2.087721574549256e-05,24,11,13
2740,Check,6.517440335034157e-05,0.00010024514337298497,106,39,67
2741,Checked,2.3052039770217305e-06,3.6233184351681345e-06,3,1,2
2742,Checking,8.592123914353715e-06,2.6053384938589907e-05,22,7,15
2743,Checkpoint,2.3052039770217305e-06,3.6233184351681345e-06,4,1,3
2744,Cheer,1.48790438516857e-05,1.2250267090330355e-05,15,7,8
2745,Cheered,2.3052039770217305e-06,1.8979287041356905e-06,4,3,1
2746,Cheering,6.496483935243052e-06,1.8979287041356905e-06,5,3,2
2747,Cheerleader,2.3052039770217305e-06,5.348708166200577e-06,5,1,4
2748,Cheese,4.400843956132392e-06,1.8979287041356905e-06,3,2,1
2749,Cheesy,2.3052039770217305e-06,3.6233184351681345e-06,3,1,2
2750,Cheetah,2.3052039770217305e-06,1.8979287041356905e-06,3,2,1
2751,Chef,8.592123914353715e-06,7.074097897233022e-06,11,5,6
2752,Chelsea,2.954852370546031e-05,2.6053384938589907e-05,37,15,22
2753,Chelyabinsk,2.095639979110664e-07,3.6233184351681345e-06,3,0,3
2754,Chemical,5.6791843433898893e-05,3.122955413168725e-05,50,29,21
2755,Chemistry,8.592123914353715e-06,1.2250267090330355e-05,12,4,8
2756,Chemo,2.095639979110664e-07,3.6233184351681345e-06,3,1,2
2757,Chen,6.496483935243052e-06,1.8979287041356905e-06,5,3,2
2758,Cheney,5.6791843433898893e-05,5.711040009717395e-05,66,29,37
2759,Chennai,6.496483935243052e-06,1.7253897310324457e-07,3,3,0
2760,Cheonan,4.400843956132392e-06,5.348708166200577e-06,5,2,3
2761,Cherie,6.496483935243052e-06,3.6233184351681345e-06,5,3,2
2762,Chernobyl,1.9070323809907035e-05,2.777877466962238e-05,33,12,21
2763,Cherokee,2.3052039770217305e-06,1.8979287041356905e-06,3,1,2
2764,Cheryl,2.095639979110664e-07,5.348708166200577e-06,4,0,4
2765,Ches,6.496483935243052e-06,8.79948762826546e-06,8,3,5
2766,Chesapeake,2.3052039770217305e-06,5.348708166200577e-06,4,1,3
2767,Chest,4.400843956132392e-06,1.8979287041356905e-06,3,2,1
2768,Chevron,7.984388320411623e-05,5.020884117304414e-05,75,43,32
2769,Chevy,2.095639979110664e-07,8.79948762826546e-06,5,0,5
2770,Chewbacca,6.496483935243052e-06,3.6233184351681345e-06,5,3,2
2771,Chewed,4.400843956132392e-06,1.8979287041356905e-06,3,2,1
2772,Chewing,4.400843956132392e-06,3.6233184351681345e-06,4,2,2
2773,Chi,8.592123914353715e-06,1.8979287041356905e-06,6,4,2
2774,Chibok,2.3052039770217305e-06,3.6233184351681345e-06,3,1,2
2775,Chicago,0.00010918284291166549,0.00011749904068330962,143,63,80
2776,Chick,4.400843956132392e-06,1.8979287041356905e-06,3,2,1
2777,Chicken,1.48790438516857e-05,2.6053384938589907e-05,25,9,16
2778,Chide,8.592123914353715e-06,7.074097897233022e-06,8,4,4
2779,Chief,0.00023282560167919462,0.00027450950620726186,300,121,179
2780,Chihuahua,4.400843956132392e-06,1.052487735929791e-05,10,3,7
2781,Chilcot,4.400843956132392e-06,1.2250267090330355e-05,9,2,7
2782,Child,0.0003962855200498262,0.00039528678737953317,466,210,256
2783,Childhood,1.48790438516857e-05,3.2954943862719716e-05,29,9,20
2784,Childish,2.095639979110664e-07,5.348708166200577e-06,3,0,3
2785,Children,1.9070323809907035e-05,3.640572332478458e-05,35,10,25
2786,Chile,8.822644312055891e-05,0.00010887209202814718,108,43,65
2787,Chilean,2.954852370546031e-05,5.3659620635109e-05,49,15,34
2788,Chili,2.3052039770217305e-06,5.348708166200577e-06,4,1,3
2789,Chill,1.278340387257504e-05,1.052487735929791e-05,14,8,6
2790,Chilling,1.48790438516857e-05,2.4327995207557487e-05,22,8,14
2791,Chimp,4.400843956132392e-06,8.79948762826546e-06,7,2,5
2792,China,0.0020392672636725864,0.0019895468988535116,2360,1058,1302
2793,ChinaIndia,2.095639979110664e-07,3.6233184351681345e-06,3,0,3
2794,ChinaU,2.3052039770217305e-06,5.348708166200577e-06,4,1,3
2795,Chinese,0.0008908565551199428,0.0008594166250272608,1017,462,555
2796,Chinesemade,2.095639979110664e-07,5.348708166200577e-06,3,0,3
2797,Chip,2.3052039770217305e-06,1.052487735929791e-05,7,1,6
2798,Chipotle,3.3739803663681634e-05,2.6053384938589907e-05,35,20,15
2799,Chiquita,8.592123914353715e-06,1.8979287041356905e-06,7,6,1
2800,Chirac,2.3052039770217305e-06,5.348708166200577e-06,4,1,3
2801,Cho,2.3052039770217305e-06,3.6233184351681345e-06,3,1,2
2802,Chobani,2.095639979110664e-07,7.074097897233022e-06,4,0,4
2803,Chocolate,1.0687763893464371e-05,1.8979287041356905e-06,6,5,1
2804,Choice,3.7931083621902995e-05,4.330728224891437e-05,53,23,30
2805,Choke,4.400843956132392e-06,1.8979287041356905e-06,3,2,1
2806,Choked,6.496483935243052e-06,1.7253897310324457e-07,4,3,1
2807,Choking,2.3052039770217305e-06,3.6233184351681345e-06,4,1,3
2808,Cholera,1.278340387257504e-05,7.074097897233022e-06,10,6,4
2809,Chomsky,1.48790438516857e-05,1.3975656821362803e-05,17,8,9
2810,Choose,1.9070323809907035e-05,3.468033359375216e-05,36,13,23
2811,Choosing,1.48790438516857e-05,1.2250267090330355e-05,16,8,8
2812,Chop,2.3052039770217305e-06,3.6233184351681345e-06,4,1,3
2813,Chopra,6.496483935243052e-06,3.6233184351681345e-06,5,3,2
2814,Choru,4.400843956132392e-06,3.6233184351681345e-06,4,2,2
2815,Chose,2.3052039770217305e-06,3.6233184351681345e-06,3,1,2
2816,Chri,0.0001741476822640959,0.00022274781427628854,234,95,139
2817,Christ,1.9070323809907035e-05,7.074097897233022e-06,14,10,4
2818,Christchurch,1.6974683830796368e-05,7.074097897233022e-06,13,8,5
2819,Christian,0.0003627552803840558,0.0003141934700210085,400,185,215
2820,Christiane,4.400843956132392e-06,3.6233184351681345e-06,4,2,2
2821,Christianity,2.954852370546031e-05,1.570104655239525e-05,24,14,10
2822,Christie,0.00011966104280721883,0.0001382037174556987,155,67,88
2823,Christina,4.400843956132392e-06,3.6233184351681345e-06,5,2,3
2824,Christine,1.6974683830796368e-05,1.9151826014460126e-05,20,8,12
2825,Christma,0.0001531912824729893,0.00017098612234531542,202,88,114
2826,Christopher,4.6313643538345614e-05,2.777877466962238e-05,42,23,19
2827,Christy,2.3052039770217305e-06,3.6233184351681345e-06,3,1,2
2828,Chrome,4.400843956132392e-06,1.8979287041356905e-06,6,3,3
2829,Chronic,4.400843956132392e-06,3.6233184351681345e-06,4,2,2
2830,Chronicle,2.3052039770217305e-06,3.6233184351681345e-06,3,1,2
2831,Chrysler,4.400843956132392e-06,5.348708166200577e-06,5,2,3
2832,Chuck,8.613080314144832e-05,8.816741525575797e-05,110,47,63
2833,Church,0.00023911252161652657,0.00022792398346938586,263,120,143
2834,Churchill,2.3052039770217305e-06,1.052487735929791e-05,9,3,6
2835,Chuy,6.496483935243052e-06,1.8979287041356905e-06,4,3,1
2836,Chvez,1.9070323809907035e-05,2.6053384938589907e-05,30,13,17
2837,Cigarette,1.48790438516857e-05,1.052487735929791e-05,14,7,7
2838,Cincinnati,8.592123914353715e-06,8.79948762826546e-06,9,4,5
2839,Cinderella,2.095639979110664e-07,1.8979287041356905e-06,4,1,3
2840,Cindy,1.0687763893464371e-05,3.6233184351681345e-06,7,5,2
2841,Cinema,2.3052039770217305e-06,3.6233184351681345e-06,4,1,3
2842,Cipla,4.400843956132392e-06,1.8979287041356905e-06,3,2,1
2843,Circle,1.278340387257504e-05,7.074097897233022e-06,12,7,5
2844,Circu,8.592123914353715e-06,5.348708166200577e-06,8,4,4
2845,Circuit,1.6974683830796368e-05,2.087721574549256e-05,25,13,12
2846,Circumcision,2.3052039770217305e-06,7.074097897233022e-06,7,1,6
2847,Circumstance,2.3052039770217305e-06,1.7253897310324457e-07,3,1,2
2848,Cisco,1.6974683830796368e-05,3.6233184351681345e-06,11,8,3
2849,Cisnero,2.3052039770217305e-06,3.6233184351681345e-06,3,1,2
2850,Cite,6.496483935243052e-06,1.570104655239525e-05,12,3,9
2851,Cited,6.496483935243052e-06,1.7253897310324457e-07,4,4,0
2852,Citibank,8.592123914353715e-06,1.8979287041356905e-06,5,4,1
2853,Citigroup,6.496483935243052e-06,1.052487735929791e-05,9,3,6
2854,Citing,2.326160376812834e-05,1.9151826014460126e-05,25,11,14
2855,Citizen,9.451336305789087e-05,0.00012267520987640663,127,51,76
2856,Citizenship,4.6313643538345614e-05,4.50326719799468e-05,53,22,31
2857,City,0.0005681279983369005,0.00045222464850360367,610,306,304
2858,Citybased,2.095639979110664e-07,5.348708166200577e-06,3,0,3
2859,Ciudad,1.0687763893464371e-05,8.79948762826546e-06,11,5,6
2860,Civic,8.592123914353715e-06,7.074097897233022e-06,9,5,4
2861,Civil,0.00014900000251476814,0.00014165449691776373,174,79,95
2862,Civilian,7.146132328767358e-05,5.5385010366141504e-05,73,39,34
2863,Civility,8.592123914353715e-06,3.6233184351681345e-06,6,4,2
2864,Civilization,2.3052039770217305e-06,7.074097897233022e-06,5,1,4
2865,Claim,0.0003229381207809529,0.0003055665213658457,363,171,192
2866,Claimed,1.278340387257504e-05,7.074097897233022e-06,11,7,4
2867,Claiming,2.116596378901769e-05,1.9151826014460126e-05,22,11,11
2868,Claire,1.9070323809907035e-05,7.074097897233022e-06,15,10,5
2869,Clap,8.592123914353715e-06,8.79948762826546e-06,9,4,5
2870,Clapper,1.278340387257504e-05,7.074097897233022e-06,10,6,4
2871,Clapping,6.496483935243052e-06,1.7253897310324457e-07,3,3,0
2872,Clarence,1.6974683830796368e-05,1.052487735929791e-05,17,11,6
2873,Clarification,6.496483935243052e-06,1.7253897310324457e-07,3,3,0
2874,Clarify,8.592123914353715e-06,1.8979287041356905e-06,7,5,2
2875,Clark,2.5357243747239038e-05,1.570104655239525e-05,22,12,10
2876,Clarke,8.592123914353715e-06,8.79948762826546e-06,11,4,7
2877,Clarkson,8.592123914353715e-06,1.7253897310324457e-07,4,4,0
2878,Clas,6.517440335034157e-05,7.091351794543343e-05,83,35,48
2879,Clash,4.4218003559234974e-05,4.330728224891437e-05,49,22,27
2880,Class,6.496483935243052e-06,1.052487735929791e-05,10,3,7
2881,ClassAction,2.3052039770217305e-06,1.8979287041356905e-06,3,1,2
2882,Classic,8.592123914353715e-06,1.052487735929791e-05,13,7,6
2883,Classified,4.840928351745632e-05,2.777877466962238e-05,42,25,17
2884,Classmate,1.278340387257504e-05,7.074097897233022e-06,13,7,6
2885,Classroom,1.0687763893464371e-05,1.2250267090330355e-05,12,5,7
2886,Clau,2.3052039770217305e-06,8.79948762826546e-06,8,3,5
2887,Claudia,6.496483935243052e-06,1.8979287041356905e-06,4,3,1
2888,Clause,8.592123914353715e-06,5.348708166200577e-06,7,4,3
2889,Clay,1.0687763893464371e-05,5.348708166200577e-06,9,5,4
2890,Clayton,2.3052039770217305e-06,3.6233184351681345e-06,3,1,2
2891,Clean,7.984388320411623e-05,8.4716635793693e-05,91,39,52
2892,CleanUp,2.3052039770217305e-06,3.6233184351681345e-06,3,1,2
2893,Cleaner,6.496483935243052e-06,3.6233184351681345e-06,5,3,2
2894,Cleaning,4.400843956132392e-06,1.052487735929791e-05,10,3,7
2895,Cleanse,4.400843956132392e-06,1.8979287041356905e-06,3,2,1
2896,Cleansing,4.400843956132392e-06,3.6233184351681345e-06,5,2,3
2897,Cleanup,6.496483935243052e-06,1.8979287041356905e-06,4,3,1
2898,Clear,5.050492349656699e-05,3.468033359375216e-05,52,27,25
2899,Clearance,1.278340387257504e-05,1.742643628342769e-05,17,6,11
2900,Cleared,8.592123914353715e-06,7.074097897233022e-06,8,4,4
2901,Clearing,4.400843956132392e-06,5.348708166200577e-06,5,2,3
2902,Clearly,1.48790438516857e-05,1.3975656821362803e-05,20,10,10
2903,Clegg,1.6974683830796368e-05,1.052487735929791e-05,17,10,7
2904,Clemency,6.496483935243052e-06,8.79948762826546e-06,12,4,8
2905,Clement,2.3052039770217305e-06,5.348708166200577e-06,4,1,3
2906,Clergy,2.095639979110664e-07,1.8979287041356905e-06,3,0,3
2907,Cleric,1.9070323809907035e-05,1.2250267090330355e-05,20,10,10
2908,Clerk,1.9070323809907035e-05,3.468033359375216e-05,31,9,22
2909,Cleveland,5.050492349656699e-05,4.1581892517881935e-05,52,26,26
2910,Clever,2.3052039770217305e-06,3.6233184351681345e-06,3,1,2
2911,Click,1.0687763893464371e-05,1.052487735929791e-05,11,5,6
2912,Client,1.9070323809907035e-05,2.2602605476525032e-05,23,9,14
2913,Cliff,1.278340387257504e-05,1.3975656821362803e-05,15,6,9
2914,Climate,0.00045705907944403545,0.000519514848013869,569,245,324
2915,ClimateChange,8.592123914353715e-06,3.6233184351681345e-06,6,4,2
2916,ClimateDenying,2.095639979110664e-07,8.79948762826546e-06,5,0,5
2917,Climategate,4.400843956132392e-06,1.8979287041356905e-06,3,2,1
2918,Climb,1.278340387257504e-05,1.052487735929791e-05,14,8,6
2919,Climber,6.496483935243052e-06,1.8979287041356905e-06,4,3,1
2920,Climbing,4.400843956132392e-06,7.074097897233022e-06,6,2,4
2921,Clinic,2.5357243747239038e-05,3.468033359375216e-05,38,16,22
2922,Clinical,2.095639979110664e-07,3.6233184351681345e-06,3,1,2
2923,Clint,4.400843956132392e-06,1.8979287041356905e-06,3,2,1
2924,Clinton,0.0019302939847588307,0.0015961580401781146,2025,988,1037
2925,Clip,1.278340387257504e-05,5.348708166200577e-06,9,6,3
2926,Clive,4.400843956132392e-06,1.8979287041356905e-06,3,2,1
2927,Cliven,4.400843956132392e-06,7.074097897233022e-06,6,2,4
2928,Clock,1.6974683830796368e-05,2.2602605476525032e-05,23,9,14
2929,Cloning,2.3052039770217305e-06,3.6233184351681345e-06,3,1,2
2930,Clooney,8.592123914353715e-06,8.79948762826546e-06,9,4,5
2931,Close,0.00011337412286988677,0.00011749904068330962,136,60,76
2932,Closed,1.278340387257504e-05,2.6053384938589907e-05,24,8,16
2933,ClosedDoor,2.3052039770217305e-06,3.6233184351681345e-06,3,1,2
2934,Closer,4.002672360101368e-05,3.985650278684949e-05,49,22,27
2935,Closet,4.400843956132392e-06,5.348708166200577e-06,5,2,3
2936,Closing,2.5357243747239038e-05,2.9504164400654783e-05,30,13,17
2937,Closure,1.0687763893464371e-05,1.2250267090330355e-05,13,6,7
2938,Clothe,8.592123914353715e-06,1.052487735929791e-05,12,6,6
2939,Clothing,6.496483935243052e-06,1.2250267090330355e-05,10,3,7
2940,Cloud,1.6974683830796368e-05,1.9151826014460126e-05,20,9,11
2941,Clown,4.400843956132392e-06,3.6233184351681345e-06,4,2,2
2942,Clu,4.400843956132392e-06,8.79948762826546e-06,7,2,5
2943,Club,2.954852370546031e-05,4.50326719799468e-05,44,18,26
2944,Clue,1.48790438516857e-05,1.3975656821362803e-05,15,7,8
2945,Clueles,8.592123914353715e-06,7.074097897233022e-06,10,4,6
2946,Cluster,1.278340387257504e-05,5.348708166200577e-06,9,6,3
2947,Cmon,6.496483935243052e-06,8.79948762826546e-06,8,3,5
2948,Co,3.7931083621902995e-05,3.8131113055817005e-05,42,20,22
2949,CoChair,2.3052039770217305e-06,3.6233184351681345e-06,3,1,2
2950,CoFounder,2.326160376812834e-05,1.570104655239525e-05,24,13,11
2951,CoSponsor,6.496483935243052e-06,1.8979287041356905e-06,5,3,2
2952,Coach,2.116596378901769e-05,8.79948762826546e-06,16,11,5
2953,Coal,6.936568330856297e-05,0.0001019705331040174,100,39,61
2954,Coalition,3.583544364279237e-05,2.9504164400654783e-05,36,18,18
2955,Coast,7.984388320411623e-05,0.0001036959228350498,112,41,71
2956,Coastal,6.496483935243052e-06,1.052487735929791e-05,9,3,6
2957,Coastline,4.400843956132392e-06,1.8979287041356905e-06,3,2,1
2958,Coat,2.3052039770217305e-06,8.79948762826546e-06,7,2,5
2959,Coate,6.496483935243052e-06,1.8979287041356905e-06,5,3,2
2960,Coauthored,8.592123914353715e-06,8.79948762826546e-06,11,5,6
2961,Cob,2.3052039770217305e-06,3.6233184351681345e-06,3,1,2
2962,Cobb,1.0687763893464371e-05,5.348708166200577e-06,8,5,3
2963,Cobra,2.3052039770217305e-06,5.348708166200577e-06,4,1,3
2964,Coca,8.592123914353715e-06,1.2250267090330355e-05,11,4,7
2965,CocaCola,2.954852370546031e-05,3.2954943862719716e-05,33,14,19
2966,Cocaine,6.496483935243052e-06,2.6053384938589907e-05,19,3,16
2967,Cochran,2.095639979110664e-07,5.348708166200577e-06,5,2,3
2968,Cockpit,4.400843956132392e-06,3.6233184351681345e-06,4,2,2
2969,Cocktail,8.592123914353715e-06,5.348708166200577e-06,7,4,3
2970,Code,4.212236358012434e-05,2.9504164400654783e-05,41,22,19
2971,Coffee,2.7452883726349685e-05,1.3975656821362803e-05,25,16,9
2972,Coffin,6.496483935243052e-06,1.8979287041356905e-06,4,3,1
2973,Coffman,4.400843956132392e-06,1.2250267090330355e-05,9,2,7
2974,Cofounder,6.496483935243052e-06,1.8979287041356905e-06,5,3,2
2975,Cognitive,2.095639979110664e-07,5.348708166200577e-06,3,0,3
2976,Cohen,5.888748341300963e-05,9.851975364195259e-05,88,29,59
2977,Cohn,6.496483935243052e-06,1.3975656821362803e-05,12,3,9
2978,Coin,1.0687763893464371e-05,8.79948762826546e-06,10,5,5
2979,Coincidence,2.3052039770217305e-06,3.6233184351681345e-06,3,1,2
2980,Coke,1.278340387257504e-05,1.3975656821362803e-05,16,7,9
2981,Col,8.592123914353715e-06,1.2250267090330355e-05,12,4,8
2982,Cola,8.592123914353715e-06,8.79948762826546e-06,9,4,5
2983,Colbert,2.954852370546031e-05,1.3975656821362803e-05,23,14,9
2984,Cold,8.193952318322689e-05,5.3659620635109e-05,79,40,39
2985,Coldest,4.400843956132392e-06,3.6233184351681345e-06,4,2,2
2986,Cole,1.48790438516857e-05,1.052487735929791e-05,14,8,6
2987,Colgate,6.496483935243052e-06,1.7253897310324457e-07,4,3,1
2988,Coli,6.496483935243052e-06,3.6233184351681345e-06,5,3,2
2989,Colin,1.6974683830796368e-05,3.122955413168725e-05,26,8,18
2990,Collaboration,2.3052039770217305e-06,1.8979287041356905e-06,3,1,2
2991,Collaborative,4.400843956132392e-06,3.6233184351681345e-06,5,3,2
2992,Collapse,5.4696203454788295e-05,2.9504164400654783e-05,49,31,18
2993,Collapsing,6.496483935243052e-06,3.6233184351681345e-06,5,3,2
2994,Collar,6.496483935243052e-06,1.7253897310324457e-07,3,3,0
2995,Collateral,4.400843956132392e-06,8.79948762826546e-06,8,3,5
2996,Colleague,1.9070323809907035e-05,2.9504164400654783e-05,30,9,21
2997,Collect,1.0687763893464371e-05,1.052487735929791e-05,12,6,6
2998,Collecting,8.592123914353715e-06,5.348708166200577e-06,10,7,3
2999,Collection,1.6974683830796368e-05,1.742643628342769e-05,19,9,10
3000,Collective,6.496483935243052e-06,8.79948762826546e-06,9,3,6
3001,Collector,1.9070323809907035e-05,7.074097897233022e-06,14,10,4
3002,College,0.00016576512234765329,0.0002400017115866128,237,87,150
3003,Collide,2.3052039770217305e-06,8.79948762826546e-06,7,1,6
3004,Collider,1.0687763893464371e-05,7.074097897233022e-06,10,5,5
3005,Collin,3.7931083621902995e-05,3.985650278684949e-05,45,22,23
3006,Collude,2.3052039770217305e-06,1.8979287041356905e-06,3,1,2
3007,Collusion,1.6974683830796368e-05,5.348708166200577e-06,11,8,3
3008,Colo,4.400843956132392e-06,1.8979287041356905e-06,3,2,1
3009,Cologne,1.0687763893464371e-05,1.2250267090330355e-05,14,6,8
3010,Colom,2.3052039770217305e-06,1.8979287041356905e-06,4,2,2
3011,Colombia,8.822644312055891e-05,6.746273848336857e-05,91,48,43
3012,Colombian,3.7931083621902995e-05,4.1581892517881935e-05,49,22,27
3013,Colonel,1.0687763893464371e-05,5.348708166200577e-06,8,5,3
3014,Colonial,2.3052039770217305e-06,1.8979287041356905e-06,3,1,2
3015,Colonialism,6.496483935243052e-06,1.8979287041356905e-06,4,3,1
3016,Colony,6.496483935243052e-06,5.348708166200577e-06,8,4,4
3017,Color,2.326160376812834e-05,3.640572332478458e-05,37,14,23
3018,Coloradan,4.400843956132392e-06,1.8979287041356905e-06,3,2,1
3019,Colorado,8.403516316233764e-05,0.00011749904068330962,125,51,74
3020,Colorful,4.400843956132392e-06,1.8979287041356905e-06,4,2,2
3021,Colossal,2.3052039770217305e-06,7.074097897233022e-06,5,1,4
3022,Colosseum,2.3052039770217305e-06,3.6233184351681345e-06,3,1,2
3023,Columbia,2.326160376812834e-05,6.228656929027126e-05,51,13,38
3024,Columbian,2.3052039770217305e-06,1.8979287041356905e-06,3,2,1
3025,Columbine,6.496483935243052e-06,7.074097897233022e-06,7,3,4
3026,Columbu,6.496483935243052e-06,7.074097897233022e-06,8,3,5
3027,Column,8.592123914353715e-06,3.6233184351681345e-06,6,4,2
3028,Columnist,1.0687763893464371e-05,8.79948762826546e-06,11,5,6
3029,Coma,2.3052039770217305e-06,7.074097897233022e-06,6,1,5
3030,Combat,6.098312339212028e-05,3.2954943862719716e-05,49,29,20
3031,Combatant,2.3052039770217305e-06,5.348708166200577e-06,5,1,4
3032,Combating,4.400843956132392e-06,1.052487735929791e-05,10,3,7
3033,Combatting,4.400843956132392e-06,5.348708166200577e-06,5,2,3
3034,Combined,6.496483935243052e-06,5.348708166200577e-06,6,3,3
3035,Comcast,1.6974683830796368e-05,1.3975656821362803e-05,19,8,11
3036,Come,0.00015738256243121094,0.0001951415785797695,213,88,125
3037,Comeback,3.7931083621902995e-05,1.570104655239525e-05,30,21,9
3038,Comedian,6.496483935243052e-06,1.052487735929791e-05,10,4,6
3039,Comedy,4.400843956132392e-06,1.2250267090330355e-05,10,2,8
3040,Comet,4.400843956132392e-06,1.570104655239525e-05,11,2,9
3041,Comey,0.00031874684082273133,0.00017616229153841266,258,154,104
3042,Comfort,8.592123914353715e-06,1.2250267090330355e-05,15,7,8
3043,Comfortable,4.400843956132392e-06,7.074097897233022e-06,6,2,4
3044,Comic,4.400843956132392e-06,8.79948762826546e-06,7,2,5
3045,Coming,6.72700433294523e-05,0.00011922443041434203,110,35,75
3046,Command,4.400843956132392e-06,3.6233184351681345e-06,7,4,3
3047,Commander,2.326160376812834e-05,2.2602605476525032e-05,26,11,15
3048,Commandment,2.095639979110664e-07,2.087721574549256e-05,12,0,12
3049,Commando,8.592123914353715e-06,3.6233184351681345e-06,6,4,2
3050,Commemorate,6.496483935243052e-06,5.348708166200577e-06,6,3,3
3051,Commencement,4.400843956132392e-06,1.052487735929791e-05,8,2,6
3052,Comment,0.00010708720293255492,0.00011404826122124471,130,54,76
3053,Commentary,4.400843956132392e-06,1.8979287041356905e-06,3,2,1
3054,Commentator,4.400843956132392e-06,5.348708166200577e-06,5,2,3
3055,Commerce,2.7452883726349685e-05,1.2250267090330355e-05,23,15,8
3056,Commercial,1.48790438516857e-05,8.79948762826546e-06,14,7,7
3057,Commercialize,4.400843956132392e-06,1.8979287041356905e-06,3,2,1
3058,Commission,0.00010918284291166549,0.00011232287149021227,129,58,71
3059,Commissioner,3.583544364279237e-05,2.6053384938589907e-05,34,18,16
3060,Commit,3.583544364279237e-05,2.087721574549256e-05,33,18,15
3061,Commitment,1.48790438516857e-05,1.742643628342769e-05,21,10,11
3062,Committed,1.0687763893464371e-05,2.2602605476525032e-05,20,5,15
3063,Committee,0.00024539944155385846,0.0002469032705107427,286,126,160
3064,Committing,6.496483935243052e-06,1.8979287041356905e-06,4,3,1
3065,Common,7.146132328767358e-05,7.436429740749831e-05,88,37,51
3066,Commonwealth,1.278340387257504e-05,1.3975656821362803e-05,16,8,8
3067,Communicate,6.496483935243052e-06,3.6233184351681345e-06,5,3,2
3068,Communication,4.6313643538345614e-05,4.6758061710979285e-05,57,24,33
3069,Communion,6.496483935243052e-06,1.8979287041356905e-06,4,3,1
3070,Communism,4.400843956132392e-06,3.6233184351681345e-06,4,2,2
3071,Communist,6.517440335034157e-05,6.056117955923882e-05,73,34,39
3072,Community,0.00010918284291166549,0.00014510527637982858,147,60,87
3073,Commute,2.3052039770217305e-06,1.8979287041356905e-06,4,2,2
3074,Commuter,2.3052039770217305e-06,3.6233184351681345e-06,4,1,3
3075,Compact,4.400843956132392e-06,3.6233184351681345e-06,4,2,2
3076,Company,0.00033132068069739577,0.0003417997057175273,392,171,221
3077,Compare,2.7452883726349685e-05,3.468033359375216e-05,36,14,22
3078,Compared,1.9070323809907035e-05,2.4327995207557487e-05,24,9,15
3079,Comparing,8.592123914353715e-06,7.074097897233022e-06,8,4,4
3080,Comparison,1.278340387257504e-05,7.074097897233022e-06,11,6,5
3081,Compassion,1.48790438516857e-05,7.074097897233022e-06,15,8,7
3082,Compassionate,8.592123914353715e-06,8.79948762826546e-06,9,4,5
3083,Compelling,6.496483935243052e-06,1.8979287041356905e-06,4,3,1
3084,Compensation,6.496483935243052e-06,8.79948762826546e-06,8,3,5
3085,Compete,6.496483935243052e-06,1.3975656821362803e-05,11,3,8
3086,Competence,4.400843956132392e-06,1.8979287041356905e-06,4,3,1
3087,Competition,1.0687763893464371e-05,1.742643628342769e-05,16,5,11
3088,Competitive,2.3052039770217305e-06,1.3975656821362803e-05,11,3,8
3089,Competitivenes,2.3052039770217305e-06,5.348708166200577e-06,4,1,3
3090,Competitor,2.095639979110664e-07,3.6233184351681345e-06,3,0,3
3091,Complain,2.326160376812834e-05,1.742643628342769e-05,21,11,10
3092,Complaining,1.0687763893464371e-05,3.6233184351681345e-06,7,5,2
3093,Complaint,4.840928351745632e-05,4.1581892517881935e-05,50,24,26
3094,Complete,1.48790438516857e-05,1.742643628342769e-05,19,7,12
3095,Completed,2.3052039770217305e-06,3.6233184351681345e-06,3,1,2
3096,Completely,2.7452883726349685e-05,2.777877466962238e-05,29,13,16
3097,Complex,1.48790438516857e-05,1.9151826014460126e-05,22,9,13
3098,Compliance,4.400843956132392e-06,1.8979287041356905e-06,4,2,2
3099,Complicate,2.3052039770217305e-06,7.074097897233022e-06,6,2,4
3100,Complicated,1.0687763893464371e-05,1.570104655239525e-05,15,5,10
3101,Complicit,2.3052039770217305e-06,7.074097897233022e-06,7,1,6
3102,Comply,6.496483935243052e-06,5.348708166200577e-06,7,3,4
3103,Compound,2.3052039770217305e-06,7.074097897233022e-06,6,1,5
3104,Comprehensive,1.0687763893464371e-05,8.79948762826546e-06,11,5,6
3105,Compromise,2.3052039770217305e-06,5.348708166200577e-06,6,1,5
3106,Compromised,6.496483935243052e-06,3.6233184351681345e-06,6,4,2
3107,Computer,5.050492349656699e-05,5.1934230904076595e-05,59,26,33
3108,Comrade,4.400843956132392e-06,1.8979287041356905e-06,3,2,1
3109,Con,2.954852370546031e-05,8.79948762826546e-06,22,15,7
3110,Concealed,1.0687763893464371e-05,1.2250267090330355e-05,12,5,7
3111,Concede,1.6974683830796368e-05,1.9151826014460126e-05,22,10,12
3112,Conceived,2.095639979110664e-07,5.348708166200577e-06,3,0,3
3113,Concentration,1.0687763893464371e-05,1.7253897310324457e-07,5,5,0
3114,Concept,2.3052039770217305e-06,8.79948762826546e-06,6,1,5
3115,Conception,2.3052039770217305e-06,1.8979287041356905e-06,3,1,2
3116,Concern,5.6791843433898893e-05,5.3659620635109e-05,65,30,35
3117,Concerned,2.7452883726349685e-05,3.468033359375216e-05,35,15,20
3118,Concert,8.592123914353715e-06,1.2250267090330355e-05,12,4,8
3119,Concession,8.592123914353715e-06,5.348708166200577e-06,7,4,3
3120,Conclude,6.496483935243052e-06,7.074097897233022e-06,10,5,5
3121,Concordia,4.400843956132392e-06,1.8979287041356905e-06,4,2,2
3122,Concrete,4.400843956132392e-06,7.074097897233022e-06,6,2,4
3123,Condemn,5.6791843433898893e-05,4.50326719799468e-05,56,27,29
3124,Condemnation,4.400843956132392e-06,7.074097897233022e-06,7,2,5
3125,Condemned,6.496483935243052e-06,5.348708166200577e-06,6,3,3
3126,Condemning,8.592123914353715e-06,5.348708166200577e-06,8,4,4
3127,Condition,1.9070323809907035e-05,3.2954943862719716e-05,32,9,23
3128,Condo,8.592123914353715e-06,7.074097897233022e-06,10,6,4
3129,Condoleezza,8.592123914353715e-06,5.348708166200577e-06,7,4,3
3130,Condom,6.496483935243052e-06,5.348708166200577e-06,8,4,4
3131,Conduct,1.9070323809907035e-05,1.052487735929791e-05,18,10,8
3132,Conducted,2.3052039770217305e-06,3.6233184351681345e-06,4,1,3
3133,Conducting,2.3052039770217305e-06,3.6233184351681345e-06,3,1,2
3134,Coney,8.592123914353715e-06,3.6233184351681345e-06,6,4,2
3135,Confederacy,4.400843956132392e-06,1.8979287041356905e-06,3,2,1
3136,Confederate,7.146132328767358e-05,7.954046660059569e-05,94,39,55
3137,Confederation,8.592123914353715e-06,1.7253897310324457e-07,6,4,2
3138,Conference,7.355696326678427e-05,5.5385010366141504e-05,77,38,39
3139,Confession,6.496483935243052e-06,7.074097897233022e-06,7,3,4
3140,Confessional,4.400843956132392e-06,3.6233184351681345e-06,4,2,2
3141,Confidant,2.3052039770217305e-06,5.348708166200577e-06,4,1,3
3142,Confidence,2.116596378901769e-05,2.087721574549256e-05,23,10,13
3143,Confident,1.0687763893464371e-05,1.3975656821362803e-05,14,5,9
3144,Confidential,8.592123914353715e-06,7.074097897233022e-06,9,4,5
3145,Confinement,8.592123914353715e-06,1.3975656821362803e-05,13,4,9
3146,Confirm,9.451336305789087e-05,7.781507686956326e-05,106,53,53
3147,Confirmation,2.326160376812834e-05,2.6053384938589907e-05,32,14,18
3148,Confirmed,2.326160376812834e-05,2.9504164400654783e-05,32,12,20
3149,Confirming,2.3052039770217305e-06,7.074097897233022e-06,7,3,4
3150,Confiscate,2.095639979110664e-07,8.79948762826546e-06,5,0,5
3151,Confiscated,2.3052039770217305e-06,3.6233184351681345e-06,3,1,2
3152,Conflict,6.307876337123095e-05,7.608968713853079e-05,81,33,48
3153,ConflictOfInterest,2.3052039770217305e-06,3.6233184351681345e-06,3,1,2
3154,Confront,3.583544364279237e-05,3.6233184351681345e-06,23,20,3
3155,Confrontation,4.400843956132392e-06,8.79948762826546e-06,7,2,5
3156,Confronted,2.3052039770217305e-06,3.6233184351681345e-06,4,1,3
3157,Confuse,4.400843956132392e-06,3.6233184351681345e-06,4,2,2
3158,Confused,1.0687763893464371e-05,1.8979287041356905e-06,8,5,3
3159,Confusing,1.0687763893464371e-05,7.074097897233022e-06,9,5,4
3160,Confusion,6.496483935243052e-06,7.074097897233022e-06,8,4,4
3161,Congo,0.00013013924270277222,6.573734875233614e-05,117,73,44
3162,Congolese,1.278340387257504e-05,1.2250267090330355e-05,14,6,8
3163,Congrat,4.400843956132392e-06,3.6233184351681345e-06,4,2,2
3164,Congratulate,1.48790438516857e-05,8.79948762826546e-06,12,7,5
3165,Congratulation,1.278340387257504e-05,1.570104655239525e-05,16,6,10
3166,Congregation,2.095639979110664e-07,1.8979287041356905e-06,3,1,2
3167,Congres,0.0007818832762061878,0.0007593440206273787,914,419,495
3168,Congress,6.496483935243052e-06,1.742643628342769e-05,15,5,10
3169,Congressional,0.0001783389622223174,0.00014510527637982858,183,90,93
3170,Congressman,0.00019091280209698145,0.00020549391696596386,231,102,129
3171,Congresswoman,4.4218003559234974e-05,3.468033359375216e-05,46,24,22
3172,Connect,1.48790438516857e-05,1.570104655239525e-05,16,7,9
3173,Connected,1.0687763893464371e-05,1.8979287041356905e-06,6,5,1
3174,Connecticut,3.3739803663681634e-05,4.330728224891437e-05,44,17,27
3175,Connecting,4.400843956132392e-06,3.6233184351681345e-06,5,2,3
3176,Connection,2.326160376812834e-05,2.087721574549256e-05,25,13,12
3177,ConocoPhillip,2.3052039770217305e-06,1.8979287041356905e-06,4,1,3
3178,Conor,1.0687763893464371e-05,3.6233184351681345e-06,7,5,2
3179,Conquer,2.3052039770217305e-06,3.6233184351681345e-06,3,1,2
3180,Conquered,4.400843956132392e-06,1.8979287041356905e-06,3,2,1
3181,Conrad,8.592123914353715e-06,1.8979287041356905e-06,5,4,1
3182,Conroy,2.3052039770217305e-06,3.6233184351681345e-06,5,2,3
3183,Conscience,6.496483935243052e-06,5.348708166200577e-06,8,3,5
3184,Consciou,6.496483935243052e-06,1.7253897310324457e-07,3,3,0
3185,Conscription,8.592123914353715e-06,1.8979287041356905e-06,5,4,1
3186,Consecutive,4.400843956132392e-06,3.6233184351681345e-06,4,2,2
3187,Consensu,6.496483935243052e-06,1.8979287041356905e-06,4,3,1
3188,Consent,6.496483935243052e-06,1.8979287041356905e-06,5,3,2
3189,Consequence,1.48790438516857e-05,2.9504164400654783e-05,26,7,19
3190,Consequential,4.400843956132392e-06,1.8979287041356905e-06,3,2,1
3191,Conservation,1.278340387257504e-05,2.2602605476525032e-05,19,6,13
3192,Conservationist,1.0687763893464371e-05,8.79948762826546e-06,11,5,6
3193,Conservatism,4.400843956132392e-06,1.8979287041356905e-06,3,2,1
3194,Conservative,0.0002726427612822975,0.00024172710131764556,308,143,165
3195,Consider,9.451336305789087e-05,8.989280498679035e-05,104,47,57
3196,Consideration,2.3052039770217305e-06,8.79948762826546e-06,7,1,6
3197,Considered,6.496483935243052e-06,1.8979287041356905e-06,7,5,2
3198,Considering,4.4218003559234974e-05,4.8483451442011706e-05,53,22,31
3199,Consistent,6.496483935243052e-06,1.7253897310324457e-07,3,3,0
3200,Consolidation,2.3052039770217305e-06,5.348708166200577e-06,4,1,3
3201,Consortium,2.095639979110664e-07,3.6233184351681345e-06,3,1,2
3202,Conspiracy,4.002672360101368e-05,6.573734875233614e-05,61,21,40
3203,Constant,2.095639979110664e-07,5.348708166200577e-06,4,0,4
3204,Constantine,2.3052039770217305e-06,3.6233184351681345e-06,3,1,2
3205,Constituent,1.6974683830796368e-05,1.9151826014460126e-05,19,8,11
3206,Constitute,2.3052039770217305e-06,3.6233184351681345e-06,4,2,2
3207,Constitution,9.660900303700153e-05,9.851975364195259e-05,112,51,61
3208,Constitutional,4.4218003559234974e-05,3.985650278684949e-05,46,22,24
3209,Construction,3.7931083621902995e-05,1.570104655239525e-05,32,20,12
3210,Consulate,1.0687763893464371e-05,1.052487735929791e-05,13,6,7
3211,Consultant,6.496483935243052e-06,8.79948762826546e-06,10,4,6
3212,Consultation,4.400843956132392e-06,1.8979287041356905e-06,3,2,1
3213,Consulting,2.3052039770217305e-06,7.074097897233022e-06,7,3,4
3214,Consume,1.48790438516857e-05,1.8979287041356905e-06,8,7,1
3215,Consumer,0.00012175668278632962,0.00014510527637982858,154,61,93
3216,Consuming,4.400843956132392e-06,5.348708166200577e-06,5,2,3
3217,Consumption,2.3052039770217305e-06,3.6233184351681345e-06,4,1,3
3218,Contact,1.9070323809907035e-05,1.570104655239525e-05,21,9,12
3219,Contagion,6.496483935243052e-06,3.6233184351681345e-06,5,3,2
3220,Contagiou,4.400843956132392e-06,3.6233184351681345e-06,4,2,2
3221,Contain,6.496483935243052e-06,7.074097897233022e-06,7,3,4
3222,Contained,4.400843956132392e-06,1.8979287041356905e-06,4,2,2
3223,Container,8.592123914353715e-06,1.2250267090330355e-05,12,5,7
3224,Contaminated,4.400843956132392e-06,1.8979287041356905e-06,3,2,1
3225,Contamination,6.496483935243052e-06,1.052487735929791e-05,10,4,6
3226,Contempt,1.9070323809907035e-05,5.348708166200577e-06,13,9,4
3227,Contender,1.0687763893464371e-05,1.3975656821362803e-05,14,6,8
3228,Content,2.326160376812834e-05,3.985650278684949e-05,38,11,27
3229,Contest,4.400843956132392e-06,2.087721574549256e-05,18,3,15
3230,Contestant,4.400843956132392e-06,1.8979287041356905e-06,4,3,1
3231,Contested,8.592123914353715e-06,1.052487735929791e-05,11,5,6
3232,Context,2.3052039770217305e-06,5.348708166200577e-06,5,2,3
3233,Continent,1.0687763893464371e-05,5.348708166200577e-06,10,6,4
3234,Continental,2.3052039770217305e-06,5.348708166200577e-06,5,2,3
3235,Continue,0.00010708720293255492,0.00011577365095227703,129,58,71
3236,Continued,8.592123914353715e-06,1.8979287041356905e-06,5,4,1
3237,Continuing,6.496483935243052e-06,7.074097897233022e-06,9,3,6
3238,Contraception,1.0687763893464371e-05,1.2250267090330355e-05,12,5,7
3239,Contraceptive,6.496483935243052e-06,1.7253897310324457e-07,4,4,0
3240,Contract,2.5357243747239038e-05,2.087721574549256e-05,31,17,14
3241,Contractor,1.9070323809907035e-05,2.9504164400654783e-05,26,9,17
3242,Contradict,6.496483935243052e-06,1.3975656821362803e-05,12,3,9
3243,Contradicting,4.400843956132392e-06,3.6233184351681345e-06,4,2,2
3244,Contrary,1.278340387257504e-05,1.2250267090330355e-05,15,7,8
3245,Contribute,6.496483935243052e-06,7.074097897233022e-06,7,3,4
3246,Contributed,4.400843956132392e-06,1.8979287041356905e-06,3,2,1
3247,Contribution,1.48790438516857e-05,1.9151826014460126e-05,24,11,13
3248,Contributor,1.278340387257504e-05,7.074097897233022e-06,10,6,4
3249,Control,0.00018043460220142793,0.00019341618884873702,220,96,124
3250,Controlled,4.400843956132392e-06,1.8979287041356905e-06,3,2,1
3251,Controller,2.095639979110664e-07,3.6233184351681345e-06,3,0,3
3252,Controversial,7.355696326678427e-05,6.401195902130366e-05,84,42,42
3253,Controversy,2.7452883726349685e-05,3.640572332478458e-05,38,14,24
3254,Conundrum,6.496483935243052e-06,3.6233184351681345e-06,5,3,2
3255,Convene,2.3052039770217305e-06,7.074097897233022e-06,5,1,4
3256,Convenience,4.400843956132392e-06,1.8979287041356905e-06,3,2,1
3257,Convention,0.00014900000251476814,0.00016235917369015308,174,74,100
3258,Conventional,6.496483935243052e-06,3.6233184351681345e-06,5,3,2
3259,Conversation,3.1644163684570994e-05,4.50326719799468e-05,46,19,27
3260,Conversion,8.592123914353715e-06,7.074097897233022e-06,10,5,5
3261,Convert,6.496483935243052e-06,5.348708166200577e-06,7,3,4
3262,Converting,2.3052039770217305e-06,5.348708166200577e-06,4,1,3
3263,Convict,2.3052039770217305e-06,7.074097897233022e-06,5,1,4
3264,Convicted,3.1644163684570994e-05,5.020884117304414e-05,48,15,33
3265,Conviction,2.7452883726349685e-05,3.468033359375216e-05,35,13,22
3266,Convince,1.48790438516857e-05,8.79948762826546e-06,13,8,5
3267,Convinced,6.496483935243052e-06,1.052487735929791e-05,11,4,7
3268,Conway,7.146132328767358e-05,7.263890767646595e-05,83,35,48
3269,Conyer,1.278340387257504e-05,2.777877466962238e-05,22,6,16
3270,Cook,3.7931083621902995e-05,3.8131113055817005e-05,42,20,22
3271,Cookie,1.0687763893464371e-05,8.79948762826546e-06,12,5,7
3272,Cooking,4.400843956132392e-06,3.6233184351681345e-06,4,2,2
3273,Cool,2.116596378901769e-05,3.122955413168725e-05,28,10,18
3274,Cooler,2.3052039770217305e-06,5.348708166200577e-06,4,1,3
3275,Coolest,4.400843956132392e-06,5.348708166200577e-06,6,2,4
3276,Cooling,6.496483935243052e-06,1.7253897310324457e-07,3,3,0
3277,Coon,2.3052039770217305e-06,3.6233184351681345e-06,3,1,2
3278,Cooper,1.0687763893464371e-05,2.2602605476525032e-05,21,7,14
3279,Cooperate,4.400843956132392e-06,1.052487735929791e-05,8,2,6
3280,Cooperating,2.3052039770217305e-06,3.6233184351681345e-06,4,1,3
3281,Cooperation,1.48790438516857e-05,7.074097897233022e-06,11,7,4
3282,Cooperative,2.3052039770217305e-06,3.6233184351681345e-06,4,1,3
3283,Coordinated,4.400843956132392e-06,1.8979287041356905e-06,3,2,1
3284,Coordinating,2.3052039770217305e-06,1.8979287041356905e-06,3,1,2
3285,Coordination,2.095639979110664e-07,1.8979287041356905e-06,3,0,3
3286,Cop,0.00016786076232676425,0.0001951415785797695,216,92,124
3287,Cope,4.400843956132392e-06,7.074097897233022e-06,7,2,5
3288,Copenhagen,2.7452883726349685e-05,3.2954943862719716e-05,35,13,22
3289,Copied,6.496483935243052e-06,1.8979287041356905e-06,4,3,1
3290,Copper,6.496483935243052e-06,3.6233184351681345e-06,6,3,3
3291,Copt,2.3052039770217305e-06,3.6233184351681345e-06,3,1,2
3292,Coptic,1.6974683830796368e-05,2.2602605476525032e-05,22,9,13
3293,Copy,1.278340387257504e-05,7.074097897233022e-06,10,6,4
3294,Copycat,4.400843956132392e-06,1.8979287041356905e-06,3,2,1
3295,Copyright,3.7931083621902995e-05,2.9504164400654783e-05,35,18,17
3296,Coral,4.400843956132392e-06,1.2250267090330355e-05,10,3,7
3297,Corbett,2.3052039770217305e-06,1.8979287041356905e-06,3,1,2
3298,Corbyn,1.6974683830796368e-05,1.3975656821362803e-05,18,8,10
3299,Core,2.116596378901769e-05,2.777877466962238e-05,26,10,16
3300,Coretta,2.095639979110664e-07,1.2250267090330355e-05,7,0,7
3301,Corey,1.48790438516857e-05,4.330728224891437e-05,41,13,28
3302,Corfman,2.095639979110664e-07,7.074097897233022e-06,4,0,4
3303,Corgi,2.3052039770217305e-06,5.348708166200577e-06,4,1,3
3304,Cori,2.3052039770217305e-06,5.348708166200577e-06,5,2,3
3305,Corinthian,2.3052039770217305e-06,1.052487735929791e-05,7,1,6
3306,Corker,2.326160376812834e-05,2.6053384938589907e-05,28,13,15
3307,Corn,8.592123914353715e-06,7.074097897233022e-06,8,4,4
3308,Corner,2.116596378901769e-05,3.6233184351681345e-06,12,10,2
3309,Cornyn,1.278340387257504e-05,5.348708166200577e-06,11,8,3
3310,Corona,4.400843956132392e-06,1.8979287041356905e-06,3,2,1
3311,Coronaviru,7.355696326678427e-05,6.918812821440096e-05,84,38,46
3312,Coroner,4.400843956132392e-06,1.7253897310324457e-07,3,2,1
3313,Corp,7.984388320411623e-05,5.3659620635109e-05,77,41,36
3314,Corporate,8.403516316233764e-05,8.989280498679035e-05,105,48,57
3315,Corporation,6.936568330856297e-05,6.918812821440096e-05,75,34,41
3316,Corps,1.6974683830796368e-05,2.777877466962238e-05,28,9,19
3317,Corpse,4.400843956132392e-06,3.6233184351681345e-06,5,2,3
3318,Correa,6.496483935243052e-06,3.6233184351681345e-06,7,5,2
3319,Correct,6.496483935243052e-06,1.052487735929791e-05,10,3,7
3320,Correction,1.0687763893464371e-05,1.2250267090330355e-05,12,5,7
3321,Corrective,2.095639979110664e-07,3.6233184351681345e-06,3,0,3
3322,Correspondent,1.48790438516857e-05,1.3975656821362803e-05,17,7,10
3323,Corrie,6.496483935243052e-06,1.742643628342769e-05,14,3,11
3324,Corrupt,1.9070323809907035e-05,1.9151826014460126e-05,20,9,11
3325,Corruption,5.6791843433898893e-05,4.50326719799468e-05,65,29,36
3326,Cortez,2.3052039770217305e-06,3.6233184351681345e-06,3,1,2
3327,Cory,2.7452883726349685e-05,3.985650278684949e-05,39,15,24
3328,Cosby,6.496483935243052e-06,8.79948762826546e-06,9,4,5
3329,Cosmic,2.3052039770217305e-06,8.79948762826546e-06,6,1,5
3330,Cost,0.00017205204228498542,0.00015028144557292604,189,90,99
3331,Costa,3.3739803663681634e-05,4.50326719799468e-05,44,16,28
3332,Costco,1.278340387257504e-05,1.570104655239525e-05,15,6,9
3333,Costello,6.496483935243052e-06,1.8979287041356905e-06,4,3,1
3334,Costing,1.0687763893464371e-05,1.2250267090330355e-05,12,5,7
3335,Costly,6.496483935243052e-06,8.79948762826546e-06,11,5,6
3336,Costume,1.0687763893464371e-05,1.2250267090330355e-05,13,5,8
3337,Cote,2.095639979110664e-07,3.6233184351681345e-06,3,0,3
3338,Cotton,2.116596378901769e-05,2.6053384938589907e-05,27,10,17
3339,Couch,2.3052039770217305e-06,3.6233184351681345e-06,4,2,2
3340,Could,0.0006875794771462083,0.0006609968059585296,809,368,441
3341,Couldve,2.3052039770217305e-06,5.348708166200577e-06,4,1,3
3342,Coulson,8.592123914353715e-06,5.348708166200577e-06,7,4,3
3343,Coulter,2.3052039770217305e-06,2.2602605476525032e-05,15,2,13
3344,Council,0.00014900000251476814,0.00017961307100047735,198,78,120
3345,Counsel,3.7931083621902995e-05,4.330728224891437e-05,47,20,27
3346,Counseling,4.400843956132392e-06,3.6233184351681345e-06,5,2,3
3347,Counselor,8.592123914353715e-06,3.6233184351681345e-06,7,5,2
3348,Count,3.583544364279237e-05,3.2954943862719716e-05,41,19,22
3349,Countdown,2.095639979110664e-07,1.8979287041356905e-06,3,1,2
3350,Counter,8.592123914353715e-06,7.074097897233022e-06,8,4,4
3351,CounterTerrorism,2.3052039770217305e-06,1.8979287041356905e-06,3,2,1
3352,Counterfeit,2.3052039770217305e-06,8.79948762826546e-06,7,2,5
3353,Countering,2.3052039770217305e-06,3.6233184351681345e-06,3,1,2
3354,Counterpart,6.496483935243052e-06,1.8979287041356905e-06,4,3,1
3355,Counterproductive,2.3052039770217305e-06,3.6233184351681345e-06,3,1,2
3356,Counting,2.3052039770217305e-06,1.570104655239525e-05,11,1,10
3357,Countles,2.3052039770217305e-06,7.074097897233022e-06,5,1,4
3358,Country,0.0002621645613867441,0.00026760794728313193,309,141,168
3359,County,0.0001154697628489974,0.0001295767688005365,145,60,85
3360,Coup,2.7452883726349685e-05,2.777877466962238e-05,31,14,17
3361,Couple,5.6791843433898893e-05,6.746273848336857e-05,80,34,46
3362,Coupon,1.0687763893464371e-05,7.074097897233022e-06,11,6,5
3363,Courage,1.9070323809907035e-05,7.074097897233022e-06,13,9,4
3364,Courageou,2.3052039770217305e-06,3.6233184351681345e-06,3,1,2
3365,Course,4.6313643538345614e-05,3.2954943862719716e-05,45,23,22
3366,Courser,4.400843956132392e-06,1.8979287041356905e-06,3,2,1
3367,Court,0.0013016019910256319,0.001182064504730328,1465,684,781
3368,Courtesy,2.095639979110664e-07,3.6233184351681345e-06,6,0,6
3369,Courthouse,4.400843956132392e-06,3.6233184351681345e-06,4,2,2
3370,Courtney,2.3052039770217305e-06,5.348708166200577e-06,4,1,3
3371,Courtroom,6.496483935243052e-06,1.7253897310324457e-07,3,3,0
3372,Cousin,2.095639979110664e-07,8.79948762826546e-06,7,0,7
3373,Cove,4.400843956132392e-06,7.074097897233022e-06,8,3,5
3374,Cover,4.6313643538345614e-05,5.020884117304414e-05,55,23,32
3375,CoverUp,1.48790438516857e-05,1.2250267090330355e-05,14,7,7
3376,Coverage,4.002672360101368e-05,4.8483451442011706e-05,53,21,32
3377,Covered,1.48790438516857e-05,1.3975656821362803e-05,18,7,11
3378,Covering,6.496483935243052e-06,2.087721574549256e-05,17,5,12
3379,Covert,6.496483935243052e-06,1.8979287041356905e-06,4,3,1
3380,Coverup,2.3052039770217305e-06,3.6233184351681345e-06,3,1,2
3381,Cow,1.0687763893464371e-05,8.79948762826546e-06,11,5,6
3382,Coward,2.3052039770217305e-06,5.348708166200577e-06,7,3,4
3383,Cowboy,1.0687763893464371e-05,1.8979287041356905e-06,6,5,1
3384,Cowen,4.400843956132392e-06,1.7253897310324457e-07,3,2,1
3385,Coworker,2.3052039770217305e-06,1.8979287041356905e-06,3,1,2
3386,Cox,1.278340387257504e-05,1.052487735929791e-05,14,7,7
3387,Cozy,6.496483935243052e-06,5.348708166200577e-06,6,3,3
3388,Crab,4.400843956132392e-06,1.8979287041356905e-06,3,2,1
3389,Crack,4.002672360101368e-05,5.1934230904076595e-05,60,20,40
3390,Crackdown,6.307876337123095e-05,5.711040009717395e-05,69,33,36
3391,Cracked,6.496483935243052e-06,1.8979287041356905e-06,6,4,2
3392,Cracker,2.095639979110664e-07,5.348708166200577e-06,3,0,3
3393,Cracking,8.592123914353715e-06,1.8979287041356905e-06,5,4,1
3394,Cradle,2.3052039770217305e-06,3.6233184351681345e-06,3,1,2
3395,Craft,2.3052039770217305e-06,1.2250267090330355e-05,8,1,7
3396,Crafting,4.400843956132392e-06,1.8979287041356905e-06,3,2,1
3397,Craig,1.6974683830796368e-05,3.6233184351681345e-06,13,10,3
3398,Craigslist,4.400843956132392e-06,1.2250267090330355e-05,10,3,7
3399,Cramer,2.3052039770217305e-06,7.074097897233022e-06,6,2,4
3400,Crane,2.095639979110664e-07,5.348708166200577e-06,3,0,3
3401,Crank,4.400843956132392e-06,1.8979287041356905e-06,3,2,1
3402,Cranky,2.3052039770217305e-06,3.6233184351681345e-06,3,1,2
3403,Crap,8.592123914353715e-06,7.074097897233022e-06,8,4,4
3404,Crappy,2.3052039770217305e-06,1.8979287041356905e-06,3,1,2
3405,Crash,6.098312339212028e-05,7.781507686956326e-05,87,38,49
3406,Crashed,6.496483935243052e-06,8.79948762826546e-06,9,3,6
3407,Crashing,2.3052039770217305e-06,3.6233184351681345e-06,4,1,3
3408,Crater,2.3052039770217305e-06,5.348708166200577e-06,6,2,4
3409,Craze,6.496483935243052e-06,1.8979287041356905e-06,4,3,1
3410,Craziest,2.3052039770217305e-06,3.6233184351681345e-06,3,1,2
3411,Crazy,3.1644163684570994e-05,3.985650278684949e-05,40,15,25
3412,Cream,4.400843956132392e-06,5.348708166200577e-06,6,2,4
3413,Create,7.984388320411623e-05,8.644202552472544e-05,98,44,54
3414,Created,1.9070323809907035e-05,2.087721574549256e-05,23,10,13
3415,Creating,3.3739803663681634e-05,3.640572332478458e-05,42,18,24
3416,Creative,1.0687763893464371e-05,2.6053384938589907e-05,20,5,15
3417,Creativity,6.496483935243052e-06,5.348708166200577e-06,7,4,3
3418,Creator,1.0687763893464371e-05,2.087721574549256e-05,19,6,13
3419,Creature,1.278340387257504e-05,3.6233184351681345e-06,9,6,3
3420,Credential,4.400843956132392e-06,1.8979287041356905e-06,3,2,1
3421,Credibility,1.0687763893464371e-05,1.052487735929791e-05,12,6,6
3422,Credible,6.496483935243052e-06,7.074097897233022e-06,8,3,5
3423,Credit,0.00018043460220142793,0.00017616229153841266,210,96,114
3424,Creditor,2.3052039770217305e-06,3.6233184351681345e-06,4,1,3
3425,Creek,8.592123914353715e-06,8.79948762826546e-06,9,4,5
3426,Creepy,6.496483935243052e-06,3.6233184351681345e-06,5,3,2
3427,Crescent,6.496483935243052e-06,1.8979287041356905e-06,4,3,1
3428,Crew,2.326160376812834e-05,1.742643628342769e-05,22,12,10
3429,Cricket,1.0687763893464371e-05,1.052487735929791e-05,11,5,6
3430,Crime,0.00016157384238943198,0.00017271151207634748,198,87,111
3431,Crimea,0.00010499156295344414,0.00010887209202814718,120,53,67
3432,Crimean,2.326160376812834e-05,2.087721574549256e-05,24,11,13
3433,Criminal,0.00012804360272366158,0.0001278513790695043,153,72,81
3434,Criminalization,4.400843956132392e-06,3.6233184351681345e-06,4,2,2
3435,Criminalize,8.592123914353715e-06,7.074097897233022e-06,9,4,5
3436,Criminalizing,4.400843956132392e-06,7.074097897233022e-06,7,2,5
3437,Criminally,4.400843956132392e-06,5.348708166200577e-06,6,2,4
3438,Cripple,2.3052039770217305e-06,5.348708166200577e-06,4,1,3
3439,Crippled,4.400843956132392e-06,1.7253897310324457e-07,3,3,0
3440,Crippling,2.3052039770217305e-06,5.348708166200577e-06,4,1,3
3441,Crise,8.592123914353715e-06,8.79948762826546e-06,9,4,5
3442,Crisi,0.0002747384012614078,0.00026415716782106726,313,143,170
3443,Crist,2.095639979110664e-07,8.79948762826546e-06,6,1,5
3444,Cristina,1.6974683830796368e-05,1.2250267090330355e-05,15,8,7
3445,Critic,7.984388320411623e-05,0.00011059748175917965,115,41,74
3446,Critical,2.116596378901769e-05,3.640572332478458e-05,36,11,25
3447,Critically,2.095639979110664e-07,7.074097897233022e-06,6,0,6
3448,Criticism,4.4218003559234974e-05,3.468033359375216e-05,49,25,24
3449,Criticize,3.3739803663681634e-05,3.122955413168725e-05,41,18,23
3450,Criticized,1.278340387257504e-05,1.570104655239525e-05,15,6,9
3451,Criticizing,1.6974683830796368e-05,1.9151826014460126e-05,19,8,11
3452,Critique,4.400843956132392e-06,1.052487735929791e-05,9,2,7
3453,Croat,2.3052039770217305e-06,1.8979287041356905e-06,3,2,1
3454,Croatia,2.116596378901769e-05,1.570104655239525e-05,21,10,11
3455,Croatian,6.496483935243052e-06,1.8979287041356905e-06,5,3,2
3456,Crocodile,1.278340387257504e-05,5.348708166200577e-06,10,6,4
3457,Crook,6.496483935243052e-06,5.348708166200577e-06,6,3,3
3458,Crooked,8.592123914353715e-06,7.074097897233022e-06,9,5,4
3459,Crop,2.116596378901769e-05,8.79948762826546e-06,16,10,6
3460,Cros,6.307876337123095e-05,5.3659620635109e-05,64,31,33
3461,Cross,4.400843956132392e-06,1.8979287041356905e-06,4,2,2
3462,CrossBorder,2.3052039770217305e-06,1.8979287041356905e-06,3,1,2
3463,Crossed,2.095639979110664e-07,5.348708166200577e-06,3,0,3
3464,Crosshair,4.400843956132392e-06,5.348708166200577e-06,5,2,3
3465,Crossing,6.496483935243052e-06,1.2250267090330355e-05,13,4,9
3466,Crossposted,4.002672360101368e-05,3.8131113055817005e-05,46,20,26
3467,Crossroad,2.3052039770217305e-06,7.074097897233022e-06,6,1,5
3468,Crow,4.400843956132392e-06,1.2250267090330355e-05,11,3,8
3469,Crowd,5.050492349656699e-05,4.330728224891437e-05,53,26,27
3470,Crowded,4.400843956132392e-06,8.79948762826546e-06,8,2,6
3471,Crowdfunding,8.592123914353715e-06,1.570104655239525e-05,15,4,11
3472,Crowdsourcing,2.3052039770217305e-06,3.6233184351681345e-06,3,1,2
3473,Crown,1.48790438516857e-05,1.052487735929791e-05,13,7,6
3474,Crucial,2.5357243747239038e-05,1.742643628342769e-05,25,13,12
3475,Crude,8.592123914353715e-06,1.3975656821362803e-05,16,6,10
3476,Cruel,1.0687763893464371e-05,1.3975656821362803e-05,16,5,11
3477,Cruelty,4.400843956132392e-06,5.348708166200577e-06,5,2,3
3478,Cruise,2.326160376812834e-05,2.087721574549256e-05,28,13,15
3479,Crumble,2.095639979110664e-07,5.348708166200577e-06,5,1,4
3480,Crumbling,4.400843956132392e-06,3.6233184351681345e-06,4,2,2
3481,Crunch,2.3052039770217305e-06,3.6233184351681345e-06,3,1,2
3482,Crusade,8.592123914353715e-06,1.052487735929791e-05,10,4,6
3483,Crusader,4.400843956132392e-06,8.79948762826546e-06,8,2,6
3484,Crush,1.278340387257504e-05,1.570104655239525e-05,16,7,9
3485,Crushed,6.496483935243052e-06,1.052487735929791e-05,9,3,6
3486,Crushing,2.3052039770217305e-06,8.79948762826546e-06,7,2,5
3487,Cruz,0.0004528677994858143,0.00032972197760030013,469,255,214
3488,Cry,1.9070323809907035e-05,2.2602605476525032e-05,23,10,13
3489,Crying,1.0687763893464371e-05,3.6233184351681345e-06,8,6,2
3490,Cryptic,4.400843956132392e-06,1.7253897310324457e-07,3,2,1
3491,Crystal,8.592123914353715e-06,3.6233184351681345e-06,6,4,2
3492,Csuite,6.496483935243052e-06,3.6233184351681345e-06,5,3,2
3493,Cub,1.48790438516857e-05,5.348708166200577e-06,12,7,5
3494,Cuba,0.00016576512234765329,0.00017616229153841266,214,89,125
3495,Cuban,6.517440335034157e-05,6.746273848336857e-05,81,32,49
3496,Cue,4.400843956132392e-06,7.074097897233022e-06,6,2,4
3497,Cuellar,6.496483935243052e-06,3.6233184351681345e-06,5,3,2
3498,Cull,4.400843956132392e-06,1.8979287041356905e-06,3,2,1
3499,Cullen,2.3052039770217305e-06,5.348708166200577e-06,4,1,3
3500,Culprit,4.400843956132392e-06,1.7253897310324457e-07,3,3,0
3501,Cult,1.0687763893464371e-05,5.348708166200577e-06,8,5,3
3502,Cultivating,6.496483935243052e-06,1.8979287041356905e-06,4,3,1
3503,Cultural,1.9070323809907035e-05,1.570104655239525e-05,19,9,10
3504,Culture,5.888748341300963e-05,6.401195902130366e-05,72,31,41
3505,Cumbria,2.3052039770217305e-06,3.6233184351681345e-06,3,1,2
3506,Cumming,1.278340387257504e-05,1.2250267090330355e-05,14,7,7
3507,Cunha,4.400843956132392e-06,1.8979287041356905e-06,3,2,1
3508,Cuomo,7.355696326678427e-05,7.091351794543343e-05,82,38,44
3509,Cup,0.00011127848289077625,0.00014683066611086105,157,60,97
3510,Cupcake,4.400843956132392e-06,1.8979287041356905e-06,3,2,1
3511,Cupp,2.095639979110664e-07,5.348708166200577e-06,3,0,3
3512,Curb,2.954852370546031e-05,2.777877466962238e-05,33,14,19
3513,Curbing,2.095639979110664e-07,7.074097897233022e-06,4,0,4
3514,Cure,2.326160376812834e-05,1.9151826014460126e-05,23,12,11
3515,Cured,2.3052039770217305e-06,7.074097897233022e-06,5,1,4
3516,Curiel,4.400843956132392e-06,1.8979287041356905e-06,3,2,1
3517,Curiosity,1.278340387257504e-05,1.3975656821362803e-05,18,10,8
3518,Curiou,6.496483935243052e-06,8.79948762826546e-06,8,3,5
3519,Currency,2.116596378901769e-05,2.087721574549256e-05,27,12,15
3520,Current,4.4218003559234974e-05,2.777877466962238e-05,41,23,18
3521,Currently,1.0687763893464371e-05,1.2250267090330355e-05,12,5,7
3522,Curriculum,2.3052039770217305e-06,5.348708166200577e-06,4,1,3
3523,Curry,1.0687763893464371e-05,3.6233184351681345e-06,8,5,3
3524,Curse,4.400843956132392e-06,7.074097897233022e-06,7,2,5
3525,Cursing,6.496483935243052e-06,5.348708166200577e-06,7,3,4
3526,Curt,6.496483935243052e-06,1.8979287041356905e-06,4,3,1
3527,Curtain,6.496483935243052e-06,7.074097897233022e-06,7,3,4
3528,Curti,4.400843956132392e-06,3.6233184351681345e-06,5,3,2
3529,Custody,6.496483935243052e-06,1.742643628342769e-05,15,4,11
3530,Custom,2.7452883726349685e-05,3.122955413168725e-05,32,13,19
3531,Customer,8.822644312055891e-05,8.644202552472544e-05,98,48,50
3532,Cut,0.0002537820014703013,0.0002469032705107427,292,131,161
3533,Cutback,2.3052039770217305e-06,1.8979287041356905e-06,3,1,2
3534,Cute,1.48790438516857e-05,8.79948762826546e-06,13,8,5
3535,Cutenes,4.400843956132392e-06,3.6233184351681345e-06,4,2,2
3536,Cutest,4.400843956132392e-06,1.8979287041356905e-06,4,2,2
3537,Cutting,2.5357243747239038e-05,2.2602605476525032e-05,26,12,14
3538,Cyber,5.6791843433898893e-05,4.50326719799468e-05,59,29,30
3539,CyberAttack,4.400843956132392e-06,1.8979287041356905e-06,3,2,1
3540,Cyberattack,8.592123914353715e-06,1.742643628342769e-05,16,4,12
3541,Cyberbullying,4.400843956132392e-06,3.6233184351681345e-06,4,2,2
3542,Cybercrime,2.3052039770217305e-06,7.074097897233022e-06,7,1,6
3543,Cybersecurity,8.592123914353715e-06,1.570104655239525e-05,18,8,10
3544,Cycle,1.0687763893464371e-05,1.3975656821362803e-05,14,5,9
3545,Cyclist,8.592123914353715e-06,3.6233184351681345e-06,7,5,2
3546,Cyclone,2.095639979110664e-07,8.79948762826546e-06,6,0,6
3547,Cynical,1.48790438516857e-05,1.8979287041356905e-06,8,7,1
3548,Cynicism,2.3052039770217305e-06,1.8979287041356905e-06,3,2,1
3549,Cynthia,1.0687763893464371e-05,1.3975656821362803e-05,14,6,8
3550,Cypriot,6.496483935243052e-06,7.074097897233022e-06,7,3,4
3551,Cypru,5.050492349656699e-05,2.2602605476525032e-05,40,25,15
3552,Cyru,2.3052039770217305e-06,5.348708166200577e-06,5,1,4
3553,Cystic,2.095639979110664e-07,5.348708166200577e-06,3,0,3
3554,Czar,1.6974683830796368e-05,1.742643628342769e-05,19,8,11
3555,Czech,6.72700433294523e-05,4.50326719799468e-05,67,35,32
3556,DA,2.5357243747239038e-05,2.2602605476525032e-05,28,12,16
3557,DACA,9.03220830996695e-05,0.00010024514337298497,103,43,60
3558,DAPL,2.095639979110664e-07,3.6233184351681345e-06,4,0,4
3559,DC,0.00015738256243121094,0.0001554576147660233,186,84,102
3560,DCCC,1.0687763893464371e-05,8.79948762826546e-06,10,5,5
3561,DCalif,1.278340387257504e-05,8.79948762826546e-06,11,6,5
3562,DConn,6.496483935243052e-06,1.7253897310324457e-07,3,3,0
3563,DDO,8.592123914353715e-06,7.074097897233022e-06,8,4,4
3564,DDay,4.400843956132392e-06,8.79948762826546e-06,7,2,5
3565,DDo,8.592123914353715e-06,1.052487735929791e-05,11,4,7
3566,DE,6.496483935243052e-06,1.8979287041356905e-06,5,4,1
3567,DEA,2.116596378901769e-05,2.6053384938589907e-05,32,13,19
3568,DEAD,2.3052039770217305e-06,3.6233184351681345e-06,3,1,2
3569,DFla,6.496483935243052e-06,1.7253897310324457e-07,3,3,0
3570,DH,4.4218003559234974e-05,3.2954943862719716e-05,42,21,21
3571,DIY,8.592123914353715e-06,5.348708166200577e-06,7,4,3
3572,DIll,6.496483935243052e-06,3.6233184351681345e-06,5,3,2
3573,DMCA,8.592123914353715e-06,8.79948762826546e-06,9,4,5
3574,DMV,2.3052039770217305e-06,3.6233184351681345e-06,3,1,2
3575,DMZ,6.496483935243052e-06,3.6233184351681345e-06,6,3,3
3576,DMas,6.496483935243052e-06,5.348708166200577e-06,6,3,3
3577,DMd,2.3052039770217305e-06,8.79948762826546e-06,6,1,5
3578,DMinn,2.3052039770217305e-06,3.6233184351681345e-06,4,1,3
3579,DMoney,4.400843956132392e-06,1.7253897310324457e-07,3,3,0
3580,DN,8.592123914353715e-06,3.6233184351681345e-06,6,4,2
3581,DNA,8.403516316233764e-05,9.851975364195259e-05,108,42,66
3582,DNC,0.00010289592297433347,0.00010887209202814718,128,56,72
3583,DNY,6.496483935243052e-06,5.348708166200577e-06,6,3,3
3584,DOD,2.095639979110664e-07,3.6233184351681345e-06,5,1,4
3585,DOJ,0.0001154697628489974,0.00011749904068330962,148,65,83
3586,DOL,4.400843956132392e-06,5.348708166200577e-06,7,4,3
3587,DPRK,6.496483935243052e-06,1.2250267090330355e-05,11,4,7
3588,DR,1.0687763893464371e-05,1.3975656821362803e-05,14,6,8
3589,DRC,1.0687763893464371e-05,1.8979287041356905e-06,7,5,2
3590,DREAMer,2.095639979110664e-07,3.6233184351681345e-06,4,1,3
3591,DRM,6.496483935243052e-06,1.8979287041356905e-06,4,3,1
3592,DUI,4.400843956132392e-06,1.8979287041356905e-06,3,2,1
3593,DVD,1.278340387257504e-05,3.6233184351681345e-06,10,7,3
3594,Da,1.9070323809907035e-05,7.074097897233022e-06,15,10,5
3595,Dab,4.400843956132392e-06,1.7253897310324457e-07,3,3,0
3596,Dad,5.4696203454788295e-05,7.608968713853079e-05,77,28,49
3597,Daddy,2.095639979110664e-07,8.79948762826546e-06,5,0,5
3598,Daesh,2.3052039770217305e-06,1.9151826014460126e-05,13,1,12
3599,Dagestan,8.592123914353715e-06,3.6233184351681345e-06,6,4,2
3600,Dagger,4.400843956132392e-06,3.6233184351681345e-06,4,2,2
3601,Daiichi,2.326160376812834e-05,8.79948762826546e-06,21,13,8
3602,Daily,7.355696326678427e-05,0.00011749904068330962,111,39,72
3603,Daine,4.400843956132392e-06,5.348708166200577e-06,5,2,3
3604,Dairy,4.400843956132392e-06,7.074097897233022e-06,8,2,6
3605,Dakota,8.822644312055891e-05,4.6758061710979285e-05,85,45,40
3606,Dalai,7.355696326678427e-05,4.6758061710979285e-05,64,37,27
3607,Dale,4.400843956132392e-06,7.074097897233022e-06,6,2,4
3608,Dalla,2.5357243747239038e-05,4.8483451442011706e-05,40,12,28
3609,Dam,1.278340387257504e-05,1.3975656821362803e-05,17,7,10
3610,Damage,1.9070323809907035e-05,4.50326719799468e-05,37,11,26
3611,Damaged,1.0687763893464371e-05,5.348708166200577e-06,8,5,3
3612,Damaging,8.592123914353715e-06,3.6233184351681345e-06,7,4,3
3613,Damascu,5.4696203454788295e-05,7.263890767646595e-05,73,26,47
3614,Damn,6.496483935243052e-06,1.570104655239525e-05,14,3,11
3615,Damned,6.496483935243052e-06,3.6233184351681345e-06,5,3,2
3616,Damning,2.116596378901769e-05,2.6053384938589907e-05,26,10,16
3617,Damon,4.400843956132392e-06,1.8979287041356905e-06,4,3,1
3618,Damond,6.496483935243052e-06,1.8979287041356905e-06,4,3,1
3619,Damore,2.3052039770217305e-06,5.348708166200577e-06,5,2,3
3620,Dan,5.050492349656699e-05,4.8483451442011706e-05,57,28,29
3621,Dana,1.278340387257504e-05,1.3975656821362803e-05,16,6,10
3622,Dance,3.7931083621902995e-05,2.2602605476525032e-05,34,19,15
3623,Danced,2.3052039770217305e-06,3.6233184351681345e-06,6,2,4
3624,Dancer,2.3052039770217305e-06,5.348708166200577e-06,4,1,3
3625,Dancing,2.116596378901769e-05,1.3975656821362803e-05,21,10,11
3626,Dane,4.400843956132392e-06,1.052487735929791e-05,9,2,7
3627,Danger,2.954852370546031e-05,3.2954943862719716e-05,35,15,20
3628,Dangerou,5.888748341300963e-05,8.126585633162811e-05,86,31,55
3629,Daniel,8.822644312055891e-05,7.608968713853079e-05,89,43,46
3630,Danish,7.565260324589493e-05,7.954046660059569e-05,96,38,58
3631,Dannel,2.095639979110664e-07,8.79948762826546e-06,5,0,5
3632,Danny,1.278340387257504e-05,1.742643628342769e-05,16,6,10
3633,Danube,1.0687763893464371e-05,1.8979287041356905e-06,7,5,2
3634,Daraa,8.592123914353715e-06,3.6233184351681345e-06,6,4,2
3635,Daraprim,4.400843956132392e-06,3.6233184351681345e-06,5,3,2
3636,Dare,6.496483935243052e-06,7.074097897233022e-06,8,3,5
3637,Darfur,3.1644163684570994e-05,3.468033359375216e-05,41,18,23
3638,Daring,2.3052039770217305e-06,5.348708166200577e-06,5,2,3
3639,Dark,6.098312339212028e-05,6.918812821440096e-05,79,35,44
3640,Darkest,2.095639979110664e-07,3.6233184351681345e-06,3,0,3
3641,Darknes,4.400843956132392e-06,7.074097897233022e-06,7,3,4
3642,Darling,2.095639979110664e-07,5.348708166200577e-06,4,0,4
3643,Darrell,2.3052039770217305e-06,8.79948762826546e-06,6,1,5
3644,Darren,8.592123914353715e-06,1.052487735929791e-05,10,4,6
3645,Darryl,2.095639979110664e-07,1.8979287041356905e-06,4,2,2
3646,Darth,4.400843956132392e-06,5.348708166200577e-06,5,2,3
3647,Darwin,1.0687763893464371e-05,7.074097897233022e-06,11,6,5
3648,Dash,2.3052039770217305e-06,5.348708166200577e-06,4,1,3
3649,Dashcam,2.3052039770217305e-06,1.8979287041356905e-06,4,3,1
3650,Database,1.278340387257504e-05,3.6233184351681345e-06,10,7,3
3651,Date,1.0687763893464371e-05,2.777877466962238e-05,26,8,18
3652,Dating,6.496483935243052e-06,8.79948762826546e-06,9,3,6
3653,Datum,0.00014480872255654665,0.00016063378395912072,188,81,107
3654,Daughter,5.4696203454788295e-05,6.746273848336857e-05,74,31,43
3655,Daunte,6.496483935243052e-06,1.7253897310324457e-07,4,3,1
3656,Dave,6.496483935243052e-06,1.742643628342769e-05,15,3,12
3657,Davi,5.4696203454788295e-05,6.228656929027126e-05,75,32,43
3658,David,0.00029988608101073563,0.0003228204186761705,365,155,210
3659,Davidson,1.278340387257504e-05,7.074097897233022e-06,10,6,4
3660,Davo,1.9070323809907035e-05,2.9504164400654783e-05,27,9,18
3661,Dawkin,4.400843956132392e-06,1.570104655239525e-05,11,2,9
3662,Dawn,4.002672360101368e-05,2.4327995207557487e-05,33,19,14
3663,Dawson,2.095639979110664e-07,5.348708166200577e-06,3,0,3
3664,Day,0.0006540492374804378,0.0007472662925101516,842,354,488
3665,Daylight,4.400843956132392e-06,3.6233184351681345e-06,4,2,2
3666,Dayton,1.0687763893464371e-05,1.052487735929791e-05,11,5,6
3667,De,3.1644163684570994e-05,3.2954943862719716e-05,38,17,21
3668,DeGrasse,4.400843956132392e-06,5.348708166200577e-06,7,4,3
3669,DeLauro,4.400843956132392e-06,1.8979287041356905e-06,3,2,1
3670,DeRay,6.496483935243052e-06,3.6233184351681345e-06,5,3,2
3671,DeSanti,2.7452883726349685e-05,7.074097897233022e-06,17,13,4
3672,DeVo,4.4218003559234974e-05,6.401195902130366e-05,70,27,43
3673,DeVos,2.3052039770217305e-06,3.6233184351681345e-06,3,1,2
3674,Dead,0.00020348664197164515,0.0002192970348142235,243,105,138
3675,Deadliest,8.592123914353715e-06,1.052487735929791e-05,11,4,7
3676,Deadline,3.1644163684570994e-05,3.468033359375216e-05,38,17,21
3677,Deadlocked,4.400843956132392e-06,1.7253897310324457e-07,3,2,1
3678,Deadly,7.774824322500554e-05,0.0001036959228350498,111,45,66
3679,Deaf,8.592123914353715e-06,3.6233184351681345e-06,7,5,2
3680,Deal,0.0003271294007391747,0.00041081529495882486,431,174,257
3681,Dealer,2.3052039770217305e-06,1.052487735929791e-05,8,2,6
3682,Dealing,8.592123914353715e-06,1.2250267090330355e-05,15,6,9
3683,Dealt,8.592123914353715e-06,3.6233184351681345e-06,6,4,2
3684,Dean,3.3739803663681634e-05,1.570104655239525e-05,29,17,12
3685,Dear,6.098312339212028e-05,6.228656929027126e-05,75,34,41
3686,Death,0.0003732334802796091,0.0004539500382346362,494,205,289
3687,Deb,4.400843956132392e-06,1.3975656821362803e-05,10,2,8
3688,Debacle,1.0687763893464371e-05,1.2250267090330355e-05,12,5,7
3689,Debate,0.0003795204002169411,0.00035042665437268953,422,204,218
3690,Debating,8.592123914353715e-06,5.348708166200577e-06,7,4,3
3691,Debbie,1.9070323809907035e-05,2.2602605476525032e-05,26,11,15
3692,Debilitating,2.3052039770217305e-06,1.8979287041356905e-06,3,1,2
3693,Debit,1.278340387257504e-05,3.6233184351681345e-06,8,6,2
3694,Deborah,6.496483935243052e-06,7.074097897233022e-06,8,4,4
3695,Debris,4.400843956132392e-06,1.9151826014460126e-05,13,2,11
3696,Debt,0.00011756540282810809,0.0001485560558418934,163,69,94
3697,Debtor,2.3052039770217305e-06,7.074097897233022e-06,6,2,4
3698,Debunk,6.496483935243052e-06,1.7253897310324457e-07,3,3,0
3699,Debunked,4.400843956132392e-06,3.6233184351681345e-06,4,2,2
3700,Debunking,2.3052039770217305e-06,1.8979287041356905e-06,3,1,2
3701,Debut,1.48790438516857e-05,1.052487735929791e-05,14,7,7
3702,Dec,2.7452883726349685e-05,2.777877466962238e-05,31,14,17
3703,Decade,6.72700433294523e-05,6.746273848336857e-05,78,35,43
3704,DecadesOld,2.3052039770217305e-06,3.6233184351681345e-06,3,1,2
3705,December,8.822644312055891e-05,0.00010714670229711469,116,51,65
3706,Decency,2.3052039770217305e-06,5.348708166200577e-06,4,1,3
3707,Decent,2.3052039770217305e-06,3.6233184351681345e-06,3,1,2
3708,Deception,2.3052039770217305e-06,7.074097897233022e-06,6,2,4
3709,Deceptive,4.400843956132392e-06,7.074097897233022e-06,6,2,4
3710,Decide,7.146132328767358e-05,5.3659620635109e-05,68,36,32
3711,Decided,1.6974683830796368e-05,1.2250267090330355e-05,19,12,7
3712,Deciding,2.3052039770217305e-06,3.6233184351681345e-06,3,1,2
3713,Decision,8.193952318322689e-05,9.506897417988779e-05,107,46,61
3714,DecisionMaking,4.400843956132392e-06,1.8979287041356905e-06,3,2,1
3715,Decisive,6.496483935243052e-06,3.6233184351681345e-06,5,3,2
3716,Declaration,1.9070323809907035e-05,1.742643628342769e-05,25,12,13
3717,Declare,6.936568330856297e-05,8.644202552472544e-05,88,37,51
3718,Declared,1.6974683830796368e-05,1.570104655239525e-05,20,8,12
3719,Declaring,6.496483935243052e-06,1.3975656821362803e-05,11,3,8
3720,Declassified,8.592123914353715e-06,7.074097897233022e-06,8,4,4
3721,Decline,3.3739803663681634e-05,2.9504164400654783e-05,36,17,19
3722,Declining,6.496483935243052e-06,8.79948762826546e-06,9,4,5
3723,Decoding,2.3052039770217305e-06,1.8979287041356905e-06,3,2,1
3724,Decriminalization,4.400843956132392e-06,1.052487735929791e-05,8,2,6
3725,Decriminalize,1.278340387257504e-05,7.074097897233022e-06,11,6,5
3726,Decriminalizing,6.496483935243052e-06,3.6233184351681345e-06,5,3,2
3727,Decry,1.0687763893464371e-05,8.79948762826546e-06,10,5,5
3728,Dedicate,8.592123914353715e-06,1.8979287041356905e-06,5,4,1
3729,Dedicated,4.400843956132392e-06,1.8979287041356905e-06,3,2,1
3730,Deductible,2.3052039770217305e-06,7.074097897233022e-06,6,1,5
3731,Deduction,6.496483935243052e-06,7.074097897233022e-06,8,3,5
3732,Deemed,4.400843956132392e-06,1.8979287041356905e-06,3,2,1
3733,Deep,4.002672360101368e-05,3.640572332478458e-05,44,21,23
3734,DeepMind,2.3052039770217305e-06,1.8979287041356905e-06,3,1,2
3735,DeepRed,2.3052039770217305e-06,3.6233184351681345e-06,3,1,2
3736,Deepak,2.3052039770217305e-06,1.8979287041356905e-06,3,1,2
3737,Deepen,1.278340387257504e-05,8.79948762826546e-06,12,6,6
3738,Deeper,1.0687763893464371e-05,1.3975656821362803e-05,13,5,8
3739,Deepest,2.3052039770217305e-06,1.8979287041356905e-06,3,2,1
3740,Deeply,1.278340387257504e-05,1.3975656821362803e-05,14,6,8
3741,Deepwater,1.6974683830796368e-05,8.79948762826546e-06,17,11,6
3742,Deer,2.3052039770217305e-06,3.6233184351681345e-06,4,2,2
3743,Defamation,1.0687763893464371e-05,1.9151826014460126e-05,16,5,11
3744,Default,1.48790438516857e-05,1.570104655239525e-05,21,10,11
3745,Defeat,3.583544364279237e-05,8.989280498679035e-05,73,18,55
3746,Defeated,6.496483935243052e-06,2.087721574549256e-05,16,4,12
3747,Defeating,4.400843956132392e-06,5.348708166200577e-06,6,3,3
3748,Defect,1.278340387257504e-05,1.2250267090330355e-05,13,6,7
3749,Defected,4.400843956132392e-06,1.8979287041356905e-06,3,2,1
3750,Defective,2.3052039770217305e-06,3.6233184351681345e-06,3,1,2
3751,Defector,1.48790438516857e-05,1.052487735929791e-05,14,8,6
3752,Defence,4.002672360101368e-05,3.2954943862719716e-05,43,21,22
3753,Defend,0.00013642616264010403,0.00014165449691776373,168,73,95
3754,Defendant,4.400843956132392e-06,5.348708166200577e-06,6,2,4
3755,Defended,6.496483935243052e-06,1.8979287041356905e-06,4,3,1
3756,Defender,1.6974683830796368e-05,2.2602605476525032e-05,23,8,15
3757,Defending,1.48790438516857e-05,3.122955413168725e-05,27,8,19
3758,Defense,0.0001741476822640959,0.0001589083942280881,195,91,104
3759,Defenseles,2.095639979110664e-07,5.348708166200577e-06,3,0,3
3760,Defensive,2.095639979110664e-07,8.79948762826546e-06,5,0,5
3761,Deferred,8.592123914353715e-06,1.3975656821362803e-05,14,5,9
3762,Defiance,4.400843956132392e-06,5.348708166200577e-06,5,2,3
3763,Defiant,6.496483935243052e-06,1.742643628342769e-05,14,3,11
3764,Deficit,2.5357243747239038e-05,2.087721574549256e-05,27,15,12
3765,Defied,4.400843956132392e-06,1.7253897310324457e-07,3,2,1
3766,Define,1.48790438516857e-05,7.074097897233022e-06,13,9,4
3767,Defining,6.496483935243052e-06,5.348708166200577e-06,6,3,3
3768,Definitely,8.592123914353715e-06,1.3975656821362803e-05,14,4,10
3769,Definition,8.592123914353715e-06,1.052487735929791e-05,11,4,7
3770,Definitive,2.3052039770217305e-06,1.8979287041356905e-06,3,2,1
3771,Deforestation,6.496483935243052e-06,1.052487735929791e-05,9,3,6
3772,Defrauded,6.496483935243052e-06,7.074097897233022e-06,7,3,4
3773,Defrauding,2.3052039770217305e-06,3.6233184351681345e-06,4,1,3
3774,Defund,2.116596378901769e-05,2.087721574549256e-05,25,12,13
3775,Defunding,1.278340387257504e-05,1.052487735929791e-05,13,7,6
3776,Defy,1.9070323809907035e-05,1.742643628342769e-05,21,10,11
3777,Defying,4.400843956132392e-06,1.052487735929791e-05,12,2,10
3778,Degree,1.278340387257504e-05,1.2250267090330355e-05,16,8,8
3779,Deir,6.496483935243052e-06,1.7253897310324457e-07,4,3,1
3780,Dekker,4.400843956132392e-06,1.8979287041356905e-06,3,2,1
3781,Delaney,4.400843956132392e-06,3.6233184351681345e-06,5,3,2
3782,Delaware,1.9070323809907035e-05,1.3975656821362803e-05,18,10,8
3783,Delay,3.583544364279237e-05,4.330728224891437e-05,47,21,26
3784,Delayed,1.278340387257504e-05,8.79948762826546e-06,13,7,6
3785,Delaying,4.400843956132392e-06,5.348708166200577e-06,6,2,4
3786,Delegate,3.7931083621902995e-05,4.6758061710979285e-05,53,20,33
3787,Delegation,2.095639979110664e-07,7.074097897233022e-06,4,0,4
3788,Delete,1.6974683830796368e-05,1.052487735929791e-05,15,8,7
3789,Deleted,2.095639979110664e-07,1.052487735929791e-05,10,1,9
3790,Deleting,2.3052039770217305e-06,5.348708166200577e-06,5,1,4
3791,Delhi,6.72700433294523e-05,5.883578982820635e-05,77,36,41
3792,Deliberately,4.400843956132392e-06,3.6233184351681345e-06,4,2,2
3793,Deliberation,6.496483935243052e-06,5.348708166200577e-06,6,3,3
3794,Deliver,4.002672360101368e-05,3.8131113055817005e-05,46,20,26
3795,Delivered,1.0687763893464371e-05,1.052487735929791e-05,12,6,6
3796,Delivering,6.496483935243052e-06,1.3975656821362803e-05,11,3,8
3797,Delivery,2.116596378901769e-05,1.3975656821362803e-05,20,10,10
3798,Dell,1.0687763893464371e-05,7.074097897233022e-06,9,5,4
3799,Delta,4.4218003559234974e-05,3.2954943862719716e-05,42,21,21
3800,Delusion,2.095639979110664e-07,7.074097897233022e-06,4,0,4
3801,Delusional,4.400843956132392e-06,5.348708166200577e-06,5,2,3
3802,Dem,7.774824322500554e-05,0.00015373222503499084,143,43,100
3803,Demagogue,1.0687763893464371e-05,8.79948762826546e-06,10,5,5
3804,Demand,0.00013642616264010403,0.00011749904068330962,144,68,76
3805,Demanded,8.592123914353715e-06,3.6233184351681345e-06,7,5,2
3806,Demanding,1.9070323809907035e-05,8.79948762826546e-06,16,10,6
3807,Demeaning,2.3052039770217305e-06,3.6233184351681345e-06,3,1,2
3808,Dementia,4.400843956132392e-06,1.8979287041356905e-06,3,2,1
3809,Demi,2.095639979110664e-07,1.8979287041356905e-06,3,1,2
3810,Demise,8.592123914353715e-06,1.8979287041356905e-06,7,5,2
3811,Democracy,9.24177230787802e-05,0.00011922443041434203,127,50,77
3812,Democrat,0.00107108159332346,0.0011993184020406525,1372,577,795
3813,Democratic,0.0007232053567910894,0.0007489916822411843,874,386,488
3814,Democrats,1.0687763893464371e-05,8.79948762826546e-06,12,5,7
3815,Demographic,6.496483935243052e-06,1.8979287041356905e-06,5,4,1
3816,Demolish,8.592123914353715e-06,3.6233184351681345e-06,7,5,2
3817,Demolition,2.3052039770217305e-06,5.348708166200577e-06,5,2,3
3818,Demon,4.400843956132392e-06,5.348708166200577e-06,6,2,4
3819,Demonize,2.3052039770217305e-06,3.6233184351681345e-06,3,1,2
3820,Demonstrate,4.400843956132392e-06,1.8979287041356905e-06,3,2,1
3821,Demonstration,2.3052039770217305e-06,5.348708166200577e-06,6,1,5
3822,Demonstrator,6.496483935243052e-06,1.3975656821362803e-05,11,3,8
3823,Den,2.3052039770217305e-06,1.052487735929791e-05,7,1,6
3824,Denham,2.095639979110664e-07,3.6233184351681345e-06,3,0,3
3825,Deni,4.400843956132392e-06,3.6233184351681345e-06,4,2,2
3826,Denial,2.116596378901769e-05,3.122955413168725e-05,32,12,20
3827,Denied,2.5357243747239038e-05,1.9151826014460126e-05,25,13,12
3828,Denier,2.954852370546031e-05,2.6053384938589907e-05,32,16,16
3829,Denise,6.496483935243052e-06,3.6233184351681345e-06,5,3,2
3830,Denmark,9.451336305789087e-05,0.00011059748175917965,121,48,73
3831,Denni,2.954852370546031e-05,2.4327995207557487e-05,31,15,16
3832,Denounce,2.116596378901769e-05,2.4327995207557487e-05,26,12,14
3833,Denounced,4.400843956132392e-06,1.7253897310324457e-07,3,2,1
3834,Denouncing,4.400843956132392e-06,8.79948762826546e-06,8,3,5
3835,Dentist,2.3052039770217305e-06,5.348708166200577e-06,7,3,4
3836,Denver,1.278340387257504e-05,1.9151826014460126e-05,20,9,11
3837,Deny,7.984388320411623e-05,7.781507686956326e-05,91,41,50
3838,Denying,2.116596378901769e-05,2.2602605476525032e-05,25,11,14
3839,Depart,6.496483935243052e-06,3.6233184351681345e-06,5,3,2
3840,Department,0.0004235288397782649,0.00042634380253811694,511,224,287
3841,Departure,1.278340387257504e-05,7.074097897233022e-06,11,7,4
3842,Depend,8.592123914353715e-06,2.087721574549256e-05,16,4,12
3843,Depending,6.496483935243052e-06,3.6233184351681345e-06,6,3,3
3844,Depicting,6.496483935243052e-06,1.8979287041356905e-06,4,3,1
3845,Depleted,2.3052039770217305e-06,5.348708166200577e-06,4,1,3
3846,Deploy,1.0687763893464371e-05,1.3975656821362803e-05,15,7,8
3847,Deployed,6.496483935243052e-06,1.8979287041356905e-06,4,3,1
3848,Deploying,2.095639979110664e-07,7.074097897233022e-06,4,0,4
3849,Deployment,8.592123914353715e-06,5.348708166200577e-06,7,4,3
3850,Deport,1.6974683830796368e-05,1.3975656821362803e-05,19,10,9
3851,Deportation,5.6791843433898893e-05,8.126585633162811e-05,85,31,54
3852,Deported,8.592123914353715e-06,1.3975656821362803e-05,15,5,10
3853,Deporting,2.095639979110664e-07,5.348708166200577e-06,3,0,3
3854,Deposit,1.0687763893464371e-05,1.052487735929791e-05,12,5,7
3855,Deposition,2.3052039770217305e-06,1.8979287041356905e-06,3,2,1
3856,Depot,2.3052039770217305e-06,7.074097897233022e-06,6,1,5
3857,Depressed,4.400843956132392e-06,3.6233184351681345e-06,4,2,2
3858,Depressing,8.592123914353715e-06,3.6233184351681345e-06,6,4,2
3859,Depressingly,4.400843956132392e-06,3.6233184351681345e-06,4,2,2
3860,Depression,1.278340387257504e-05,2.777877466962238e-05,25,6,19
3861,Deprivation,2.095639979110664e-07,5.348708166200577e-06,3,0,3
3862,Dept,2.116596378901769e-05,2.087721574549256e-05,24,11,13
3863,Depth,4.400843956132392e-06,5.348708166200577e-06,5,2,3
3864,Deputy,7.565260324589493e-05,6.918812821440096e-05,84,40,44
3865,Der,6.496483935243052e-06,3.6233184351681345e-06,5,3,2
3866,Deraa,2.3052039770217305e-06,1.8979287041356905e-06,4,1,3
3867,Derail,1.278340387257504e-05,1.742643628342769e-05,17,6,11
3868,Derailment,6.496483935243052e-06,1.7253897310324457e-07,3,3,0
3869,Derby,2.3052039770217305e-06,1.8979287041356905e-06,3,1,2
3870,Deregulate,4.400843956132392e-06,8.79948762826546e-06,7,2,5
3871,Deregulation,4.400843956132392e-06,1.8979287041356905e-06,3,2,1
3872,Derek,2.3052039770217305e-06,1.3975656821362803e-05,12,1,11
3873,Derry,2.3052039770217305e-06,3.6233184351681345e-06,4,1,3
3874,Desalination,4.400843956132392e-06,1.8979287041356905e-06,3,2,1
3875,Descend,6.496483935243052e-06,7.074097897233022e-06,9,4,5
3876,Descendant,2.095639979110664e-07,7.074097897233022e-06,4,0,4
3877,Descent,4.400843956132392e-06,5.348708166200577e-06,5,2,3
3878,Describe,2.116596378901769e-05,1.9151826014460126e-05,24,11,13
3879,Desegregation,2.095639979110664e-07,5.348708166200577e-06,3,0,3
3880,Desert,1.9070323809907035e-05,1.570104655239525e-05,21,10,11
3881,Deserve,4.840928351745632e-05,3.2954943862719716e-05,46,26,20
3882,Deserved,4.400843956132392e-06,3.6233184351681345e-06,4,2,2
3883,Design,1.0687763893464371e-05,2.087721574549256e-05,18,5,13
3884,Designated,4.400843956132392e-06,1.8979287041356905e-06,3,2,1
3885,Designed,6.496483935243052e-06,1.052487735929791e-05,10,3,7
3886,Designer,4.400843956132392e-06,7.074097897233022e-06,6,2,4
3887,Designing,8.592123914353715e-06,3.6233184351681345e-06,6,4,2
3888,Desire,2.095639979110664e-07,1.8979287041356905e-06,3,2,1
3889,Desiree,2.3052039770217305e-06,3.6233184351681345e-06,3,1,2
3890,Desk,1.0687763893464371e-05,1.052487735929791e-05,13,6,7
3891,Desmond,1.278340387257504e-05,1.570104655239525e-05,16,6,10
3892,Despair,1.0687763893464371e-05,8.79948762826546e-06,10,5,5
3893,Desperate,2.5357243747239038e-05,2.2602605476525032e-05,29,15,14
3894,Desperately,2.3052039770217305e-06,5.348708166200577e-06,5,2,3
3895,Desperation,2.3052039770217305e-06,3.6233184351681345e-06,3,1,2
3896,Despicable,4.400843956132392e-06,8.79948762826546e-06,8,2,6
3897,Despite,0.00019300844207609195,0.0002469032705107427,258,102,156
3898,Destination,2.3052039770217305e-06,3.6233184351681345e-06,4,2,2
3899,Destroy,6.936568330856297e-05,6.746273848336857e-05,77,37,40
3900,Destroyed,2.326160376812834e-05,1.742643628342769e-05,24,12,12
3901,Destroying,1.6974683830796368e-05,2.2602605476525032e-05,21,8,13
3902,Destruction,1.9070323809907035e-05,2.6053384938589907e-05,24,9,15
3903,Destructive,6.496483935243052e-06,1.2250267090330355e-05,11,4,7
3904,Detail,6.517440335034157e-05,6.056117955923882e-05,69,33,36
3905,Detailed,6.496483935243052e-06,7.074097897233022e-06,8,3,5
3906,Detain,4.400843956132392e-06,1.052487735929791e-05,8,2,6
3907,Detained,2.116596378901769e-05,1.570104655239525e-05,23,12,11
3908,Detainee,3.3739803663681634e-05,2.087721574549256e-05,32,18,14
3909,Detaining,4.400843956132392e-06,1.8979287041356905e-06,4,2,2
3910,Detect,6.496483935243052e-06,7.074097897233022e-06,9,5,4
3911,Detected,2.3052039770217305e-06,1.052487735929791e-05,8,1,7
3912,Detective,1.0687763893464371e-05,1.8979287041356905e-06,8,6,2
3913,Detention,5.260056347567764e-05,3.122955413168725e-05,45,27,18
3914,Deter,2.3052039770217305e-06,3.6233184351681345e-06,3,1,2
3915,Determine,6.496483935243052e-06,7.074097897233022e-06,7,3,4
3916,Determined,1.48790438516857e-05,3.6233184351681345e-06,10,8,2
3917,Detonate,4.400843956132392e-06,1.8979287041356905e-06,3,2,1
3918,Detroit,3.583544364279237e-05,3.985650278684949e-05,42,17,25
3919,Deutsche,2.7452883726349685e-05,2.087721574549256e-05,26,13,13
3920,Devastate,1.0687763893464371e-05,3.6233184351681345e-06,8,5,3
3921,Devastated,4.400843956132392e-06,1.2250267090330355e-05,9,2,7
3922,Devastating,1.6974683830796368e-05,2.4327995207557487e-05,25,9,16
3923,Devastation,8.592123914353715e-06,1.3975656821362803e-05,13,5,8
3924,Develop,8.592123914353715e-06,5.348708166200577e-06,8,5,3
3925,Developed,6.496483935243052e-06,5.348708166200577e-06,8,4,4
3926,Developer,6.496483935243052e-06,7.074097897233022e-06,8,4,4
3927,Developing,2.326160376812834e-05,1.742643628342769e-05,27,14,13
3928,Development,4.840928351745632e-05,4.330728224891437e-05,52,24,28
3929,Developmental,2.095639979110664e-07,5.348708166200577e-06,4,1,3
3930,Device,1.9070323809907035e-05,2.4327995207557487e-05,27,12,15
3931,Devil,1.48790438516857e-05,1.742643628342769e-05,17,7,10
3932,Devin,2.7452883726349685e-05,2.6053384938589907e-05,28,13,15
3933,Dhabi,8.592123914353715e-06,8.79948762826546e-06,9,4,5
3934,Dhaka,4.400843956132392e-06,3.6233184351681345e-06,6,3,3
3935,DiCaprio,4.400843956132392e-06,1.2250267090330355e-05,11,2,9
3936,Diabetes,2.095639979110664e-07,1.2250267090330355e-05,7,0,7
3937,Diabetic,6.496483935243052e-06,1.7253897310324457e-07,3,3,0
3938,Diagnosed,6.496483935243052e-06,3.6233184351681345e-06,7,4,3
3939,Diagnosi,1.0687763893464371e-05,5.348708166200577e-06,9,6,3
3940,Dialogue,4.400843956132392e-06,8.79948762826546e-06,8,2,6
3941,Diamond,1.6974683830796368e-05,2.6053384938589907e-05,25,9,16
3942,Diana,2.095639979110664e-07,1.3975656821362803e-05,8,0,8
3943,Diane,6.496483935243052e-06,7.074097897233022e-06,7,3,4
3944,Dianne,1.48790438516857e-05,1.3975656821362803e-05,19,8,11
3945,Diaper,2.095639979110664e-07,5.348708166200577e-06,3,0,3
3946,Diary,4.400843956132392e-06,5.348708166200577e-06,6,2,4
3947,Diaspora,2.3052039770217305e-06,3.6233184351681345e-06,4,1,3
3948,Diaz,4.400843956132392e-06,5.348708166200577e-06,5,2,3
3949,Dick,3.7931083621902995e-05,4.1581892517881935e-05,48,20,28
3950,Dictator,2.116596378901769e-05,1.570104655239525e-05,21,11,10
3951,Dictatorship,4.400843956132392e-06,8.79948762826546e-06,8,3,5
3952,Dictionary,2.095639979110664e-07,1.052487735929791e-05,6,0,6
3953,Didn,2.5357243747239038e-05,2.9504164400654783e-05,33,14,19
3954,Die,5.050492349656699e-05,9.161819471782287e-05,86,27,59
3955,Diebold,4.400843956132392e-06,1.8979287041356905e-06,3,2,1
3956,Died,4.212236358012434e-05,4.1581892517881935e-05,50,22,28
3957,Diego,1.48790438516857e-05,1.9151826014460126e-05,21,9,12
3958,Diesel,8.592123914353715e-06,8.79948762826546e-06,11,5,6
3959,Dieselgate,4.400843956132392e-06,3.6233184351681345e-06,4,2,2
3960,Diet,1.278340387257504e-05,5.348708166200577e-06,9,6,3
3961,Differ,4.400843956132392e-06,1.7253897310324457e-07,3,2,1
3962,Difference,2.5357243747239038e-05,2.777877466962238e-05,32,13,19
3963,Different,2.7452883726349685e-05,4.1581892517881935e-05,44,16,28
3964,Differently,6.496483935243052e-06,5.348708166200577e-06,6,3,3
3965,Difficult,6.496483935243052e-06,1.742643628342769e-05,15,3,12
3966,Dig,1.48790438516857e-05,1.742643628342769e-05,18,7,11
3967,Digg,2.095639979110664e-07,5.348708166200577e-06,3,0,3
3968,Digger,2.3052039770217305e-06,3.6233184351681345e-06,3,1,2
3969,Digging,6.496483935243052e-06,1.052487735929791e-05,9,3,6
3970,Digital,4.002672360101368e-05,5.3659620635109e-05,52,21,31
3971,Dignity,1.278340387257504e-05,3.6233184351681345e-06,12,9,3
3972,Dilbert,4.400843956132392e-06,1.7253897310324457e-07,3,3,0
3973,Dilemma,1.278340387257504e-05,1.3975656821362803e-05,15,6,9
3974,Dilma,1.0687763893464371e-05,2.2602605476525032e-05,18,5,13
3975,Dim,4.400843956132392e-06,3.6233184351681345e-06,4,2,2
3976,Dime,2.3052039770217305e-06,7.074097897233022e-06,5,1,4
3977,Diminish,4.400843956132392e-06,1.7253897310324457e-07,3,3,0
3978,Dimon,1.0687763893464371e-05,1.8979287041356905e-06,7,6,1
3979,Diner,8.592123914353715e-06,5.348708166200577e-06,8,5,3
3980,Ding,8.592123914353715e-06,1.052487735929791e-05,10,4,6
3981,Dingell,4.400843956132392e-06,3.6233184351681345e-06,4,2,2
3982,Dining,8.592123914353715e-06,1.8979287041356905e-06,6,5,1
3983,Dinner,3.583544364279237e-05,3.985650278684949e-05,42,18,24
3984,Dinosaur,6.496483935243052e-06,8.79948762826546e-06,10,4,6
3985,Dioxide,4.400843956132392e-06,5.348708166200577e-06,5,2,3
3986,Dip,8.592123914353715e-06,8.79948762826546e-06,9,4,5
3987,Diplomacy,1.9070323809907035e-05,1.2250267090330355e-05,17,9,8
3988,Diplomat,3.583544364279237e-05,3.2954943862719716e-05,37,17,20
3989,Diplomatic,1.0687763893464371e-05,1.742643628342769e-05,16,6,10
3990,Dire,6.496483935243052e-06,1.2250267090330355e-05,14,6,8
3991,Direct,2.5357243747239038e-05,2.087721574549256e-05,25,13,12
3992,Directed,2.3052039770217305e-06,3.6233184351681345e-06,3,1,2
3993,Direction,8.592123914353715e-06,7.074097897233022e-06,9,4,5
3994,Directive,2.3052039770217305e-06,5.348708166200577e-06,5,2,3
3995,Directly,8.592123914353715e-06,8.79948762826546e-06,12,5,7
3996,Director,0.00016157384238943198,0.00018824001965563945,198,82,116
3997,Dirt,1.0687763893464371e-05,8.79948762826546e-06,13,8,5
3998,Dirty,1.6974683830796368e-05,4.1581892517881935e-05,36,10,26
3999,DirtyDenier,2.095639979110664e-07,7.074097897233022e-06,4,0,4
4000,Dis,2.3052039770217305e-06,3.6233184351681345e-06,3,1,2
4001,Disability,6.72700433294523e-05,4.1581892517881935e-05,66,36,30
4002,Disabled,6.496483935243052e-06,1.2250267090330355e-05,14,4,10
4003,Disagree,1.0687763893464371e-05,1.3975656821362803e-05,17,7,10
4004,Disagreement,1.278340387257504e-05,1.7253897310324457e-07,8,7,1
4005,Disappear,1.48790438516857e-05,1.742643628342769e-05,21,9,12
4006,Disappeared,6.496483935243052e-06,7.074097897233022e-06,8,3,5
4007,Disappearing,8.592123914353715e-06,3.6233184351681345e-06,8,5,3
4008,Disappointed,6.496483935243052e-06,1.2250267090330355e-05,10,3,7
4009,Disappointing,6.496483935243052e-06,7.074097897233022e-06,7,3,4
4010,Disarm,4.400843956132392e-06,1.8979287041356905e-06,3,2,1
4011,Disarmament,2.095639979110664e-07,5.348708166200577e-06,3,0,3
4012,Disarming,2.3052039770217305e-06,1.7253897310324457e-07,3,1,2
4013,Disarray,2.3052039770217305e-06,5.348708166200577e-06,4,1,3
4014,Disaster,8.822644312055891e-05,9.851975364195259e-05,110,48,62
4015,Disastrou,4.400843956132392e-06,1.2250267090330355e-05,10,2,8
4016,Disband,4.400843956132392e-06,1.8979287041356905e-06,3,2,1
4017,Discipline,2.3052039770217305e-06,3.6233184351681345e-06,3,1,2
4018,Disciplined,2.3052039770217305e-06,7.074097897233022e-06,5,1,4
4019,Disclaimer,6.496483935243052e-06,1.7253897310324457e-07,3,3,0
4020,Disclose,1.9070323809907035e-05,1.2250267090330355e-05,22,12,10
4021,Disclosing,6.496483935243052e-06,3.6233184351681345e-06,8,4,4
4022,Disclosure,2.326160376812834e-05,2.2602605476525032e-05,27,12,15
4023,Disconnect,2.3052039770217305e-06,7.074097897233022e-06,6,2,4
4024,Disconnection,2.3052039770217305e-06,3.6233184351681345e-06,3,1,2
4025,Discontent,2.3052039770217305e-06,3.6233184351681345e-06,4,2,2
4026,Discount,2.116596378901769e-05,1.2250267090330355e-05,18,11,7
4027,Discounted,2.095639979110664e-07,3.6233184351681345e-06,3,0,3
4028,Discourage,2.3052039770217305e-06,5.348708166200577e-06,4,1,3
4029,Discourse,4.400843956132392e-06,1.8979287041356905e-06,3,2,1
4030,Discover,3.3739803663681634e-05,3.640572332478458e-05,42,17,25
4031,Discovered,4.002672360101368e-05,2.777877466962238e-05,42,23,19
4032,Discovering,4.400843956132392e-06,3.6233184351681345e-06,4,2,2
4033,Discovery,2.116596378901769e-05,2.6053384938589907e-05,32,13,19
4034,Discriminate,1.278340387257504e-05,8.79948762826546e-06,11,6,5
4035,Discriminated,2.095639979110664e-07,5.348708166200577e-06,3,0,3
4036,Discrimination,5.888748341300963e-05,6.401195902130366e-05,68,29,39
4037,Discriminatory,8.592123914353715e-06,7.074097897233022e-06,9,4,5
4038,Discus,2.7452883726349685e-05,2.2602605476525032e-05,28,15,13
4039,Discuss,4.400843956132392e-06,1.8979287041356905e-06,4,2,2
4040,Discussed,1.0687763893464371e-05,3.6233184351681345e-06,8,5,3
4041,Discussing,4.400843956132392e-06,1.052487735929791e-05,8,2,6
4042,Discussion,8.592123914353715e-06,1.052487735929791e-05,10,4,6
4043,Disdain,2.095639979110664e-07,5.348708166200577e-06,4,1,3
4044,Disease,4.212236358012434e-05,5.1934230904076595e-05,56,20,36
4045,Disgrace,2.095639979110664e-07,1.570104655239525e-05,11,0,11
4046,Disgraced,6.496483935243052e-06,1.2250267090330355e-05,10,3,7
4047,Disgraceful,8.592123914353715e-06,1.7253897310324457e-07,4,4,0
4048,Disgracefulnes,2.3052039770217305e-06,1.8979287041356905e-06,4,1,3
4049,Disguised,4.400843956132392e-06,3.6233184351681345e-06,6,2,4
4050,Disgusted,6.496483935243052e-06,1.8979287041356905e-06,6,4,2
4051,Disgusting,4.400843956132392e-06,1.7253897310324457e-07,5,3,2
4052,Dish,4.400843956132392e-06,5.348708166200577e-06,6,2,4
4053,Dishonesty,4.400843956132392e-06,1.8979287041356905e-06,3,2,1
4054,Disinformation,2.3052039770217305e-06,7.074097897233022e-06,6,1,5
4055,Dislike,4.400843956132392e-06,7.074097897233022e-06,7,2,5
4056,Dismal,4.400843956132392e-06,3.6233184351681345e-06,5,2,3
4057,Dismantle,8.592123914353715e-06,8.79948762826546e-06,9,4,5
4058,Dismantled,4.400843956132392e-06,1.8979287041356905e-06,3,2,1
4059,Dismantling,2.3052039770217305e-06,8.79948762826546e-06,8,2,6
4060,Dismay,2.095639979110664e-07,5.348708166200577e-06,3,0,3
4061,Dismis,1.48790438516857e-05,1.052487735929791e-05,13,7,6
4062,Dismiss,8.592123914353715e-06,2.2602605476525032e-05,20,5,15
4063,Dismissal,2.3052039770217305e-06,5.348708166200577e-06,6,3,3
4064,Dismissed,8.592123914353715e-06,1.052487735929791e-05,11,4,7
4065,Disney,4.212236358012434e-05,5.1934230904076595e-05,58,20,38
4066,Disneyland,4.400843956132392e-06,1.052487735929791e-05,9,3,6
4067,Disorder,1.0687763893464371e-05,8.79948762826546e-06,10,5,5
4068,Disown,6.496483935243052e-06,1.8979287041356905e-06,4,3,1
4069,Disparity,4.400843956132392e-06,5.348708166200577e-06,6,2,4
4070,Dispatch,2.3052039770217305e-06,5.348708166200577e-06,5,1,4
4071,Displaced,6.496483935243052e-06,5.348708166200577e-06,7,4,3
4072,Display,1.6974683830796368e-05,1.3975656821362803e-05,18,9,9
4073,Dispute,3.1644163684570994e-05,2.9504164400654783e-05,37,16,21
4074,Disputed,1.278340387257504e-05,7.074097897233022e-06,11,6,5
4075,Disqualify,2.095639979110664e-07,5.348708166200577e-06,3,0,3
4076,Disqualifying,4.400843956132392e-06,5.348708166200577e-06,5,2,3
4077,Disregard,2.095639979110664e-07,5.348708166200577e-06,3,0,3
4078,Disrespect,2.3052039770217305e-06,3.6233184351681345e-06,3,1,2
4079,Disrupt,1.0687763893464371e-05,1.052487735929791e-05,12,6,6
4080,Disrupting,2.3052039770217305e-06,1.8979287041356905e-06,3,2,1
4081,Disruption,2.3052039770217305e-06,1.052487735929791e-05,8,2,6
4082,Disruptive,2.3052039770217305e-06,3.6233184351681345e-06,3,1,2
4083,Dissent,1.48790438516857e-05,1.052487735929791e-05,13,7,6
4084,Dissident,6.496483935243052e-06,3.6233184351681345e-06,7,3,4
4085,Dissolve,2.3052039770217305e-06,3.6233184351681345e-06,3,1,2
4086,Distance,1.0687763893464371e-05,1.052487735929791e-05,11,5,6
4087,Distant,4.400843956132392e-06,1.052487735929791e-05,8,2,6
4088,Distort,2.3052039770217305e-06,3.6233184351681345e-06,4,2,2
4089,Distorted,4.400843956132392e-06,1.8979287041356905e-06,4,3,1
4090,Distract,8.592123914353715e-06,7.074097897233022e-06,8,4,4
4091,Distracted,4.400843956132392e-06,7.074097897233022e-06,8,3,5
4092,Distraction,2.3052039770217305e-06,3.6233184351681345e-06,4,1,3
4093,Distribute,6.496483935243052e-06,1.7253897310324457e-07,3,3,0
4094,Distribution,2.3052039770217305e-06,3.6233184351681345e-06,6,1,5
4095,District,9.03220830996695e-05,0.00011404826122124471,116,46,70
4096,Distrust,2.3052039770217305e-06,5.348708166200577e-06,4,1,3
4097,Disturbing,1.6974683830796368e-05,1.742643628342769e-05,21,9,12
4098,Ditch,1.9070323809907035e-05,2.777877466962238e-05,27,10,17
4099,Ditched,2.095639979110664e-07,3.6233184351681345e-06,3,0,3
4100,Ditching,2.3052039770217305e-06,3.6233184351681345e-06,4,1,3
4101,Dive,4.400843956132392e-06,3.6233184351681345e-06,5,3,2
4102,Diver,2.3052039770217305e-06,1.052487735929791e-05,8,2,6
4103,Diverse,6.496483935243052e-06,5.348708166200577e-06,6,3,3
4104,Diversity,4.212236358012434e-05,3.8131113055817005e-05,47,21,26
4105,Divest,1.0687763893464371e-05,5.348708166200577e-06,8,5,3
4106,Divestment,2.3052039770217305e-06,5.348708166200577e-06,5,2,3
4107,Divide,1.278340387257504e-05,2.087721574549256e-05,22,8,14
4108,Divided,3.1644163684570994e-05,3.122955413168725e-05,39,18,21
4109,Dividing,4.400843956132392e-06,1.8979287041356905e-06,3,2,1
4110,Division,1.48790438516857e-05,2.087721574549256e-05,21,7,14
4111,Divisive,8.592123914353715e-06,8.79948762826546e-06,9,4,5
4112,Divorce,1.6974683830796368e-05,1.9151826014460126e-05,26,14,12
4113,Dixie,2.3052039770217305e-06,7.074097897233022e-06,5,1,4
4114,Djibouti,2.3052039770217305e-06,3.6233184351681345e-06,3,1,2
4115,Dmitry,1.6974683830796368e-05,1.570104655239525e-05,24,12,12
4116,Do,1.0687763893464371e-05,1.742643628342769e-05,18,6,12
4117,DoD,2.3052039770217305e-06,3.6233184351681345e-06,3,1,2
4118,DoNothing,2.3052039770217305e-06,5.348708166200577e-06,4,1,3
4119,Dobb,4.400843956132392e-06,8.79948762826546e-06,7,2,5
4120,Doc,1.6974683830796368e-05,1.742643628342769e-05,20,8,12
4121,Doctor,0.00012175668278632962,0.00014337988664879628,158,66,92
4122,Doctrine,1.0687763893464371e-05,1.052487735929791e-05,12,5,7
4123,Document,0.00010708720293255492,0.0001036959228350498,121,56,65
4124,Documentary,2.5357243747239038e-05,3.122955413168725e-05,32,13,19
4125,Documenting,2.095639979110664e-07,3.6233184351681345e-06,3,1,2
4126,DoddFrank,1.9070323809907035e-05,1.2250267090330355e-05,17,9,8
4127,Dodge,2.954852370546031e-05,1.9151826014460126e-05,27,15,12
4128,Dodger,4.400843956132392e-06,3.6233184351681345e-06,4,2,2
4129,Dodging,4.400843956132392e-06,3.6233184351681345e-06,8,3,5
4130,Dodgy,8.592123914353715e-06,3.6233184351681345e-06,6,4,2
4131,Doe,2.3052039770217305e-06,3.6233184351681345e-06,4,1,3
4132,Doesn,4.4218003559234974e-05,4.330728224891437e-05,50,25,25
4133,Dog,0.00014271308257743603,0.00018651462992460717,196,76,120
4134,DogWhistle,6.496483935243052e-06,1.7253897310324457e-07,3,3,0
4135,Dogg,2.3052039770217305e-06,5.348708166200577e-06,5,1,4
4136,Doha,6.496483935243052e-06,5.348708166200577e-06,6,3,3
4137,Dole,6.496483935243052e-06,1.052487735929791e-05,11,5,6
4138,Dollar,6.72700433294523e-05,7.436429740749831e-05,85,38,47
4139,Dolphin,1.9070323809907035e-05,1.9151826014460126e-05,24,11,13
4140,Domain,8.592123914353715e-06,1.3975656821362803e-05,15,5,10
4141,Dome,1.48790438516857e-05,7.074097897233022e-06,13,8,5
4142,Domestic,5.6791843433898893e-05,7.263890767646595e-05,78,32,46
4143,Dominance,2.3052039770217305e-06,5.348708166200577e-06,4,1,3
4144,Dominant,2.095639979110664e-07,5.348708166200577e-06,3,0,3
4145,Dominate,4.400843956132392e-06,7.074097897233022e-06,6,2,4
4146,Domination,4.400843956132392e-06,5.348708166200577e-06,5,2,3
4147,Dominican,1.6974683830796368e-05,1.052487735929791e-05,15,8,7
4148,Dominion,4.400843956132392e-06,1.8979287041356905e-06,3,2,1
4149,Dominique,4.400843956132392e-06,1.3975656821362803e-05,10,2,8
4150,Domino,6.496483935243052e-06,3.6233184351681345e-06,6,4,2
4151,Don,9.870464301611217e-05,8.299124606266055e-05,109,55,54
4152,Donald,0.0031499564526012358,0.002938511250921355,3579,1631,1948
4153,Donate,4.212236358012434e-05,5.711040009717395e-05,60,26,34
4154,Donated,4.400843956132392e-06,1.052487735929791e-05,9,3,6
4155,Donating,8.592123914353715e-06,1.2250267090330355e-05,11,4,7
4156,Donation,4.840928351745632e-05,6.401195902130366e-05,67,27,40
4157,Done,4.212236358012434e-05,5.3659620635109e-05,56,21,35
4158,Donetsk,4.400843956132392e-06,3.468033359375216e-05,28,3,25
4159,Dong,2.3052039770217305e-06,5.348708166200577e-06,5,2,3
4160,Donna,4.400843956132392e-06,1.742643628342769e-05,13,2,11
4161,Donnelly,2.095639979110664e-07,5.348708166200577e-06,3,0,3
4162,Donor,9.870464301611217e-05,5.5385010366141504e-05,90,51,39
4163,Donovan,4.400843956132392e-06,3.6233184351681345e-06,4,2,2
4164,Dont,4.400843956132392e-06,1.8979287041356905e-06,4,3,1
4165,Donut,6.496483935243052e-06,1.7253897310324457e-07,4,3,1
4166,Doocy,8.592123914353715e-06,1.8979287041356905e-06,5,4,1
4167,Doodle,1.0687763893464371e-05,1.052487735929791e-05,12,6,6
4168,Doom,4.400843956132392e-06,1.2250267090330355e-05,11,2,9
4169,Doomed,6.496483935243052e-06,1.052487735929791e-05,11,3,8
4170,Doomsday,2.116596378901769e-05,7.074097897233022e-06,17,11,6
4171,Door,4.212236358012434e-05,5.711040009717395e-05,58,21,37
4172,Doral,4.400843956132392e-06,1.8979287041356905e-06,3,2,1
4173,Dorian,2.3052039770217305e-06,7.074097897233022e-06,6,1,5
4174,Dorothy,4.400843956132392e-06,7.074097897233022e-06,6,2,4
4175,Dorsey,8.592123914353715e-06,1.742643628342769e-05,16,4,12
4176,Dose,4.400843956132392e-06,1.8979287041356905e-06,3,2,1
4177,Dossier,1.0687763893464371e-05,8.79948762826546e-06,10,5,5
4178,Dot,4.400843956132392e-06,3.6233184351681345e-06,4,2,2
4179,Dotcom,5.888748341300963e-05,5.3659620635109e-05,63,31,32
4180,Double,5.4696203454788295e-05,5.3659620635109e-05,61,28,33
4181,Doubled,4.400843956132392e-06,8.79948762826546e-06,9,3,6
4182,Doubling,6.496483935243052e-06,8.79948762826546e-06,10,5,5
4183,Doubt,2.954852370546031e-05,2.4327995207557487e-05,34,15,19
4184,Doug,4.840928351745632e-05,4.330728224891437e-05,60,34,26
4185,Dougla,1.6974683830796368e-05,1.9151826014460126e-05,20,8,12
4186,Dow,1.9070323809907035e-05,2.6053384938589907e-05,28,13,15
4187,Dowd,4.400843956132392e-06,1.8979287041356905e-06,3,2,1
4188,Down,8.592123914353715e-06,5.348708166200577e-06,9,4,5
4189,DownBallot,8.592123914353715e-06,1.8979287041356905e-06,5,4,1
4190,Downed,4.400843956132392e-06,3.6233184351681345e-06,5,2,3
4191,Downfall,2.3052039770217305e-06,7.074097897233022e-06,5,1,4
4192,Downgrade,2.3052039770217305e-06,5.348708166200577e-06,4,1,3
4193,Downing,8.592123914353715e-06,8.79948762826546e-06,11,4,7
4194,Download,2.3052039770217305e-06,8.79948762826546e-06,6,1,5
4195,Downplay,8.592123914353715e-06,1.570104655239525e-05,14,4,10
4196,Downtown,6.496483935243052e-06,5.348708166200577e-06,6,3,3
4197,Downward,6.496483935243052e-06,1.8979287041356905e-06,4,3,1
4198,Dozen,7.984388320411623e-05,9.161819471782287e-05,103,41,62
4199,Dr,0.00010080028299522283,0.00011404826122124471,128,53,75
4200,Draconian,2.3052039770217305e-06,5.348708166200577e-06,4,1,3
4201,Dracula,4.400843956132392e-06,3.6233184351681345e-06,4,2,2
4202,Draft,2.7452883726349685e-05,3.468033359375216e-05,37,15,22
4203,Drafted,2.3052039770217305e-06,3.6233184351681345e-06,3,1,2
4204,Drag,1.6974683830796368e-05,8.79948762826546e-06,15,8,7
4205,Dragged,2.3052039770217305e-06,1.2250267090330355e-05,8,1,7
4206,Dragon,1.6974683830796368e-05,1.052487735929791e-05,14,8,6
4207,Drain,4.400843956132392e-06,1.742643628342769e-05,16,5,11
4208,Draining,2.3052039770217305e-06,8.79948762826546e-06,7,2,5
4209,Drake,4.400843956132392e-06,5.348708166200577e-06,5,2,3
4210,Drama,2.3052039770217305e-06,1.052487735929791e-05,7,1,6
4211,Dramatic,1.9070323809907035e-05,1.570104655239525e-05,22,12,10
4212,Dramatically,1.0687763893464371e-05,3.6233184351681345e-06,7,5,2
4213,Draper,4.400843956132392e-06,3.6233184351681345e-06,4,2,2
4214,Drastic,2.3052039770217305e-06,5.348708166200577e-06,4,1,3
4215,Draw,3.1644163684570994e-05,2.2602605476525032e-05,32,16,16
4216,Drawing,1.0687763893464371e-05,8.79948762826546e-06,12,6,6
4217,Drawn,2.3052039770217305e-06,7.074097897233022e-06,6,1,5
4218,Dread,2.3052039770217305e-06,3.6233184351681345e-06,4,1,3
4219,Dream,7.355696326678427e-05,6.918812821440096e-05,79,37,42
4220,DreamWork,6.496483935243052e-06,1.8979287041356905e-06,4,3,1
4221,Dreamed,2.095639979110664e-07,3.6233184351681345e-06,4,1,3
4222,Dreamer,7.984388320411623e-05,8.989280498679035e-05,94,39,55
4223,Dreaming,8.592123914353715e-06,1.8979287041356905e-06,5,4,1
4224,Dres,1.0687763893464371e-05,7.074097897233022e-06,11,6,5
4225,Dresden,8.592123914353715e-06,3.6233184351681345e-06,6,4,2
4226,Dress,4.400843956132392e-06,1.7253897310324457e-07,3,2,1
4227,Dressed,4.400843956132392e-06,7.074097897233022e-06,7,2,5
4228,Drew,2.3052039770217305e-06,5.348708166200577e-06,4,1,3
4229,Drifting,4.400843956132392e-06,3.6233184351681345e-06,4,2,2
4230,Drill,1.6974683830796368e-05,1.052487735929791e-05,14,8,6
4231,Drilling,2.326160376812834e-05,4.1581892517881935e-05,40,13,27
4232,Drink,1.6974683830796368e-05,2.9504164400654783e-05,25,8,17
4233,Drinking,3.583544364279237e-05,1.2250267090330355e-05,29,20,9
4234,Drive,3.7931083621902995e-05,3.640572332478458e-05,44,20,24
4235,Driven,8.592123914353715e-06,3.6233184351681345e-06,7,5,2
4236,Driver,4.002672360101368e-05,8.299124606266055e-05,76,25,51
4237,Driverles,1.9070323809907035e-05,7.074097897233022e-06,15,10,5
4238,Driving,3.7931083621902995e-05,4.1581892517881935e-05,47,19,28
4239,Drone,8.193952318322689e-05,0.00011577365095227703,125,48,77
4240,Drop,0.00010499156295344414,0.00010714670229711469,131,61,70
4241,Dropout,2.3052039770217305e-06,3.6233184351681345e-06,3,1,2
4242,Dropped,1.0687763893464371e-05,2.9504164400654783e-05,22,5,17
4243,Dropping,2.116596378901769e-05,2.2602605476525032e-05,26,11,15
4244,Drought,3.3739803663681634e-05,1.9151826014460126e-05,29,17,12
4245,Drove,8.592123914353715e-06,7.074097897233022e-06,9,4,5
4246,Drown,2.3052039770217305e-06,5.348708166200577e-06,4,1,3
4247,Drowned,4.400843956132392e-06,3.6233184351681345e-06,6,2,4
4248,Drowning,8.592123914353715e-06,7.074097897233022e-06,8,4,4
4249,Drowsy,4.400843956132392e-06,1.8979287041356905e-06,5,2,3
4250,Drudge,4.400843956132392e-06,1.8979287041356905e-06,3,2,1
4251,Drug,0.00027892968121962896,0.00033489814679339735,371,152,219
4252,Drugmaker,4.400843956132392e-06,1.052487735929791e-05,8,2,6
4253,Drugresistant,2.095639979110664e-07,8.79948762826546e-06,5,0,5
4254,Drum,8.592123914353715e-06,7.074097897233022e-06,8,4,4
4255,Drummer,2.3052039770217305e-06,1.7253897310324457e-07,3,1,2
4256,Drunk,1.9070323809907035e-05,2.4327995207557487e-05,24,9,15
4257,Drunken,2.095639979110664e-07,3.6233184351681345e-06,4,2,2
4258,Druze,4.400843956132392e-06,3.6233184351681345e-06,4,2,2
4259,Dry,1.6974683830796368e-05,7.074097897233022e-06,13,8,5
4260,Dual,4.400843956132392e-06,1.8979287041356905e-06,5,3,2
4261,Dubai,0.0001259479627445509,0.00013992910718673112,154,64,90
4262,Dubbed,2.3052039770217305e-06,3.6233184351681345e-06,3,1,2
4263,Dubiou,8.592123914353715e-06,3.6233184351681345e-06,9,5,4
4264,Dublin,6.496483935243052e-06,2.9504164400654783e-05,21,3,18
4265,Duches,1.0687763893464371e-05,1.8979287041356905e-06,6,5,1
4266,Duck,2.5357243747239038e-05,1.570104655239525e-05,26,14,12
4267,Duckling,2.3052039770217305e-06,3.6233184351681345e-06,3,1,2
4268,Duckworth,2.116596378901769e-05,2.087721574549256e-05,23,11,12
4269,Duct,2.3052039770217305e-06,1.7253897310324457e-07,3,3,0
4270,Dude,8.592123914353715e-06,7.074097897233022e-06,9,5,4
4271,Dudley,2.095639979110664e-07,5.348708166200577e-06,3,0,3
4272,Due,4.840928351745632e-05,4.50326719799468e-05,53,24,29
4273,Duet,4.400843956132392e-06,1.8979287041356905e-06,3,2,1
4274,Dug,2.3052039770217305e-06,1.8979287041356905e-06,3,1,2
4275,Duggan,4.400843956132392e-06,1.8979287041356905e-06,3,2,1
4276,Dugong,2.095639979110664e-07,5.348708166200577e-06,3,0,3
4277,Duke,2.116596378901769e-05,2.777877466962238e-05,31,13,18
4278,Dum,6.496483935243052e-06,1.7253897310324457e-07,3,3,0
4279,Duma,1.0687763893464371e-05,3.6233184351681345e-06,7,5,2
4280,Dumb,1.48790438516857e-05,1.3975656821362803e-05,16,7,9
4281,Dumbest,1.278340387257504e-05,5.348708166200577e-06,11,6,5
4282,Dumbledore,2.3052039770217305e-06,3.6233184351681345e-06,3,1,2
4283,Dump,3.583544364279237e-05,3.468033359375216e-05,41,17,24
4284,Dumped,4.400843956132392e-06,1.8979287041356905e-06,6,5,1
4285,Dumping,4.400843956132392e-06,5.348708166200577e-06,6,3,3
4286,Duncan,1.48790438516857e-05,1.3975656821362803e-05,16,7,9
4287,Dunham,2.3052039770217305e-06,3.6233184351681345e-06,3,1,2
4288,Dunk,2.095639979110664e-07,3.6233184351681345e-06,4,0,4
4289,Dunkin,4.400843956132392e-06,1.7253897310324457e-07,4,3,1
4290,Duo,2.3052039770217305e-06,3.6233184351681345e-06,4,1,3
4291,Dupe,6.496483935243052e-06,1.8979287041356905e-06,4,3,1
4292,Duped,4.400843956132392e-06,3.6233184351681345e-06,4,2,2
4293,Durban,4.400843956132392e-06,5.348708166200577e-06,6,2,4
4294,Durbin,8.592123914353715e-06,1.052487735929791e-05,12,5,7
4295,Durham,2.3052039770217305e-06,7.074097897233022e-06,6,1,5
4296,Dust,1.278340387257504e-05,8.79948762826546e-06,11,6,5
4297,Dustin,2.3052039770217305e-06,1.8979287041356905e-06,4,2,2
4298,Dutch,0.00025797328142852257,0.00019341618884873702,255,131,124
4299,Duterte,8.592123914353715e-06,1.3975656821362803e-05,12,4,8
4300,Duty,1.9070323809907035e-05,2.087721574549256e-05,25,11,14
4301,Dwarf,8.592123914353715e-06,7.074097897233022e-06,8,4,4
4302,Dweller,4.400843956132392e-06,1.8979287041356905e-06,3,2,1
4303,Dwindling,6.496483935243052e-06,1.8979287041356905e-06,4,3,1
4304,Dy,9.660900303700153e-05,6.918812821440096e-05,97,52,45
4305,Dying,3.3739803663681634e-05,5.1934230904076595e-05,52,17,35
4306,Dylan,6.496483935243052e-06,7.074097897233022e-06,7,3,4
4307,Dylann,4.400843956132392e-06,1.570104655239525e-05,13,3,10
4308,Dynamic,2.3052039770217305e-06,5.348708166200577e-06,4,1,3
4309,Dynasty,4.400843956132392e-06,5.348708166200577e-06,5,2,3
4310,Dysfunction,2.3052039770217305e-06,5.348708166200577e-06,6,2,4
4311,Dysfunctional,2.3052039770217305e-06,1.8979287041356905e-06,3,2,1
4312,Dystopian,2.095639979110664e-07,7.074097897233022e-06,5,0,5
4313,Dystrophy,2.3052039770217305e-06,1.8979287041356905e-06,3,2,1
4314,Dziekanski,8.592123914353715e-06,1.7253897310324457e-07,6,5,1
4315,Déjà,4.400843956132392e-06,1.7253897310324457e-07,3,2,1
4316,ECB,2.095639979110664e-07,5.348708166200577e-06,4,0,4
4317,ECigarette,4.400843956132392e-06,5.348708166200577e-06,7,2,5
4318,EDF,2.095639979110664e-07,3.6233184351681345e-06,3,0,3
4319,EFF,4.400843956132392e-06,7.074097897233022e-06,8,2,6
4320,EMILY,6.496483935243052e-06,5.348708166200577e-06,6,3,3
4321,EPA,0.0001259479627445509,0.00020721930669699654,201,71,130
4322,ER,6.496483935243052e-06,1.8979287041356905e-06,6,4,2
4323,ESA,6.496483935243052e-06,1.8979287041356905e-06,5,3,2
4324,ESPN,1.278340387257504e-05,2.2602605476525032e-05,20,6,14
4325,EST,2.095639979110664e-07,8.79948762826546e-06,6,1,5
4326,ET,1.0687763893464371e-05,5.348708166200577e-06,10,6,4
4327,ETA,2.095639979110664e-07,5.348708166200577e-06,4,1,3
4328,EU,0.0006351884776684417,0.0005488464734414206,694,332,362
4329,EUR,2.3052039770217305e-06,1.8979287041356905e-06,3,1,2
4330,EUU,1.278340387257504e-05,1.8979287041356905e-06,9,6,3
4331,EVERY,2.3052039770217305e-06,3.6233184351681345e-06,3,1,2
4332,Eager,1.0687763893464371e-05,1.2250267090330355e-05,14,5,9
4333,Eagle,2.116596378901769e-05,1.052487735929791e-05,16,10,6
4334,Ear,1.48790438516857e-05,8.79948762826546e-06,14,9,5
4335,Earhart,2.095639979110664e-07,5.348708166200577e-06,8,5,3
4336,Earl,4.400843956132392e-06,3.6233184351681345e-06,4,2,2
4337,Earlier,2.116596378901769e-05,3.122955413168725e-05,31,11,20
4338,Earliest,4.400843956132392e-06,7.074097897233022e-06,6,2,4
4339,Early,6.307876337123095e-05,9.679436391092026e-05,94,34,60
4340,Earmark,2.095639979110664e-07,5.348708166200577e-06,3,0,3
4341,Earn,2.326160376812834e-05,8.79948762826546e-06,19,13,6
4342,Earned,1.0687763893464371e-05,5.348708166200577e-06,9,5,4
4343,Earnest,2.095639979110664e-07,1.8979287041356905e-06,3,2,1
4344,Earning,6.496483935243052e-06,8.79948762826546e-06,8,3,5
4345,Earth,0.00023072996170008382,0.0002244732040073209,270,125,145
4346,Earthlike,4.400843956132392e-06,3.6233184351681345e-06,4,2,2
4347,Earthquake,7.355696326678427e-05,8.644202552472544e-05,94,40,54
4348,Earthsized,2.3052039770217305e-06,3.6233184351681345e-06,3,1,2
4349,Ease,8.592123914353715e-06,1.570104655239525e-05,15,5,10
4350,Easier,2.954852370546031e-05,3.985650278684949e-05,38,14,24
4351,Easiest,4.400843956132392e-06,1.8979287041356905e-06,4,2,2
4352,Easily,1.0687763893464371e-05,8.79948762826546e-06,12,6,6
4353,Easing,4.400843956132392e-06,1.8979287041356905e-06,3,2,1
4354,East,0.0003292250407182847,0.0003090173008279106,378,173,205
4355,Easter,8.592123914353715e-06,1.742643628342769e-05,15,4,11
4356,Eastern,7.146132328767358e-05,4.50326719799468e-05,63,35,28
4357,Easterner,2.3052039770217305e-06,1.8979287041356905e-06,3,2,1
4358,Eastman,2.3052039770217305e-06,3.6233184351681345e-06,4,2,2
4359,Easy,4.4218003559234974e-05,3.2954943862719716e-05,45,21,24
4360,Eat,3.1644163684570994e-05,3.122955413168725e-05,38,17,21
4361,Eating,3.1644163684570994e-05,3.468033359375216e-05,35,15,20
4362,Ebadi,8.592123914353715e-06,1.8979287041356905e-06,5,4,1
4363,Ebay,6.496483935243052e-06,1.7253897310324457e-07,4,4,0
4364,Ebola,0.0002181561218254202,0.00024172710131764556,279,121,158
4365,Ebolafree,2.095639979110664e-07,5.348708166200577e-06,3,0,3
4366,Ebrahim,2.3052039770217305e-06,3.6233184351681345e-06,3,1,2
4367,Eccentric,2.3052039770217305e-06,3.6233184351681345e-06,3,1,2
4368,Echo,1.6974683830796368e-05,7.074097897233022e-06,14,8,6
4369,Ecigarette,6.496483935243052e-06,5.348708166200577e-06,6,3,3
4370,Eclipse,6.496483935243052e-06,2.9504164400654783e-05,20,3,17
4371,Eco,8.592123914353715e-06,1.7253897310324457e-07,4,4,0
4372,Ecoli,6.496483935243052e-06,3.6233184351681345e-06,5,3,2
4373,Ecological,4.400843956132392e-06,1.8979287041356905e-06,3,2,1
4374,Economic,0.00013642616264010403,0.00015373222503499084,170,73,97
4375,Economically,4.400843956132392e-06,1.8979287041356905e-06,4,2,2
4376,Economist,3.583544364279237e-05,6.056117955923882e-05,60,18,42
4377,Economy,0.0001385218026192147,0.00015373222503499084,174,75,99
4378,Ecstasy,6.496483935243052e-06,1.8979287041356905e-06,4,3,1
4379,Ecuador,0.00010708720293255492,0.00012094982014537423,135,59,76
4380,Ecuadoran,6.496483935243052e-06,1.8979287041356905e-06,4,3,1
4381,Ecuadorean,8.592123914353715e-06,1.3975656821362803e-05,13,4,9
4382,Ecuadorian,1.278340387257504e-05,2.2602605476525032e-05,20,6,14
4383,Ed,2.954852370546031e-05,3.8131113055817005e-05,46,19,27
4384,Eddie,2.3052039770217305e-06,1.3975656821362803e-05,9,1,8
4385,Edge,3.1644163684570994e-05,1.9151826014460126e-05,30,17,13
4386,Edinburgh,2.3052039770217305e-06,3.6233184351681345e-06,3,1,2
4387,Editing,2.3052039770217305e-06,3.6233184351681345e-06,3,1,2
4388,Edition,2.326160376812834e-05,2.9504164400654783e-05,32,13,19
4389,Editor,1.6974683830796368e-05,2.2602605476525032e-05,21,8,13
4390,Editorial,1.48790438516857e-05,8.79948762826546e-06,13,7,6
4391,Edmonton,8.592123914353715e-06,7.074097897233022e-06,9,4,5
4392,Eduardo,2.3052039770217305e-06,8.79948762826546e-06,6,1,5
4393,Educate,8.592123914353715e-06,1.8979287041356905e-06,7,5,2
4394,Educated,8.592123914353715e-06,5.348708166200577e-06,8,4,4
4395,Educating,4.400843956132392e-06,5.348708166200577e-06,5,2,3
4396,Education,0.0001385218026192147,0.00017271151207634748,188,78,110
4397,Educational,4.400843956132392e-06,5.348708166200577e-06,5,2,3
4398,Educator,1.0687763893464371e-05,5.348708166200577e-06,8,5,3
4399,Edvard,6.496483935243052e-06,1.7253897310324457e-07,3,3,0
4400,Edward,0.00018881716211787043,0.00018306385046254245,212,97,115
4401,Edwin,6.496483935243052e-06,7.074097897233022e-06,7,3,4
4402,Eerily,4.400843956132392e-06,1.8979287041356905e-06,3,2,1
4403,Effect,5.260056347567764e-05,4.8483451442011706e-05,58,29,29
4404,Effective,1.0687763893464371e-05,2.6053384938589907e-05,22,6,16
4405,Effectively,8.592123914353715e-06,8.79948762826546e-06,11,6,5
4406,Effectivenes,6.496483935243052e-06,1.8979287041356905e-06,5,4,1
4407,Efficiency,8.592123914353715e-06,5.348708166200577e-06,7,4,3
4408,Efficient,2.3052039770217305e-06,3.6233184351681345e-06,5,2,3
4409,Effort,7.355696326678427e-05,0.00012267520987640663,121,42,79
4410,Egg,8.592123914353715e-06,1.742643628342769e-05,15,5,10
4411,Ego,2.3052039770217305e-06,5.348708166200577e-06,6,1,5
4412,Egypt,0.0005555541584622364,0.0006057843345654911,686,290,396
4413,EgyptAir,4.400843956132392e-06,1.742643628342769e-05,13,3,10
4414,Egyptian,0.0003292250407182847,0.00031074269055894344,377,171,206
4415,Ehud,4.400843956132392e-06,8.79948762826546e-06,12,3,9
4416,Eid,1.0687763893464371e-05,5.348708166200577e-06,8,5,3
4417,Eiffel,6.496483935243052e-06,3.6233184351681345e-06,5,3,2
4418,Eight,3.3739803663681634e-05,3.8131113055817005e-05,45,19,26
4419,Eighteen,4.400843956132392e-06,3.6233184351681345e-06,4,2,2
4420,Eighth,2.3052039770217305e-06,3.6233184351681345e-06,3,1,2
4421,Eighty,4.400843956132392e-06,3.6233184351681345e-06,4,2,2
4422,Eilat,4.400843956132392e-06,5.348708166200577e-06,6,2,4
4423,Eileen,6.496483935243052e-06,7.074097897233022e-06,7,3,4
4424,Einstein,1.0687763893464371e-05,1.3975656821362803e-05,14,5,9
4425,Eisenhower,6.496483935243052e-06,5.348708166200577e-06,7,3,4
4426,Either,3.1644163684570994e-05,2.777877466962238e-05,35,17,18
4427,Ejected,2.095639979110664e-07,3.6233184351681345e-06,4,0,4
4428,Ejection,2.3052039770217305e-06,3.6233184351681345e-06,3,1,2
4429,El,7.774824322500554e-05,9.506897417988779e-05,99,39,60
4430,ElBaradei,4.400843956132392e-06,8.79948762826546e-06,10,3,7
4431,ElSayed,2.3052039770217305e-06,3.6233184351681345e-06,4,2,2
4432,Elaine,1.0687763893464371e-05,1.570104655239525e-05,15,5,10
4433,Elbow,4.400843956132392e-06,1.8979287041356905e-06,3,2,1
4434,Elder,4.400843956132392e-06,1.052487735929791e-05,8,2,6
4435,Elderly,3.1644163684570994e-05,2.4327995207557487e-05,33,17,16
4436,Elect,1.6974683830796368e-05,2.087721574549256e-05,24,10,14
4437,Electability,6.496483935243052e-06,1.8979287041356905e-06,4,3,1
4438,Elected,3.583544364279237e-05,4.330728224891437e-05,44,18,26
4439,Electing,6.496483935243052e-06,1.052487735929791e-05,13,5,8
4440,Election,0.0005911800381071181,0.0006161366729516858,721,315,406
4441,Elector,4.400843956132392e-06,1.2250267090330355e-05,9,2,7
4442,Electoral,2.954852370546031e-05,4.6758061710979285e-05,47,16,31
4443,Electric,6.307876337123095e-05,3.640572332478458e-05,57,34,23
4444,Electricity,2.116596378901769e-05,1.052487735929791e-05,20,10,10
4445,Electronic,3.7931083621902995e-05,1.742643628342769e-05,29,19,10
4446,Elegy,2.3052039770217305e-06,7.074097897233022e-06,5,1,4
4447,Element,6.496483935243052e-06,3.6233184351681345e-06,6,3,3
4448,Elementary,1.9070323809907035e-05,1.052487735929791e-05,16,9,7
4449,Elena,4.400843956132392e-06,1.8979287041356905e-06,4,3,1
4450,Elephant,5.4696203454788295e-05,4.8483451442011706e-05,58,28,30
4451,Elevate,2.095639979110664e-07,7.074097897233022e-06,4,0,4
4452,Elevator,8.592123914353715e-06,5.348708166200577e-06,7,4,3
4453,Eleven,1.278340387257504e-05,1.2250267090330355e-05,16,8,8
4454,Eli,4.400843956132392e-06,1.8979287041356905e-06,3,2,1
4455,Eligibility,2.3052039770217305e-06,1.8979287041356905e-06,3,1,2
4456,Eligible,2.095639979110664e-07,1.052487735929791e-05,6,0,6
4457,Elijah,8.592123914353715e-06,1.2250267090330355e-05,12,5,7
4458,Eliminate,1.48790438516857e-05,2.4327995207557487e-05,26,11,15
4459,Eliminating,2.3052039770217305e-06,8.79948762826546e-06,7,1,6
4460,Elimination,2.3052039770217305e-06,7.074097897233022e-06,5,1,4
4461,Eliot,4.400843956132392e-06,1.8979287041356905e-06,4,2,2
4462,Elisabeth,2.095639979110664e-07,5.348708166200577e-06,4,0,4
4463,Elite,4.4218003559234974e-05,3.640572332478458e-05,43,22,21
4464,Elizabeth,0.00015947820241032126,0.00020549391696596386,224,89,135
4465,Ellen,8.592123914353715e-06,1.052487735929791e-05,10,4,6
4466,Elliot,6.496483935243052e-06,1.8979287041356905e-06,4,3,1
4467,Elliott,2.3052039770217305e-06,8.79948762826546e-06,6,1,5
4468,Ellison,2.116596378901769e-05,2.777877466962238e-05,31,11,20
4469,Elon,5.4696203454788295e-05,7.263890767646595e-05,74,27,47
4470,Else,4.4218003559234974e-05,3.2954943862719716e-05,42,23,19
4471,Elsewhere,1.0687763893464371e-05,5.348708166200577e-06,8,5,3
4472,Elton,8.592123914353715e-06,3.6233184351681345e-06,7,4,3
4473,Elusive,2.3052039770217305e-06,8.79948762826546e-06,6,1,5
4474,Elvi,6.496483935243052e-06,1.8979287041356905e-06,4,3,1
4475,Em,6.496483935243052e-06,7.074097897233022e-06,7,3,4
4476,Email,0.0005534585184831261,0.0005643749810207128,646,285,361
4477,Emanuel,2.5357243747239038e-05,1.742643628342769e-05,25,13,12
4478,Embargo,6.496483935243052e-06,5.348708166200577e-06,7,4,3
4479,Embarrassed,6.496483935243052e-06,7.074097897233022e-06,7,3,4
4480,Embarrassing,4.400843956132392e-06,1.2250267090330355e-05,15,4,11
4481,Embarrassment,2.3052039770217305e-06,1.052487735929791e-05,8,2,6
4482,Embassy,7.146132328767358e-05,8.299124606266055e-05,87,36,51
4483,Embattled,1.0687763893464371e-05,7.074097897233022e-06,12,7,5
4484,Embezzling,6.496483935243052e-06,1.8979287041356905e-06,5,4,1
4485,Embody,2.095639979110664e-07,3.6233184351681345e-06,3,0,3
4486,Emboldened,4.400843956132392e-06,1.8979287041356905e-06,4,2,2
4487,Embrace,4.212236358012434e-05,2.6053384938589907e-05,35,20,15
4488,Embraced,4.400843956132392e-06,3.6233184351681345e-06,6,2,4
4489,Embracing,2.3052039770217305e-06,1.570104655239525e-05,12,2,10
4490,Embroiled,2.095639979110664e-07,5.348708166200577e-06,3,0,3
4491,Embryonic,2.3052039770217305e-06,5.348708166200577e-06,4,1,3
4492,Emerge,8.592123914353715e-06,2.6053384938589907e-05,19,4,15
4493,Emergency,8.822644312055891e-05,7.954046660059569e-05,101,49,52
4494,Emerging,1.48790438516857e-05,1.052487735929791e-05,13,7,6
4495,Emily,2.095639979110664e-07,5.348708166200577e-06,3,0,3
4496,Eminent,4.400843956132392e-06,1.8979287041356905e-06,3,2,1
4497,Emir,2.095639979110664e-07,5.348708166200577e-06,3,0,3
4498,Emirate,2.116596378901769e-05,1.3975656821362803e-05,22,10,12
4499,Emission,5.4696203454788295e-05,3.640572332478458e-05,52,29,23
4500,Emma,8.592123914353715e-06,1.052487735929791e-05,12,6,6
4501,Emmanuel,1.48790438516857e-05,8.79948762826546e-06,13,7,6
4502,Emmett,2.095639979110664e-07,5.348708166200577e-06,3,0,3
4503,Emmy,2.3052039770217305e-06,8.79948762826546e-06,6,1,5
4504,Emoji,1.0687763893464371e-05,1.3975656821362803e-05,14,6,8
4505,Emolument,8.592123914353715e-06,3.6233184351681345e-06,7,4,3
4506,Emotion,1.0687763893464371e-05,5.348708166200577e-06,8,5,3
4507,Emotional,3.3739803663681634e-05,4.1581892517881935e-05,41,16,25
4508,Empathy,1.278340387257504e-05,1.052487735929791e-05,13,6,7
4509,Emperor,6.496483935243052e-06,5.348708166200577e-06,7,4,3
4510,Emphasize,4.400843956132392e-06,8.79948762826546e-06,7,2,5
4511,Empire,3.3739803663681634e-05,2.2602605476525032e-05,33,19,14
4512,Employ,2.3052039770217305e-06,3.6233184351681345e-06,4,2,2
4513,Employee,0.0001154697628489974,0.00014683066611086105,157,63,94
4514,Employer,2.326160376812834e-05,3.468033359375216e-05,37,14,23
4515,Employment,2.326160376812834e-05,2.087721574549256e-05,28,14,14
4516,Empower,2.326160376812834e-05,7.074097897233022e-06,17,11,6
4517,Empowering,8.592123914353715e-06,1.742643628342769e-05,15,4,11
4518,Empowerment,8.592123914353715e-06,8.79948762826546e-06,11,5,6
4519,Empty,1.0687763893464371e-05,1.9151826014460126e-05,18,5,13
4520,Emptying,2.3052039770217305e-06,3.6233184351681345e-06,3,1,2
4521,En,2.3052039770217305e-06,1.8979287041356905e-06,4,2,2
4522,Enable,8.592123914353715e-06,7.074097897233022e-06,10,5,5
4523,Enabled,2.095639979110664e-07,1.052487735929791e-05,7,0,7
4524,Enabler,2.3052039770217305e-06,1.8979287041356905e-06,3,1,2
4525,Enabling,8.592123914353715e-06,1.052487735929791e-05,10,4,6
4526,Enact,2.3052039770217305e-06,7.074097897233022e-06,6,2,4
4527,Enacted,2.095639979110664e-07,3.6233184351681345e-06,3,1,2
4528,Encounter,6.496483935243052e-06,3.6233184351681345e-06,6,3,3
4529,Encourage,1.0687763893464371e-05,1.570104655239525e-05,15,6,9
4530,Encouraging,4.400843956132392e-06,5.348708166200577e-06,7,3,4
4531,Encrypted,2.3052039770217305e-06,5.348708166200577e-06,5,1,4
4532,Encryption,1.48790438516857e-05,1.052487735929791e-05,15,7,8
4533,End,0.00027054712130318646,0.0003245458084072032,363,153,210
4534,Enda,4.400843956132392e-06,1.8979287041356905e-06,3,2,1
4535,Endanger,6.496483935243052e-06,5.348708166200577e-06,6,3,3
4536,Endangered,2.5357243747239038e-05,2.4327995207557487e-05,34,14,20
4537,Ended,1.6974683830796368e-05,1.2250267090330355e-05,17,9,8
4538,Endgame,2.3052039770217305e-06,5.348708166200577e-06,4,1,3
4539,Ending,5.260056347567764e-05,3.985650278684949e-05,55,28,27
4540,Endles,6.496483935243052e-06,1.570104655239525e-05,12,3,9
4541,Endorse,0.00011337412286988677,9.506897417988779e-05,124,61,63
4542,Endorsed,1.6974683830796368e-05,5.348708166200577e-06,13,9,4
4543,Endorsement,5.260056347567764e-05,5.020884117304414e-05,62,28,34
4544,Endorsing,2.3052039770217305e-06,1.3975656821362803e-05,10,1,9
4545,Endure,2.3052039770217305e-06,7.074097897233022e-06,6,2,4
4546,Enduring,4.400843956132392e-06,1.7253897310324457e-07,4,3,1
4547,Enemy,2.326160376812834e-05,4.330728224891437e-05,37,11,26
4548,Energy,0.00018462588215964923,0.0001554576147660233,190,93,97
4549,Enforce,6.496483935243052e-06,1.742643628342769e-05,14,3,11
4550,Enforcement,3.3739803663681634e-05,4.330728224891437e-05,48,19,29
4551,Enforcing,4.400843956132392e-06,1.570104655239525e-05,11,2,9
4552,Engage,8.592123914353715e-06,1.7253897310324457e-07,4,4,0
4553,Engaged,4.400843956132392e-06,7.074097897233022e-06,7,2,5
4554,Engagement,1.6974683830796368e-05,1.2250267090330355e-05,20,12,8
4555,Engaging,4.400843956132392e-06,1.8979287041356905e-06,4,2,2
4556,Engel,2.3052039770217305e-06,1.8979287041356905e-06,3,1,2
4557,Engine,8.592123914353715e-06,7.074097897233022e-06,9,5,4
4558,Engineer,1.48790438516857e-05,2.087721574549256e-05,23,8,15
4559,Engineering,8.592123914353715e-06,7.074097897233022e-06,8,4,4
4560,England,0.00016366948236854273,0.0001520068353039585,174,82,92
4561,English,0.00013223488268188294,0.0001382037174556987,164,71,93
4562,Enhanced,4.400843956132392e-06,1.8979287041356905e-06,4,2,2
4563,Enjoy,1.0687763893464371e-05,1.3975656821362803e-05,14,5,9
4564,Enlist,2.3052039770217305e-06,3.6233184351681345e-06,6,4,2
4565,Enormou,8.592123914353715e-06,8.79948762826546e-06,9,4,5
4566,Enough,0.00010499156295344414,8.816741525575797e-05,109,53,56
4567,Enraged,6.496483935243052e-06,1.7253897310324457e-07,3,3,0
4568,Enrique,1.6974683830796368e-05,1.3975656821362803e-05,22,14,8
4569,Enroll,2.3052039770217305e-06,3.6233184351681345e-06,4,1,3
4570,Enrollment,2.326160376812834e-05,1.742643628342769e-05,24,13,11
4571,Ensue,2.3052039770217305e-06,3.6233184351681345e-06,4,1,3
4572,Ensure,6.496483935243052e-06,1.2250267090330355e-05,11,4,7
4573,Ensuring,4.400843956132392e-06,1.8979287041356905e-06,3,2,1
4574,Enter,3.583544364279237e-05,3.122955413168725e-05,37,19,18
4575,Entered,2.3052039770217305e-06,7.074097897233022e-06,5,1,4
4576,Entering,4.400843956132392e-06,1.7253897310324457e-07,6,6,0
4577,Enterprise,8.592123914353715e-06,8.79948762826546e-06,9,4,5
4578,Entertainer,2.095639979110664e-07,5.348708166200577e-06,3,0,3
4579,Entertainment,4.400843956132392e-06,5.348708166200577e-06,7,3,4
4580,Enthusiasm,4.400843956132392e-06,5.348708166200577e-06,7,2,5
4581,Entire,2.5357243747239038e-05,5.020884117304414e-05,44,14,30
4582,Entirely,2.3052039770217305e-06,8.79948762826546e-06,7,1,6
4583,Entitled,2.3052039770217305e-06,1.8979287041356905e-06,4,2,2
4584,Entitlement,2.3052039770217305e-06,1.8979287041356905e-06,4,1,3
4585,Entrance,2.095639979110664e-07,3.6233184351681345e-06,3,0,3
4586,Entrepreneur,4.212236358012434e-05,3.640572332478458e-05,45,22,23
4587,Entrepreneurial,6.496483935243052e-06,1.052487735929791e-05,9,3,6
4588,Entrepreneurship,1.48790438516857e-05,1.570104655239525e-05,17,8,9
4589,Entry,2.326160376812834e-05,1.570104655239525e-05,21,11,10
4590,Environment,4.6313643538345614e-05,3.122955413168725e-05,41,22,19
4591,Environmental,7.355696326678427e-05,7.436429740749831e-05,83,36,47
4592,Environmentalist,2.326160376812834e-05,2.2602605476525032e-05,27,11,16
4593,Envoy,2.954852370546031e-05,5.348708166200577e-06,18,14,4
4594,EpiPen,8.592123914353715e-06,3.6233184351681345e-06,7,5,2
4595,Epic,2.116596378901769e-05,2.087721574549256e-05,24,10,14
4596,Epidemic,4.6313643538345614e-05,4.1581892517881935e-05,52,25,27
4597,Episode,1.278340387257504e-05,1.052487735929791e-05,13,6,7
4598,Epstein,1.48790438516857e-05,1.570104655239525e-05,17,8,9
4599,Equal,4.002672360101368e-05,3.985650278684949e-05,48,21,27
4600,Equality,4.6313643538345614e-05,6.056117955923882e-05,61,24,37
4601,Equally,2.3052039770217305e-06,3.6233184351681345e-06,3,1,2
4602,Equating,4.400843956132392e-06,1.7253897310324457e-07,3,3,0
4603,Equifax,2.116596378901769e-05,1.742643628342769e-05,21,11,10
4604,Equipment,4.400843956132392e-06,7.074097897233022e-06,6,2,4
4605,Equity,1.0687763893464371e-05,1.052487735929791e-05,13,6,7
4606,Equivalent,4.400843956132392e-06,7.074097897233022e-06,6,2,4
4607,Era,3.7931083621902995e-05,3.2954943862719716e-05,45,23,22
4608,Eradicate,4.400843956132392e-06,3.6233184351681345e-06,4,2,2
4609,Eradicated,2.095639979110664e-07,7.074097897233022e-06,4,0,4
4610,Erase,8.592123914353715e-06,1.052487735929791e-05,11,5,6
4611,Erbil,4.400843956132392e-06,1.8979287041356905e-06,3,2,1
4612,Erdoan,3.583544364279237e-05,2.4327995207557487e-05,35,17,18
4613,Erdogan,0.00012385232276544028,0.00012094982014537423,140,62,78
4614,Eric,8.822644312055891e-05,0.0001485560558418934,138,48,90
4615,Erica,6.496483935243052e-06,5.348708166200577e-06,6,3,3
4616,Erickson,4.400843956132392e-06,1.8979287041356905e-06,3,2,1
4617,Erik,8.592123914353715e-06,1.052487735929791e-05,10,4,6
4618,Erika,6.496483935243052e-06,3.6233184351681345e-06,5,3,2
4619,Eritrea,2.3052039770217305e-06,7.074097897233022e-06,5,1,4
4620,Eritrean,2.3052039770217305e-06,7.074097897233022e-06,5,1,4
4621,Ernest,6.496483935243052e-06,3.6233184351681345e-06,5,3,2
4622,Ernst,1.0687763893464371e-05,1.9151826014460126e-05,19,6,13
4623,Error,2.116596378901769e-05,1.9151826014460126e-05,23,11,12
4624,Erupt,2.5357243747239038e-05,2.9504164400654783e-05,37,13,24
4625,Eruption,6.496483935243052e-06,7.074097897233022e-06,7,3,4
4626,Escalate,6.496483935243052e-06,1.3975656821362803e-05,11,3,8
4627,Escalating,6.496483935243052e-06,1.7253897310324457e-07,3,3,0
4628,Escalation,2.3052039770217305e-06,5.348708166200577e-06,4,1,3
4629,Escape,8.592123914353715e-06,2.777877466962238e-05,20,4,16
4630,Escaped,8.592123914353715e-06,1.052487735929791e-05,10,4,6
4631,Escaping,2.3052039770217305e-06,8.79948762826546e-06,6,1,5
4632,Escobar,2.3052039770217305e-06,3.6233184351681345e-06,3,1,2
4633,Escort,2.3052039770217305e-06,7.074097897233022e-06,6,2,4
4634,Escorting,4.400843956132392e-06,1.8979287041356905e-06,3,2,1
4635,Especially,2.116596378901769e-05,1.2250267090330355e-05,21,13,8
4636,Espionage,8.592123914353715e-06,1.3975656821362803e-05,12,4,8
4637,Essay,4.400843956132392e-06,7.074097897233022e-06,7,3,4
4638,Essential,2.326160376812834e-05,1.2250267090330355e-05,20,12,8
4639,Essentially,2.3052039770217305e-06,5.348708166200577e-06,5,2,3
4640,Establish,4.400843956132392e-06,1.8979287041356905e-06,3,2,1
4641,Establishment,2.5357243747239038e-05,1.570104655239525e-05,26,14,12
4642,Estate,2.954852370546031e-05,1.742643628342769e-05,25,14,11
4643,Estemirovum,4.400843956132392e-06,3.6233184351681345e-06,5,3,2
4644,Estimate,1.9070323809907035e-05,8.79948762826546e-06,14,9,5
4645,Estimated,2.3052039770217305e-06,1.8979287041356905e-06,3,2,1
4646,Estonia,2.326160376812834e-05,2.2602605476525032e-05,25,11,14
4647,Estonian,4.400843956132392e-06,1.052487735929791e-05,8,2,6
4648,Et,2.3052039770217305e-06,1.8979287041356905e-06,3,1,2
4649,Eta,4.400843956132392e-06,1.8979287041356905e-06,3,2,1
4650,Ethic,7.984388320411623e-05,8.989280498679035e-05,99,39,60
4651,Ethical,1.48790438516857e-05,1.570104655239525e-05,19,7,12
4652,Ethically,2.095639979110664e-07,3.6233184351681345e-06,3,1,2
4653,Ethiopia,1.48790438516857e-05,4.6758061710979285e-05,40,9,31
4654,Ethiopian,2.326160376812834e-05,2.777877466962238e-05,29,11,18
4655,Ethnic,1.9070323809907035e-05,1.570104655239525e-05,22,10,12
4656,Ethnicity,2.095639979110664e-07,3.6233184351681345e-06,3,0,3
4657,Etiquette,4.400843956132392e-06,5.348708166200577e-06,7,3,4
4658,Etna,2.3052039770217305e-06,3.6233184351681345e-06,3,1,2
4659,Etsy,2.3052039770217305e-06,5.348708166200577e-06,5,1,4
4660,Eugene,6.496483935243052e-06,7.074097897233022e-06,7,3,4
4661,Eulogy,2.3052039770217305e-06,3.6233184351681345e-06,4,1,3
4662,Eurasian,8.592123914353715e-06,8.79948762826546e-06,9,4,5
4663,Euro,6.307876337123095e-05,7.091351794543343e-05,77,33,44
4664,Eurogroup,2.3052039770217305e-06,1.8979287041356905e-06,3,1,2
4665,Europa,2.095639979110664e-07,8.79948762826546e-06,5,0,5
4666,Europe,0.0006205189978146674,0.0006040589448344588,736,333,403
4667,European,0.0006247102777728885,0.0005902558269861991,705,330,375
4668,Eurovision,2.095639979110664e-07,5.348708166200577e-06,6,0,6
4669,Eurozone,6.496483935243052e-06,2.2602605476525032e-05,19,4,15
4670,Eva,4.400843956132392e-06,1.8979287041356905e-06,3,2,1
4671,Evacuate,2.3052039770217305e-06,5.348708166200577e-06,4,1,3
4672,Evacuated,4.400843956132392e-06,8.79948762826546e-06,8,2,6
4673,Evacuation,2.3052039770217305e-06,3.6233184351681345e-06,3,1,2
4674,Evacuee,2.3052039770217305e-06,7.074097897233022e-06,5,1,4
4675,Evade,4.400843956132392e-06,3.6233184351681345e-06,4,2,2
4676,Evading,2.3052039770217305e-06,3.6233184351681345e-06,3,1,2
4677,Evaluate,6.496483935243052e-06,5.348708166200577e-06,6,3,3
4678,Evaluation,2.3052039770217305e-06,3.6233184351681345e-06,3,1,2
4679,Evan,2.954852370546031e-05,1.742643628342769e-05,26,16,10
4680,Evangelical,1.6974683830796368e-05,2.2602605476525032e-05,24,9,15
4681,Evangelist,4.400843956132392e-06,3.6233184351681345e-06,4,2,2
4682,Evasion,6.496483935243052e-06,7.074097897233022e-06,8,3,5
4683,Eve,3.7931083621902995e-05,1.570104655239525e-05,34,25,9
4684,Evelyn,6.496483935243052e-06,1.7253897310324457e-07,3,3,0
4685,Even,0.00040466807996626886,0.0004056391257657278,472,213,259
4686,Evening,4.400843956132392e-06,7.074097897233022e-06,7,2,5
4687,Event,7.355696326678427e-05,6.228656929027126e-05,84,42,42
4688,Eventually,1.48790438516857e-05,1.8979287041356905e-06,8,7,1
4689,Ever,0.00014690436253565753,0.00016235917369015308,177,75,102
4690,Everest,2.7452883726349685e-05,2.777877466962238e-05,29,13,16
4691,Every,0.00021186920188808795,0.00021584625535215864,257,115,142
4692,Everybody,1.9070323809907035e-05,3.2954943862719716e-05,30,11,19
4693,Everyday,6.496483935243052e-06,1.9151826014460126e-05,14,3,11
4694,Everyone,0.0001154697628489974,0.00011232287149021227,142,70,72
4695,Everything,9.660900303700153e-05,0.00010542131256608228,113,46,67
4696,Everytown,2.3052039770217305e-06,5.348708166200577e-06,4,1,3
4697,Everywhere,1.278340387257504e-05,1.9151826014460126e-05,19,7,12
4698,Evicted,2.3052039770217305e-06,1.8979287041356905e-06,3,2,1
4699,Eviction,8.592123914353715e-06,8.79948762826546e-06,11,5,6
4700,Evidence,8.193952318322689e-05,9.851975364195259e-05,103,41,62
4701,Evidently,2.095639979110664e-07,5.348708166200577e-06,4,0,4
4702,Evil,1.0687763893464371e-05,2.2602605476525032e-05,20,6,14
4703,Eviscerate,6.496483935243052e-06,3.6233184351681345e-06,6,3,3
4704,Evo,8.592123914353715e-06,1.9151826014460126e-05,15,4,11
4705,Evoke,2.095639979110664e-07,3.6233184351681345e-06,3,0,3
4706,Evolution,1.278340387257504e-05,2.4327995207557487e-05,22,6,16
4707,Evolutionary,2.095639979110664e-07,1.8979287041356905e-06,3,0,3
4708,Evolve,2.3052039770217305e-06,5.348708166200577e-06,4,1,3
4709,Evolving,4.400843956132392e-06,1.8979287041356905e-06,3,2,1
4710,Ewok,2.3052039770217305e-06,3.6233184351681345e-06,3,1,2
4711,Ex,2.3052039770217305e-06,8.79948762826546e-06,6,1,5
4712,ExBush,2.3052039770217305e-06,1.8979287041356905e-06,3,1,2
4713,ExCIA,6.496483935243052e-06,5.348708166200577e-06,7,3,4
4714,ExCop,6.496483935243052e-06,5.348708166200577e-06,6,3,3
4715,ExEmployee,2.3052039770217305e-06,1.7253897310324457e-07,3,2,1
4716,ExFBI,2.095639979110664e-07,7.074097897233022e-06,4,0,4
4717,ExFelon,2.095639979110664e-07,3.6233184351681345e-06,3,1,2
4718,ExGOP,4.400843956132392e-06,1.8979287041356905e-06,3,2,1
4719,ExMossad,6.496483935243052e-06,1.7253897310324457e-07,3,3,0
4720,ExOffender,8.592123914353715e-06,5.348708166200577e-06,8,5,3
4721,ExPlayboy,6.496483935243052e-06,1.7253897310324457e-07,3,3,0
4722,ExPresident,4.400843956132392e-06,5.348708166200577e-06,5,2,3
4723,ExTrump,1.6974683830796368e-05,1.570104655239525e-05,21,10,11
4724,ExWife,2.3052039770217305e-06,5.348708166200577e-06,5,1,4
4725,Exact,2.3052039770217305e-06,5.348708166200577e-06,4,1,3
4726,Exactly,1.9070323809907035e-05,2.4327995207557487e-05,26,10,16
4727,Exaggerate,4.400843956132392e-06,1.7253897310324457e-07,3,2,1
4728,Exaggeration,4.400843956132392e-06,1.8979287041356905e-06,3,2,1
4729,Exam,2.3052039770217305e-06,5.348708166200577e-06,4,1,3
4730,Examiner,2.095639979110664e-07,5.348708166200577e-06,3,0,3
4731,Examining,2.095639979110664e-07,5.348708166200577e-06,4,0,4
4732,Example,1.0687763893464371e-05,1.570104655239525e-05,14,5,9
4733,Exceed,8.592123914353715e-06,1.8979287041356905e-06,6,5,1
4734,Excellent,6.496483935243052e-06,1.9151826014460126e-05,16,4,12
4735,Except,2.7452883726349685e-05,2.2602605476525032e-05,30,14,16
4736,Exception,6.496483935243052e-06,1.8979287041356905e-06,4,3,1
4737,Exceptional,4.400843956132392e-06,7.074097897233022e-06,6,2,4
4738,ExceptionalCareer,6.496483935243052e-06,1.8979287041356905e-06,4,3,1
4739,Exceptionalism,2.3052039770217305e-06,7.074097897233022e-06,7,3,4
4740,Excerpt,8.592123914353715e-06,1.8979287041356905e-06,5,4,1
4741,Exces,2.3052039770217305e-06,5.348708166200577e-06,4,1,3
4742,Excessive,1.278340387257504e-05,7.074097897233022e-06,11,7,4
4743,Exchange,4.212236358012434e-05,4.330728224891437e-05,48,20,28
4744,Excited,8.592123914353715e-06,1.2250267090330355e-05,12,5,7
4745,Exciting,4.400843956132392e-06,1.8979287041356905e-06,4,2,2
4746,Exclude,4.400843956132392e-06,1.8979287041356905e-06,3,2,1
4747,Exclusion,1.278340387257504e-05,3.6233184351681345e-06,8,6,2
4748,Exclusive,4.840928351745632e-05,2.777877466962238e-05,42,25,17
4749,Excuse,1.278340387257504e-05,2.2602605476525032e-05,21,7,14
4750,Exec,1.278340387257504e-05,3.640572332478458e-05,34,7,27
4751,Execute,8.592123914353715e-06,3.2954943862719716e-05,26,5,21
4752,Executed,2.3052039770217305e-06,1.3975656821362803e-05,11,3,8
4753,Executing,4.400843956132392e-06,5.348708166200577e-06,5,2,3
4754,Execution,2.7452883726349685e-05,4.50326719799468e-05,49,17,32
4755,Executive,0.00013223488268188294,0.00010714670229711469,137,69,68
4756,Exempt,4.400843956132392e-06,7.074097897233022e-06,6,2,4
4757,Exemption,4.400843956132392e-06,3.6233184351681345e-06,4,2,2
4758,Exercise,1.6974683830796368e-05,1.3975656821362803e-05,18,10,8
4759,Exercising,4.400843956132392e-06,3.6233184351681345e-06,4,2,2
4760,Exhausting,2.095639979110664e-07,5.348708166200577e-06,3,0,3
4761,Exhibit,8.592123914353715e-06,8.79948762826546e-06,9,4,5
4762,Exile,8.592123914353715e-06,3.6233184351681345e-06,7,5,2
4763,Exiled,4.400843956132392e-06,3.6233184351681345e-06,4,2,2
4764,Exist,2.326160376812834e-05,3.2954943862719716e-05,34,14,20
4765,Existed,4.400843956132392e-06,7.074097897233022e-06,7,2,5
4766,Existence,2.3052039770217305e-06,5.348708166200577e-06,4,1,3
4767,Existential,2.3052039770217305e-06,7.074097897233022e-06,5,1,4
4768,Existing,2.3052039770217305e-06,8.79948762826546e-06,6,1,5
4769,Exit,4.212236358012434e-05,2.9504164400654783e-05,43,25,18
4770,Exiting,2.3052039770217305e-06,5.348708166200577e-06,4,1,3
4771,Expand,4.212236358012434e-05,5.1934230904076595e-05,55,24,31
4772,Expanded,8.592123914353715e-06,5.348708166200577e-06,8,5,3
4773,Expanding,6.496483935243052e-06,2.777877466962238e-05,20,3,17
4774,Expansion,2.326160376812834e-05,2.4327995207557487e-05,29,11,18
4775,Expat,6.496483935243052e-06,3.6233184351681345e-06,6,3,3
4776,Expect,5.260056347567764e-05,4.330728224891437e-05,59,32,27
4777,Expectancy,6.496483935243052e-06,3.6233184351681345e-06,5,3,2
4778,Expectation,1.9070323809907035e-05,1.9151826014460126e-05,21,10,11
4779,Expected,3.3739803663681634e-05,3.2954943862719716e-05,43,21,22
4780,Expecting,4.400843956132392e-06,5.348708166200577e-06,5,2,3
4781,Expel,1.6974683830796368e-05,8.79948762826546e-06,13,8,5
4782,Expelled,2.3052039770217305e-06,3.6233184351681345e-06,4,1,3
4783,Expense,1.6974683830796368e-05,1.052487735929791e-05,15,8,7
4784,Expensive,2.954852370546031e-05,3.640572332478458e-05,42,18,24
4785,Experience,2.326160376812834e-05,2.6053384938589907e-05,28,11,17
4786,Experienced,2.3052039770217305e-06,3.6233184351681345e-06,4,2,2
4787,Experiment,1.9070323809907035e-05,1.9151826014460126e-05,20,9,11
4788,Experimental,6.496483935243052e-06,8.79948762826546e-06,8,3,5
4789,Expert,0.00014271308257743603,0.00014337988664879628,164,73,91
4790,Expire,2.095639979110664e-07,5.348708166200577e-06,3,0,3
4791,Explain,0.00010708720293255492,6.918812821440096e-05,106,61,45
4792,Explained,1.6974683830796368e-05,1.742643628342769e-05,20,9,11
4793,Explainer,6.496483935243052e-06,1.8979287041356905e-06,4,3,1
4794,Explanation,8.592123914353715e-06,1.052487735929791e-05,10,4,6
4795,Explicit,6.496483935243052e-06,7.074097897233022e-06,7,3,4
4796,Explicitly,6.496483935243052e-06,1.8979287041356905e-06,4,3,1
4797,Explode,3.3739803663681634e-05,1.3975656821362803e-05,27,17,10
4798,Exploded,4.400843956132392e-06,3.6233184351681345e-06,4,2,2
4799,Exploding,6.496483935243052e-06,5.348708166200577e-06,7,4,3
4800,Exploit,1.278340387257504e-05,3.6233184351681345e-06,8,6,2
4801,Exploitation,2.3052039770217305e-06,5.348708166200577e-06,5,1,4
4802,Exploited,4.400843956132392e-06,1.8979287041356905e-06,3,2,1
4803,Exploiting,8.592123914353715e-06,1.8979287041356905e-06,5,4,1
4804,Exploration,1.48790438516857e-05,8.79948762826546e-06,13,8,5
4805,Explore,1.0687763893464371e-05,8.79948762826546e-06,13,6,7
4806,Explored,8.592123914353715e-06,3.6233184351681345e-06,7,4,3
4807,Explorer,4.400843956132392e-06,3.6233184351681345e-06,4,2,2
4808,Exploring,1.0687763893464371e-05,1.052487735929791e-05,11,5,6
4809,Explosion,3.7931083621902995e-05,4.330728224891437e-05,55,24,31
4810,Explosive,2.326160376812834e-05,2.4327995207557487e-05,27,12,15
4811,Export,1.9070323809907035e-05,1.3975656821362803e-05,22,12,10
4812,ExportImport,1.0687763893464371e-05,1.052487735929791e-05,11,5,6
4813,Exporter,2.3052039770217305e-06,3.6233184351681345e-06,3,1,2
4814,Exporting,2.3052039770217305e-06,3.6233184351681345e-06,3,1,2
4815,Expose,2.954852370546031e-05,3.8131113055817005e-05,39,15,24
4816,Exposed,2.954852370546031e-05,3.8131113055817005e-05,41,17,24
4817,Exposing,2.3052039770217305e-06,5.348708166200577e-06,7,4,3
4818,Exposure,4.400843956132392e-06,1.7253897310324457e-07,3,3,0
4819,Expres,2.326160376812834e-05,2.6053384938589907e-05,26,11,15
4820,Express,2.3052039770217305e-06,5.348708166200577e-06,4,1,3
4821,Expression,8.592123914353715e-06,5.348708166200577e-06,8,4,4
4822,Expulsion,2.3052039770217305e-06,3.6233184351681345e-06,3,1,2
4823,Exsoldier,2.3052039770217305e-06,1.8979287041356905e-06,3,2,1
4824,Extend,3.3739803663681634e-05,1.9151826014460126e-05,28,16,12
4825,Extension,8.592123914353715e-06,8.79948762826546e-06,14,5,9
4826,Extensive,6.496483935243052e-06,7.074097897233022e-06,8,3,5
4827,Extent,4.400843956132392e-06,3.6233184351681345e-06,4,2,2
4828,Extinct,6.496483935243052e-06,1.052487735929791e-05,10,4,6
4829,Extinction,1.9070323809907035e-05,2.087721574549256e-05,22,10,12
4830,Extortion,8.592123914353715e-06,1.7253897310324457e-07,5,4,1
4831,Extra,1.0687763893464371e-05,2.4327995207557487e-05,22,7,15
4832,Extradite,2.3052039770217305e-06,5.348708166200577e-06,5,2,3
4833,Extradition,1.0687763893464371e-05,1.3975656821362803e-05,13,5,8
4834,Extramarital,2.3052039770217305e-06,3.6233184351681345e-06,3,1,2
4835,Extraordinary,4.400843956132392e-06,1.052487735929791e-05,9,2,7
4836,Extreme,2.954852370546031e-05,4.1581892517881935e-05,42,17,25
4837,Extremely,6.496483935243052e-06,1.052487735929791e-05,10,4,6
4838,Extremism,1.6974683830796368e-05,1.2250267090330355e-05,16,9,7
4839,Extremist,3.583544364279237e-05,4.1581892517881935e-05,46,21,25
4840,Exwife,2.3052039770217305e-06,1.7253897310324457e-07,4,4,0
4841,Exxon,8.193952318322689e-05,5.5385010366141504e-05,80,41,39
4842,ExxonMobil,1.48790438516857e-05,2.2602605476525032e-05,21,7,14
4843,Eye,4.840928351745632e-05,7.954046660059569e-05,76,25,51
4844,EyeOpening,2.3052039770217305e-06,3.6233184351681345e-06,3,1,2
4845,Eyeing,4.400843956132392e-06,5.348708166200577e-06,6,2,4
4846,Eyewitnes,4.400843956132392e-06,1.8979287041356905e-06,3,2,1
4847,Eyjafjallajokull,4.400843956132392e-06,1.8979287041356905e-06,3,2,1
4848,Ezra,2.3052039770217305e-06,1.8979287041356905e-06,4,1,3
4849,Ezzor,4.400843956132392e-06,1.7253897310324457e-07,3,2,1
4850,F15,2.3052039770217305e-06,1.8979287041356905e-06,3,2,1
4851,F16,2.116596378901769e-05,2.6053384938589907e-05,26,10,16
4852,F22,8.592123914353715e-06,5.348708166200577e-06,7,4,3
4853,F35,2.116596378901769e-05,2.087721574549256e-05,22,10,12
4854,FAA,4.400843956132392e-06,8.79948762826546e-06,9,3,6
4855,FAKE,4.400843956132392e-06,3.6233184351681345e-06,4,2,2
4856,FARC,1.0687763893464371e-05,7.074097897233022e-06,9,5,4
4857,FBI,0.0004801111192142529,0.00040736451549676014,504,239,265
4858,FCC,4.002672360101368e-05,5.5385010366141504e-05,55,19,36
4859,FDA,2.954852370546031e-05,3.122955413168725e-05,36,15,21
4860,FDIC,8.592123914353715e-06,3.6233184351681345e-06,6,4,2
4861,FDR,8.592123914353715e-06,8.79948762826546e-06,9,4,5
4862,FEC,8.592123914353715e-06,7.074097897233022e-06,9,5,4
4863,FEMA,1.0687763893464371e-05,1.9151826014460126e-05,17,6,11
4864,FGM,1.48790438516857e-05,1.052487735929791e-05,15,8,7
4865,FHA,6.496483935243052e-06,1.7253897310324457e-07,5,5,0
4866,FICO,1.48790438516857e-05,5.348708166200577e-06,11,8,3
4867,FIFA,6.098312339212028e-05,3.468033359375216e-05,52,31,21
4868,FINALLY,2.3052039770217305e-06,3.6233184351681345e-06,3,1,2
4869,FIRST,2.3052039770217305e-06,3.6233184351681345e-06,3,1,2
4870,FISA,6.496483935243052e-06,1.8979287041356905e-06,5,4,1
4871,FLOTU,4.400843956132392e-06,1.7253897310324457e-07,3,3,0
4872,FM,2.954852370546031e-05,1.9151826014460126e-05,27,16,11
4873,FOI,2.3052039770217305e-06,3.6233184351681345e-06,3,1,2
4874,FOIA,6.496483935243052e-06,8.79948762826546e-06,10,4,6
4875,FOMO,2.3052039770217305e-06,5.348708166200577e-06,4,1,3
4876,FOUND,2.3052039770217305e-06,3.6233184351681345e-06,4,1,3
4877,FOX,4.400843956132392e-06,1.8979287041356905e-06,4,2,2
4878,FP,4.400843956132392e-06,1.8979287041356905e-06,3,2,1
4879,FRANCISCO,4.400843956132392e-06,5.348708166200577e-06,7,3,4
4880,FRONTLINE,2.095639979110664e-07,5.348708166200577e-06,3,0,3
4881,FSA,4.400843956132392e-06,1.052487735929791e-05,11,3,8
4882,FSB,2.116596378901769e-05,5.348708166200577e-06,14,11,3
4883,FT,4.400843956132392e-06,1.7253897310324457e-07,3,3,0
4884,FTC,8.592123914353715e-06,1.2250267090330355e-05,13,5,8
4885,FTSE,4.400843956132392e-06,1.8979287041356905e-06,3,2,1
4886,FTW,2.095639979110664e-07,3.6233184351681345e-06,4,1,3
4887,FUCKING,4.400843956132392e-06,3.6233184351681345e-06,4,2,2
4888,Fabric,2.3052039770217305e-06,1.8979287041356905e-06,3,1,2
4889,Face,0.00029779044103162505,0.00029176340351758643,350,158,192
4890,FaceTime,4.400843956132392e-06,1.8979287041356905e-06,3,2,1
4891,Facebook,0.0006247102777728885,0.0005229656274759339,662,322,340
4892,Faced,2.116596378901769e-05,2.087721574549256e-05,23,11,12
4893,Facial,1.0687763893464371e-05,5.348708166200577e-06,9,6,3
4894,Facility,3.1644163684570994e-05,2.087721574549256e-05,31,16,15
4895,Facing,5.260056347567764e-05,7.608968713853079e-05,73,25,48
4896,Fact,6.517440335034157e-05,6.918812821440096e-05,78,35,43
4897,FactCheck,1.0687763893464371e-05,7.074097897233022e-06,10,5,5
4898,FactChecker,4.400843956132392e-06,3.6233184351681345e-06,4,2,2
4899,FactChecking,6.496483935243052e-06,5.348708166200577e-06,7,3,4
4900,Faction,4.400843956132392e-06,3.6233184351681345e-06,5,2,3
4901,Facto,4.400843956132392e-06,3.6233184351681345e-06,4,2,2
4902,Factor,1.0687763893464371e-05,1.742643628342769e-05,16,5,11
4903,Factory,3.1644163684570994e-05,3.985650278684949e-05,40,16,24
4904,Faculty,2.3052039770217305e-06,3.6233184351681345e-06,3,1,2
4905,Fahrenheit,4.400843956132392e-06,7.074097897233022e-06,7,3,4
4906,Fail,8.822644312055891e-05,9.161819471782287e-05,104,46,58
4907,Failed,8.403516316233764e-05,5.711040009717395e-05,77,43,34
4908,Failing,4.212236358012434e-05,3.2954943862719716e-05,44,25,19
4909,Failure,5.6791843433898893e-05,5.5385010366141504e-05,69,32,37
4910,Fair,3.7931083621902995e-05,3.985650278684949e-05,49,23,26
4911,FairWarning,2.3052039770217305e-06,1.8979287041356905e-06,3,1,2
4912,Fairfax,2.3052039770217305e-06,3.6233184351681345e-06,3,1,2
4913,Fairnes,4.400843956132392e-06,5.348708166200577e-06,5,2,3
4914,Fairooz,2.3052039770217305e-06,3.6233184351681345e-06,3,1,2
4915,Fairy,4.400843956132392e-06,1.8979287041356905e-06,3,2,1
4916,Faith,4.002672360101368e-05,1.3975656821362803e-05,30,21,9
4917,Fake,0.00011127848289077625,0.00011577365095227703,139,59,80
4918,Faked,2.3052039770217305e-06,1.8979287041356905e-06,3,1,2
4919,Faker,4.400843956132392e-06,1.8979287041356905e-06,3,2,1
4920,Faking,2.095639979110664e-07,8.79948762826546e-06,5,0,5
4921,Falcon,6.496483935243052e-06,1.2250267090330355e-05,11,3,8
4922,Falk,2.3052039770217305e-06,3.6233184351681345e-06,3,1,2
4923,Falkland,2.954852370546031e-05,2.9504164400654783e-05,34,16,18
4924,Falkvinge,8.592123914353715e-06,8.79948762826546e-06,10,5,5
4925,Fall,8.822644312055891e-05,0.00010024514337298497,108,45,63
4926,Fallen,1.48790438516857e-05,1.570104655239525e-05,19,8,11
4927,Fallin,2.095639979110664e-07,3.6233184351681345e-06,3,0,3
4928,Falling,2.326160376812834e-05,2.777877466962238e-05,31,13,18
4929,Fallon,1.0687763893464371e-05,1.8979287041356905e-06,6,5,1
4930,Fallout,2.5357243747239038e-05,1.052487735929791e-05,21,13,8
4931,Falluja,1.278340387257504e-05,3.6233184351681345e-06,8,6,2
4932,Fallujah,1.48790438516857e-05,1.052487735929791e-05,13,7,6
4933,False,4.6313643538345614e-05,3.8131113055817005e-05,50,26,24
4934,Falsehood,8.592123914353715e-06,3.6233184351681345e-06,6,4,2
4935,Falsely,1.48790438516857e-05,1.570104655239525e-05,18,8,10
4936,Falter,2.3052039770217305e-06,5.348708166200577e-06,4,1,3
4937,Falwell,6.496483935243052e-06,5.348708166200577e-06,6,3,3
4938,Fame,4.400843956132392e-06,1.2250267090330355e-05,9,2,7
4939,Famed,4.400843956132392e-06,7.074097897233022e-06,6,2,4
4940,Familia,2.3052039770217305e-06,7.074097897233022e-06,5,1,4
4941,Familiar,2.3052039770217305e-06,7.074097897233022e-06,5,1,4
4942,Family,0.00036694656034227697,0.0003141934700210085,391,187,204
4943,Famine,8.592123914353715e-06,1.052487735929791e-05,11,4,7
4944,Famou,2.954852370546031e-05,1.742643628342769e-05,27,16,11
4945,Fan,5.888748341300963e-05,4.330728224891437e-05,59,30,29
4946,Fancy,1.0687763893464371e-05,5.348708166200577e-06,8,5,3
4947,Fannie,4.400843956132392e-06,1.8979287041356905e-06,3,2,1
4948,Fanning,2.3052039770217305e-06,1.8979287041356905e-06,3,2,1
4949,Fantasy,1.6974683830796368e-05,1.9151826014460126e-05,19,8,11
4950,Far,9.03220830996695e-05,8.126585633162811e-05,97,45,52
4951,FarRight,1.6974683830796368e-05,1.2250267090330355e-05,15,8,7
4952,Farage,2.116596378901769e-05,1.2250267090330355e-05,18,10,8
4953,Farc,6.496483935243052e-06,1.7253897310324457e-07,4,3,1
4954,Farce,4.400843956132392e-06,5.348708166200577e-06,5,2,3
4955,Fareed,2.3052039770217305e-06,5.348708166200577e-06,5,1,4
4956,Farenthold,1.278340387257504e-05,2.2602605476525032e-05,19,6,13
4957,Farewell,1.48790438516857e-05,7.074097897233022e-06,13,9,4
4958,Fargo,5.260056347567764e-05,3.2954943862719716e-05,47,25,22
4959,Farm,3.7931083621902995e-05,5.3659620635109e-05,55,22,33
4960,Farmer,6.307876337123095e-05,6.056117955923882e-05,69,32,37
4961,Farming,6.496483935243052e-06,7.074097897233022e-06,9,3,6
4962,Farmworker,6.496483935243052e-06,3.6233184351681345e-06,6,3,3
4963,Farr,2.3052039770217305e-06,1.8979287041356905e-06,3,1,2
4964,Farrakhan,4.400843956132392e-06,1.8979287041356905e-06,3,2,1
4965,Farright,4.400843956132392e-06,7.074097897233022e-06,6,2,4
4966,Fascinating,8.592123914353715e-06,5.348708166200577e-06,7,4,3
4967,Fascism,6.496483935243052e-06,1.052487735929791e-05,11,3,8
4968,Fascist,6.496483935243052e-06,1.052487735929791e-05,12,5,7
4969,Fashion,1.0687763893464371e-05,1.2250267090330355e-05,14,5,9
4970,Faso,6.496483935243052e-06,1.8979287041356905e-06,11,9,2
4971,Fast,6.936568330856297e-05,4.8483451442011706e-05,66,34,32
4972,FastFood,2.095639979110664e-07,7.074097897233022e-06,4,0,4
4973,FastTrack,2.095639979110664e-07,5.348708166200577e-06,4,1,3
4974,Faster,1.48790438516857e-05,1.570104655239525e-05,19,9,10
4975,Fastest,8.592123914353715e-06,1.3975656821362803e-05,15,4,11
4976,FastestGrowing,2.3052039770217305e-06,3.6233184351681345e-06,3,1,2
4977,Fastfood,4.400843956132392e-06,3.6233184351681345e-06,4,2,2
4978,Fat,2.326160376812834e-05,1.742643628342769e-05,23,12,11
4979,Fatah,1.0687763893464371e-05,1.9151826014460126e-05,16,5,11
4980,Fatal,1.6974683830796368e-05,2.9504164400654783e-05,29,9,20
4981,Fatally,6.496483935243052e-06,3.6233184351681345e-06,5,3,2
4982,Fate,2.116596378901769e-05,2.6053384938589907e-05,28,11,17
4983,Father,0.00010080028299522283,0.00011577365095227703,130,54,76
4984,Fatigue,2.095639979110664e-07,1.8979287041356905e-06,3,1,2
4985,Fattah,1.278340387257504e-05,3.6233184351681345e-06,8,6,2
4986,Fatwa,2.3052039770217305e-06,8.79948762826546e-06,6,1,5
4987,Fauci,8.592123914353715e-06,1.9151826014460126e-05,16,4,12
4988,Fault,8.592123914353715e-06,5.348708166200577e-06,9,5,4
4989,Faulty,2.095639979110664e-07,7.074097897233022e-06,6,1,5
4990,Favor,3.3739803663681634e-05,3.2954943862719716e-05,38,17,21
4991,Favorability,2.3052039770217305e-06,5.348708166200577e-06,5,1,4
4992,Favorably,4.400843956132392e-06,1.8979287041356905e-06,3,2,1
4993,Favored,2.3052039770217305e-06,5.348708166200577e-06,4,1,3
4994,Favoring,4.400843956132392e-06,3.6233184351681345e-06,4,2,2
4995,Favorite,4.840928351745632e-05,3.640572332478458e-05,48,25,23
4996,Fawke,2.3052039770217305e-06,5.348708166200577e-06,4,1,3
4997,Fawning,6.496483935243052e-06,1.7253897310324457e-07,3,3,0
4998,Fe,4.400843956132392e-06,5.348708166200577e-06,6,2,4
4999,Fear,0.00016366948236854273,0.00015028144557292604,178,82,96
5000,Feared,4.400843956132392e-06,1.3975656821362803e-05,12,2,10
5001,Fearing,6.496483935243052e-06,1.052487735929791e-05,12,4,8
5002,Fearles,4.400843956132392e-06,3.6233184351681345e-06,4,2,2
5003,Fearmongering,2.3052039770217305e-06,1.8979287041356905e-06,4,1,3
5004,Feather,2.3052039770217305e-06,3.6233184351681345e-06,3,1,2
5005,Feature,2.7452883726349685e-05,2.9504164400654783e-05,36,16,20
5006,Featuring,4.400843956132392e-06,7.074097897233022e-06,6,2,4
5007,Feb,2.116596378901769e-05,3.2954943862719716e-05,33,12,21
5008,February,9.03220830996695e-05,8.4716635793693e-05,101,48,53
5009,Fece,2.095639979110664e-07,5.348708166200577e-06,3,0,3
5010,Fed,0.0001741476822640959,0.00014683066611086105,188,93,95
5011,FedEx,8.592123914353715e-06,7.074097897233022e-06,9,5,4
5012,Federal,0.0003459901605511704,0.00040391373603469537,443,184,259
5013,Federation,6.496483935243052e-06,1.9151826014460126e-05,15,3,12
5014,Fee,6.517440335034157e-05,4.6758061710979285e-05,65,35,30
5015,Feed,2.326160376812834e-05,2.2602605476525032e-05,26,12,14
5016,Feedback,2.3052039770217305e-06,3.6233184351681345e-06,4,1,3
5017,Feeding,1.0687763893464371e-05,3.6233184351681345e-06,8,5,3
5018,Feel,5.888748341300963e-05,7.608968713853079e-05,77,28,49
5019,Feeling,3.1644163684570994e-05,1.742643628342769e-05,29,15,14
5020,Fein,8.592123914353715e-06,3.6233184351681345e-06,6,4,2
5021,Feingold,8.592123914353715e-06,5.348708166200577e-06,9,5,4
5022,Feinstein,1.6974683830796368e-05,1.742643628342769e-05,23,10,13
5023,Feldman,2.3052039770217305e-06,7.074097897233022e-06,5,1,4
5024,Feline,2.3052039770217305e-06,3.6233184351681345e-06,4,1,3
5025,Felipe,8.592123914353715e-06,1.052487735929791e-05,11,4,7
5026,Felix,1.278340387257504e-05,1.8979287041356905e-06,7,6,1
5027,Fell,6.496483935243052e-06,3.6233184351681345e-06,5,3,2
5028,Fellow,1.48790438516857e-05,2.6053384938589907e-05,23,8,15
5029,Felon,1.9070323809907035e-05,8.79948762826546e-06,17,11,6
5030,Felony,1.278340387257504e-05,3.122955413168725e-05,26,7,19
5031,Felt,1.278340387257504e-05,8.79948762826546e-06,11,6,5
5032,Female,0.00011756540282810809,0.00012094982014537423,152,65,87
5033,Feman,2.3052039770217305e-06,8.79948762826546e-06,6,1,5
5034,Feminist,1.48790438516857e-05,1.9151826014460126e-05,20,9,11
5035,Fence,8.592123914353715e-06,8.79948762826546e-06,11,6,5
5036,Fend,2.3052039770217305e-06,7.074097897233022e-06,5,1,4
5037,Fentanyl,2.3052039770217305e-06,1.052487735929791e-05,7,1,6
5038,Feral,2.3052039770217305e-06,7.074097897233022e-06,5,1,4
5039,Ferguson,0.00011127848289077625,0.00012612598933847184,144,60,84
5040,Fern,6.496483935243052e-06,1.8979287041356905e-06,4,3,1
5041,Fernandez,6.496483935243052e-06,1.8979287041356905e-06,5,3,2
5042,Fernando,2.095639979110664e-07,1.8979287041356905e-06,3,0,3
5043,Fernndez,6.496483935243052e-06,1.7253897310324457e-07,3,3,0
5044,Ferrari,8.592123914353715e-06,1.2250267090330355e-05,11,4,7
5045,Ferreira,2.095639979110664e-07,5.348708166200577e-06,3,0,3
5046,Ferrero,4.400843956132392e-06,1.8979287041356905e-06,3,2,1
5047,Ferry,4.400843956132392e-06,5.348708166200577e-06,5,2,3
5048,Fertility,4.400843956132392e-06,1.8979287041356905e-06,4,3,1
5049,Fest,4.400843956132392e-06,3.6233184351681345e-06,5,2,3
5050,Festival,1.6974683830796368e-05,2.087721574549256e-05,23,10,13
5051,Festivu,2.095639979110664e-07,1.052487735929791e-05,6,0,6
5052,Fetal,1.0687763893464371e-05,8.79948762826546e-06,10,5,5
5053,Fetch,2.3052039770217305e-06,1.052487735929791e-05,7,1,6
5054,Fetterman,8.592123914353715e-06,3.6233184351681345e-06,6,4,2
5055,Fetus,2.3052039770217305e-06,3.6233184351681345e-06,3,1,2
5056,Feud,1.48790438516857e-05,2.6053384938589907e-05,24,8,16
5057,Feuding,2.3052039770217305e-06,3.6233184351681345e-06,3,1,2
5058,Fever,4.400843956132392e-06,7.074097897233022e-06,8,2,6
5059,Fewer,3.3739803663681634e-05,5.020884117304414e-05,51,20,31
5060,Fiasco,8.592123914353715e-06,8.79948762826546e-06,9,4,5
5061,Fiat,6.496483935243052e-06,5.348708166200577e-06,6,3,3
5062,Fiber,6.496483935243052e-06,1.7253897310324457e-07,4,3,1
5063,Fibrosi,2.095639979110664e-07,5.348708166200577e-06,3,0,3
5064,Fidel,2.5357243747239038e-05,3.2954943862719716e-05,32,12,20
5065,Field,3.583544364279237e-05,5.020884117304414e-05,51,19,32
5066,Fierce,4.400843956132392e-06,5.348708166200577e-06,5,2,3
5067,Fiery,8.592123914353715e-06,1.052487735929791e-05,11,4,7
5068,Fifa,4.212236358012434e-05,3.122955413168725e-05,40,21,19
5069,Fifteen,1.0687763893464371e-05,8.79948762826546e-06,12,5,7
5070,Fifth,4.212236358012434e-05,2.087721574549256e-05,33,20,13
5071,FifthGrader,6.496483935243052e-06,3.6233184351681345e-06,5,3,2
5072,Fifty,1.48790438516857e-05,1.052487735929791e-05,13,7,6
5073,Fight,0.00035646836044672355,0.00038320905926230586,454,204,250
5074,Fighter,5.4696203454788295e-05,3.985650278684949e-05,54,27,27
5075,Fighting,0.00010708720293255492,0.00010714670229711469,122,52,70
5076,Figure,1.6974683830796368e-05,2.2602605476525032e-05,25,10,15
5077,Figured,2.3052039770217305e-06,3.6233184351681345e-06,4,1,3
5078,Figuring,2.095639979110664e-07,5.348708166200577e-06,3,0,3
5079,Fiji,2.116596378901769e-05,8.79948762826546e-06,16,10,6
5080,Fijian,4.400843956132392e-06,5.348708166200577e-06,5,2,3
5081,File,7.565260324589493e-05,9.334358444885519e-05,100,39,61
5082,FileSharer,2.3052039770217305e-06,5.348708166200577e-06,4,1,3
5083,FileSharing,2.3052039770217305e-06,5.348708166200577e-06,5,2,3
5084,Filed,1.0687763893464371e-05,5.348708166200577e-06,10,6,4
5085,Filibuster,2.326160376812834e-05,2.087721574549256e-05,25,11,14
5086,Filing,2.5357243747239038e-05,8.79948762826546e-06,21,12,9
5087,Filipina,6.496483935243052e-06,3.6233184351681345e-06,5,3,2
5088,Filipino,1.9070323809907035e-05,1.9151826014460126e-05,22,9,13
5089,Fill,1.9070323809907035e-05,1.2250267090330355e-05,18,9,9
5090,Filled,4.400843956132392e-06,5.348708166200577e-06,5,2,3
5091,Filling,4.400843956132392e-06,3.6233184351681345e-06,5,3,2
5092,Film,4.212236358012434e-05,3.468033359375216e-05,43,20,23
5093,Filmed,1.278340387257504e-05,1.8979287041356905e-06,7,6,1
5094,Filming,2.095639979110664e-07,1.8979287041356905e-06,4,1,3
5095,Filmmaker,6.496483935243052e-06,3.6233184351681345e-06,6,3,3
5096,Filter,1.48790438516857e-05,1.3975656821362803e-05,16,8,8
5097,Filtering,4.400843956132392e-06,1.8979287041356905e-06,3,2,1
5098,Fin,6.496483935243052e-06,7.074097897233022e-06,8,4,4
5099,Final,7.774824322500554e-05,6.573734875233614e-05,87,43,44
5100,Finally,0.00014690436253565753,0.0001520068353039585,180,82,98
5101,Finance,0.0001154697628489974,8.644202552472544e-05,114,63,51
5102,Financial,0.0001783389622223174,0.00015373222503499084,200,98,102
5103,Financially,4.400843956132392e-06,7.074097897233022e-06,10,5,5
5104,Financing,2.3052039770217305e-06,3.6233184351681345e-06,5,2,3
5105,Find,0.00028731224113607147,0.0003090173008279106,351,154,197
5106,Finding,2.326160376812834e-05,5.1934230904076595e-05,47,13,34
5107,Fine,5.4696203454788295e-05,6.228656929027126e-05,69,29,40
5108,Fined,2.116596378901769e-05,1.742643628342769e-05,21,10,11
5109,Finger,1.0687763893464371e-05,1.570104655239525e-05,17,6,11
5110,Finish,1.48790438516857e-05,1.3975656821362803e-05,16,7,9
5111,Finished,4.400843956132392e-06,5.348708166200577e-06,6,2,4
5112,Finkelstein,6.496483935243052e-06,1.8979287041356905e-06,5,4,1
5113,Finland,6.517440335034157e-05,6.746273848336857e-05,77,35,42
5114,Finn,1.0687763893464371e-05,3.6233184351681345e-06,8,6,2
5115,Finnish,3.583544364279237e-05,3.468033359375216e-05,39,17,22
5116,Fiorina,8.403516316233764e-05,3.468033359375216e-05,64,43,21
5117,Fire,0.00021396484186719832,0.0002244732040073209,254,113,141
5118,Firearm,1.9070323809907035e-05,7.074097897233022e-06,15,9,6
5119,Fireball,2.3052039770217305e-06,3.6233184351681345e-06,3,1,2
5120,Firebomb,2.095639979110664e-07,3.6233184351681345e-06,3,0,3
5121,Fired,9.24177230787802e-05,5.5385010366141504e-05,90,52,38
5122,Firefighter,1.9070323809907035e-05,1.570104655239525e-05,26,14,12
5123,Firestorm,2.3052039770217305e-06,1.7253897310324457e-07,3,1,2
5124,Firewall,4.400843956132392e-06,1.2250267090330355e-05,10,2,8
5125,Firework,4.400843956132392e-06,8.79948762826546e-06,7,2,5
5126,Firing,5.4696203454788295e-05,4.330728224891437e-05,56,30,26
5127,Firm,6.307876337123095e-05,6.401195902130366e-05,75,35,40
5128,First,0.0006205189978146674,0.0006972299903102106,795,339,456
5129,FirstClas,2.095639979110664e-07,5.348708166200577e-06,3,0,3
5130,FirstEver,1.278340387257504e-05,5.348708166200577e-06,9,6,3
5131,FirstTime,4.400843956132392e-06,1.8979287041356905e-06,3,2,1
5132,Fiscal,2.116596378901769e-05,1.3975656821362803e-05,18,10,8
5133,Fischer,6.496483935243052e-06,5.348708166200577e-06,8,5,3
5134,Fish,2.116596378901769e-05,2.2602605476525032e-05,26,13,13
5135,Fisher,4.400843956132392e-06,5.348708166200577e-06,9,2,7
5136,Fisherman,4.400843956132392e-06,1.9151826014460126e-05,17,2,15
5137,Fishery,6.496483935243052e-06,5.348708166200577e-06,8,4,4
5138,Fishing,1.9070323809907035e-05,1.742643628342769e-05,22,10,12
5139,Fisk,8.592123914353715e-06,1.2250267090330355e-05,14,5,9
5140,Fist,4.400843956132392e-06,7.074097897233022e-06,6,2,4
5141,Fit,1.48790438516857e-05,2.087721574549256e-05,23,8,15
5142,Fitch,1.0687763893464371e-05,5.348708166200577e-06,8,5,3
5143,Fitnes,2.3052039770217305e-06,1.2250267090330355e-05,8,1,7
5144,Five,0.00012385232276544028,0.0001571830044970555,175,66,109
5145,FiveThirtyEight,2.095639979110664e-07,5.348708166200577e-06,3,0,3
5146,Fix,9.451336305789087e-05,6.401195902130366e-05,93,52,41
5147,Fixing,1.278340387257504e-05,7.074097897233022e-06,13,6,7
5148,Fk,6.496483935243052e-06,7.074097897233022e-06,9,4,5
5149,Fking,4.400843956132392e-06,5.348708166200577e-06,6,3,3
5150,Fla,2.095639979110664e-07,7.074097897233022e-06,5,0,5
5151,Flabbergasted,2.3052039770217305e-06,1.8979287041356905e-06,3,2,1
5152,Flag,6.936568330856297e-05,6.918812821440096e-05,80,35,45
5153,Flagship,1.0687763893464371e-05,3.6233184351681345e-06,7,5,2
5154,Flake,3.1644163684570994e-05,2.4327995207557487e-05,35,18,17
5155,Flame,1.278340387257504e-05,1.3975656821362803e-05,16,7,9
5156,Flaming,2.3052039770217305e-06,3.6233184351681345e-06,3,1,2
5157,Flap,4.400843956132392e-06,5.348708166200577e-06,5,2,3
5158,Flare,6.496483935243052e-06,7.074097897233022e-06,8,3,5
5159,Flash,1.48790438516857e-05,1.570104655239525e-05,19,9,10
5160,Flashback,4.400843956132392e-06,7.074097897233022e-06,6,2,4
5161,Flat,1.278340387257504e-05,5.348708166200577e-06,11,7,4
5162,Flavor,2.095639979110664e-07,5.348708166200577e-06,3,0,3
5163,Flaw,1.0687763893464371e-05,1.9151826014460126e-05,19,6,13
5164,Flawed,4.400843956132392e-06,7.074097897233022e-06,6,2,4
5165,Fled,2.095639979110664e-07,5.348708166200577e-06,5,1,4
5166,Flee,2.5357243747239038e-05,1.2250267090330355e-05,27,14,13
5167,Fleece,2.3052039770217305e-06,5.348708166200577e-06,4,1,3
5168,Fleeing,8.592123914353715e-06,8.79948762826546e-06,9,4,5
5169,Fleet,1.278340387257504e-05,2.2602605476525032e-05,20,6,14
5170,Fletcher,2.3052039770217305e-06,3.6233184351681345e-06,3,1,2
5171,Flexibility,2.095639979110664e-07,7.074097897233022e-06,4,0,4
5172,Flexible,4.400843956132392e-06,3.6233184351681345e-06,5,2,3
5173,Flickr,2.3052039770217305e-06,1.8979287041356905e-06,3,2,1
5174,Flier,4.400843956132392e-06,1.8979287041356905e-06,4,3,1
5175,Flight,7.146132328767358e-05,8.299124606266055e-05,90,37,53
5176,Flint,0.00014690436253565753,0.00011749904068330962,147,76,71
5177,Flip,2.7452883726349685e-05,1.570104655239525e-05,25,15,10
5178,FlipFlop,1.278340387257504e-05,7.074097897233022e-06,12,6,6
5179,FlipFlopped,2.3052039770217305e-06,3.6233184351681345e-06,3,1,2
5180,FlipFlopper,4.400843956132392e-06,1.8979287041356905e-06,3,2,1
5181,Flipped,4.400843956132392e-06,7.074097897233022e-06,6,2,4
5182,Flipping,4.400843956132392e-06,3.6233184351681345e-06,5,2,3
5183,Float,1.48790438516857e-05,1.052487735929791e-05,13,7,6
5184,Floated,6.496483935243052e-06,5.348708166200577e-06,6,3,3
5185,Floating,4.400843956132392e-06,3.6233184351681345e-06,5,3,2
5186,Flock,4.400843956132392e-06,3.6233184351681345e-06,5,3,2
5187,Flocking,2.3052039770217305e-06,3.6233184351681345e-06,3,1,2
5188,Flood,7.146132328767358e-05,4.1581892517881935e-05,62,36,26
5189,Flooded,8.592123914353715e-06,3.6233184351681345e-06,7,4,3
5190,Flooding,6.496483935243052e-06,2.6053384938589907e-05,19,4,15
5191,Floodwater,2.3052039770217305e-06,1.8979287041356905e-06,3,1,2
5192,Floor,3.3739803663681634e-05,1.9151826014460126e-05,30,18,12
5193,Flop,2.3052039770217305e-06,3.6233184351681345e-06,3,1,2
5194,Flore,6.496483935243052e-06,5.348708166200577e-06,6,3,3
5195,Florence,4.400843956132392e-06,1.2250267090330355e-05,9,2,7
5196,Florida,0.0002956948010525145,0.0003038411316348131,376,163,213
5197,Floridian,1.278340387257504e-05,5.348708166200577e-06,10,7,3
5198,Flotilla,6.496483935243052e-06,7.074097897233022e-06,10,3,7
5199,Flourish,4.400843956132392e-06,3.6233184351681345e-06,5,2,3
5200,Flow,8.592123914353715e-06,1.742643628342769e-05,16,4,12
5201,Flower,8.592123914353715e-06,1.052487735929791e-05,10,4,6
5202,Flown,4.400843956132392e-06,1.8979287041356905e-06,3,2,1
5203,Floyd,1.48790438516857e-05,2.9504164400654783e-05,24,7,17
5204,Flu,2.7452883726349685e-05,1.9151826014460126e-05,32,19,13
5205,Flub,6.496483935243052e-06,5.348708166200577e-06,6,3,3
5206,Flush,6.496483935243052e-06,1.7253897310324457e-07,3,3,0
5207,Flux,4.400843956132392e-06,1.8979287041356905e-06,3,2,1
5208,Fly,2.326160376812834e-05,2.777877466962238e-05,28,11,17
5209,Flyby,2.3052039770217305e-06,3.6233184351681345e-06,3,1,2
5210,Flyer,6.496483935243052e-06,3.6233184351681345e-06,5,3,2
5211,Flying,2.326160376812834e-05,2.6053384938589907e-05,29,11,18
5212,Flynn,9.24177230787802e-05,0.00013130215853156914,126,46,80
5213,Foam,4.400843956132392e-06,3.6233184351681345e-06,4,2,2
5214,Focu,5.6791843433898893e-05,4.50326719799468e-05,59,30,29
5215,Focus,6.496483935243052e-06,1.052487735929791e-05,9,3,6
5216,Focused,6.496483935243052e-06,7.074097897233022e-06,8,4,4
5217,Focusing,6.496483935243052e-06,5.348708166200577e-06,7,4,3
5218,Foe,1.0687763893464371e-05,1.052487735929791e-05,11,5,6
5219,Fog,2.3052039770217305e-06,1.8979287041356905e-06,3,1,2
5220,Fogle,4.400843956132392e-06,1.8979287041356905e-06,3,2,1
5221,Foil,2.3052039770217305e-06,3.6233184351681345e-06,3,1,2
5222,Fold,4.400843956132392e-06,5.348708166200577e-06,6,3,3
5223,Foley,8.592123914353715e-06,2.087721574549256e-05,16,4,12
5224,Folk,6.496483935243052e-06,8.79948762826546e-06,9,4,5
5225,Follow,4.212236358012434e-05,3.640572332478458e-05,48,24,24
5226,Followed,4.400843956132392e-06,5.348708166200577e-06,5,2,3
5227,Follower,1.48790438516857e-05,3.6233184351681345e-06,11,8,3
5228,Following,9.870464301611217e-05,8.299124606266055e-05,104,49,55
5229,Folly,6.496483935243052e-06,3.6233184351681345e-06,5,3,2
5230,Fonda,2.3052039770217305e-06,3.6233184351681345e-06,3,1,2
5231,Fonseca,8.592123914353715e-06,5.348708166200577e-06,7,4,3
5232,Food,0.00028312096117785073,0.0002400017115866128,308,156,152
5233,Fool,1.0687763893464371e-05,1.052487735929791e-05,12,6,6
5234,Fooled,4.400843956132392e-06,3.6233184351681345e-06,5,2,3
5235,Foolish,4.400843956132392e-06,1.8979287041356905e-06,3,2,1
5236,Foot,1.9070323809907035e-05,2.2602605476525032e-05,23,9,14
5237,Footage,4.002672360101368e-05,5.3659620635109e-05,59,26,33
5238,Football,3.7931083621902995e-05,2.6053384938589907e-05,36,20,16
5239,Footprint,4.400843956132392e-06,5.348708166200577e-06,5,2,3
5240,For,4.400843956132392e-06,1.2250267090330355e-05,10,3,7
5241,ForProfit,1.9070323809907035e-05,2.2602605476525032e-05,22,9,13
5242,Forbe,1.48790438516857e-05,2.087721574549256e-05,21,9,12
5243,Forbidden,2.3052039770217305e-06,7.074097897233022e-06,5,1,4
5244,Force,0.00023701688163741595,0.00027105872674519724,301,124,177
5245,Forced,4.4218003559234974e-05,6.746273848336857e-05,64,22,42
5246,Forcibly,2.095639979110664e-07,7.074097897233022e-06,4,0,4
5247,Forcing,1.48790438516857e-05,1.2250267090330355e-05,15,8,7
5248,Ford,5.260056347567764e-05,5.883578982820635e-05,64,27,37
5249,Forecast,1.6974683830796368e-05,1.2250267090330355e-05,16,9,7
5250,Forecaster,4.400843956132392e-06,7.074097897233022e-06,6,2,4
5251,Foreclosure,1.278340387257504e-05,1.9151826014460126e-05,21,8,13
5252,Foreign,0.00023701688163741595,0.00025898099862796983,279,121,158
5253,Foreigner,1.48790438516857e-05,1.052487735929791e-05,15,7,8
5254,Forest,3.3739803663681634e-05,2.4327995207557487e-05,35,19,16
5255,Forever,2.116596378901769e-05,2.9504164400654783e-05,30,11,19
5256,Forfeit,2.3052039770217305e-06,3.6233184351681345e-06,4,1,3
5257,Forfeiture,4.400843956132392e-06,1.8979287041356905e-06,3,2,1
5258,Forged,2.095639979110664e-07,7.074097897233022e-06,5,1,4
5259,Forget,4.4218003559234974e-05,5.711040009717395e-05,62,27,35
5260,Forgive,4.400843956132392e-06,7.074097897233022e-06,6,2,4
5261,Forgivenes,1.278340387257504e-05,5.348708166200577e-06,9,6,3
5262,Forgot,1.0687763893464371e-05,5.348708166200577e-06,9,5,4
5263,Forgotten,2.954852370546031e-05,1.9151826014460126e-05,27,15,12
5264,Form,4.002672360101368e-05,3.640572332478458e-05,49,22,27
5265,Formal,2.095639979110664e-07,5.348708166200577e-06,3,0,3
5266,Formally,4.400843956132392e-06,1.2250267090330355e-05,11,3,8
5267,Formed,2.3052039770217305e-06,5.348708166200577e-06,5,1,4
5268,Former,0.0005031631589844702,0.0005039863404345769,599,268,331
5269,Formerly,2.3052039770217305e-06,8.79948762826546e-06,7,2,5
5270,Forming,4.400843956132392e-06,5.348708166200577e-06,5,2,3
5271,Formula,1.48790438516857e-05,1.2250267090330355e-05,15,7,8
5272,Forrest,6.496483935243052e-06,3.6233184351681345e-06,6,3,3
5273,Fort,8.592123914353715e-06,1.742643628342769e-05,19,7,12
5274,Fortaleza,2.3052039770217305e-06,3.6233184351681345e-06,3,1,2
5275,Fortunately,2.3052039770217305e-06,1.052487735929791e-05,7,1,6
5276,Fortune,1.48790438516857e-05,8.79948762826546e-06,14,8,6
5277,Forty,4.400843956132392e-06,8.79948762826546e-06,8,2,6
5278,Forum,3.1644163684570994e-05,2.9504164400654783e-05,36,16,20
5279,Forward,5.888748341300963e-05,6.746273848336857e-05,70,30,40
5280,Fossil,6.098312339212028e-05,4.330728224891437e-05,59,30,29
5281,Foster,1.48790438516857e-05,2.6053384938589907e-05,26,9,17
5282,Fought,1.0687763893464371e-05,1.570104655239525e-05,17,7,10
5283,Foul,2.3052039770217305e-06,7.074097897233022e-06,5,1,4
5284,Found,0.00016995640230587486,0.00022274781427628854,227,87,140
5285,Foundation,7.355696326678427e-05,0.00010024514337298497,98,38,60
5286,Founded,4.400843956132392e-06,1.2250267090330355e-05,9,2,7
5287,Founder,8.403516316233764e-05,7.263890767646595e-05,91,44,47
5288,Founding,6.496483935243052e-06,5.348708166200577e-06,9,4,5
5289,Fountain,2.3052039770217305e-06,5.348708166200577e-06,6,3,3
5290,Four,0.00014271308257743603,0.00014510527637982858,177,74,103
5291,Fourteen,4.400843956132392e-06,1.052487735929791e-05,9,2,7
5292,Fourth,4.840928351745632e-05,3.122955413168725e-05,44,25,19
5293,Fouryearold,2.3052039770217305e-06,3.6233184351681345e-06,4,2,2
5294,Fox,0.0002097735619089774,0.000286587234324489,298,113,185
5295,Foxconn,2.116596378901769e-05,2.087721574549256e-05,23,10,13
5296,Fracking,1.6974683830796368e-05,4.1581892517881935e-05,37,8,29
5297,Fraction,2.3052039770217305e-06,3.6233184351681345e-06,3,1,2
5298,Fragile,4.400843956132392e-06,7.074097897233022e-06,6,2,4
5299,Framed,4.400843956132392e-06,1.8979287041356905e-06,3,2,1
5300,Framework,4.400843956132392e-06,1.8979287041356905e-06,3,2,1
5301,France,0.0006309971977102204,0.0005902558269861991,722,341,381
5302,Franchise,2.3052039770217305e-06,5.348708166200577e-06,4,1,3
5303,Franci,0.00016786076232676425,0.00011232287149021227,159,86,73
5304,Francis,2.3052039770217305e-06,3.6233184351681345e-06,3,1,2
5305,Francisco,5.260056347567764e-05,8.989280498679035e-05,88,31,57
5306,Franco,4.400843956132392e-06,1.8979287041356905e-06,3,2,1
5307,Francois,1.278340387257504e-05,1.052487735929791e-05,14,6,8
5308,Frank,3.583544364279237e-05,4.330728224891437e-05,44,17,27
5309,Franken,4.6313643538345614e-05,6.746273848336857e-05,65,24,41
5310,Frankfurt,1.278340387257504e-05,1.052487735929791e-05,14,6,8
5311,Franklin,6.496483935243052e-06,1.052487735929791e-05,10,4,6
5312,Frankly,2.095639979110664e-07,5.348708166200577e-06,4,0,4
5313,Franois,1.48790438516857e-05,1.8979287041356905e-06,9,8,1
5314,Fraser,4.400843956132392e-06,7.074097897233022e-06,7,2,5
5315,Fraud,0.00017205204228498542,0.00014337988664879628,193,92,101
5316,Fraudster,4.400843956132392e-06,3.6233184351681345e-06,4,2,2
5317,Fraudulent,4.400843956132392e-06,3.6233184351681345e-06,4,2,2
5318,Fray,4.400843956132392e-06,3.6233184351681345e-06,4,2,2
5319,Freak,1.48790438516857e-05,1.3975656821362803e-05,15,7,8
5320,Freaked,2.3052039770217305e-06,1.8979287041356905e-06,3,1,2
5321,Freaking,2.095639979110664e-07,5.348708166200577e-06,3,0,3
5322,Freakishly,2.095639979110664e-07,3.6233184351681345e-06,3,0,3
5323,Freakout,2.3052039770217305e-06,3.6233184351681345e-06,4,1,3
5324,Freaky,2.3052039770217305e-06,5.348708166200577e-06,4,1,3
5325,Fred,1.48790438516857e-05,1.742643628342769e-05,19,9,10
5326,Freddie,2.326160376812834e-05,2.087721574549256e-05,25,11,14
5327,Free,0.00028312096117785073,0.0002175716450831913,294,142,152
5328,FreeForAll,2.095639979110664e-07,1.8979287041356905e-06,3,1,2
5329,Freebie,4.400843956132392e-06,1.8979287041356905e-06,3,2,1
5330,Freed,1.278340387257504e-05,1.3975656821362803e-05,16,6,10
5331,Freedom,0.0001741476822640959,0.00012440059960743937,174,89,85
5332,Freeing,4.400843956132392e-06,3.6233184351681345e-06,4,2,2
5333,Freelance,2.3052039770217305e-06,3.6233184351681345e-06,3,1,2
5334,Freelancer,6.496483935243052e-06,3.6233184351681345e-06,6,4,2
5335,Freeman,4.400843956132392e-06,1.3975656821362803e-05,10,2,8
5336,Freeze,1.9070323809907035e-05,7.074097897233022e-06,13,9,4
5337,Freezing,4.400843956132392e-06,5.348708166200577e-06,6,3,3
5338,Frei,2.3052039770217305e-06,3.6233184351681345e-06,3,1,2
5339,French,0.0005576497984413471,0.0005764527091379395,680,301,379
5340,Frenchman,6.496483935243052e-06,3.6233184351681345e-06,5,3,2
5341,Frenzy,1.0687763893464371e-05,3.6233184351681345e-06,8,6,2
5342,Frequent,1.0687763893464371e-05,7.074097897233022e-06,9,5,4
5343,Frequently,2.3052039770217305e-06,3.6233184351681345e-06,3,1,2
5344,Fresh,4.002672360101368e-05,3.640572332478458e-05,41,20,21
5345,Fret,2.3052039770217305e-06,3.6233184351681345e-06,3,1,2
5346,Fri,2.3052039770217305e-06,3.6233184351681345e-06,3,1,2
5347,Friday,0.00041095499990360083,0.0004763801047380581,537,228,309
5348,Frieden,2.095639979110664e-07,7.074097897233022e-06,4,0,4
5349,Friedman,6.496483935243052e-06,1.2250267090330355e-05,11,3,8
5350,Friedrich,2.095639979110664e-07,5.348708166200577e-06,3,0,3
5351,Friend,0.00011966104280721883,0.0001019705331040174,130,63,67
5352,Friendly,2.095639979110664e-07,7.074097897233022e-06,6,2,4
5353,Friends,4.400843956132392e-06,7.074097897233022e-06,6,2,4
5354,Friendship,1.0687763893464371e-05,1.052487735929791e-05,12,5,7
5355,Frightening,2.3052039770217305e-06,3.6233184351681345e-06,5,3,2
5356,Fringe,4.400843956132392e-06,1.8979287041356905e-06,3,2,1
5357,Frisbee,4.400843956132392e-06,5.348708166200577e-06,5,2,3
5358,Frisk,2.3052039770217305e-06,1.8979287041356905e-06,3,1,2
5359,Friso,4.400843956132392e-06,1.8979287041356905e-06,3,2,1
5360,Fritzl,6.496483935243052e-06,3.6233184351681345e-06,6,3,3
5361,Frog,1.0687763893464371e-05,5.348708166200577e-06,8,5,3
5362,Front,3.7931083621902995e-05,4.6758061710979285e-05,55,23,32
5363,FrontRunner,6.496483935243052e-06,1.7253897310324457e-07,3,3,0
5364,Frontier,6.496483935243052e-06,7.074097897233022e-06,7,3,4
5365,Frontire,2.3052039770217305e-06,3.6233184351681345e-06,3,1,2
5366,Frontline,4.400843956132392e-06,7.074097897233022e-06,6,2,4
5367,Frontrunner,6.496483935243052e-06,1.052487735929791e-05,9,3,6
5368,Frost,6.496483935243052e-06,1.7253897310324457e-07,4,3,1
5369,Frozen,1.6974683830796368e-05,1.052487735929791e-05,14,8,6
5370,Frugal,4.400843956132392e-06,1.8979287041356905e-06,5,2,3
5371,Fruit,4.400843956132392e-06,8.79948762826546e-06,7,2,5
5372,Fruitles,2.3052039770217305e-06,3.6233184351681345e-06,3,1,2
5373,Frustrated,1.278340387257504e-05,7.074097897233022e-06,11,7,4
5374,Frustrating,4.400843956132392e-06,3.6233184351681345e-06,4,2,2
5375,Frustration,4.400843956132392e-06,1.2250267090330355e-05,10,2,8
5376,Fry,6.496483935243052e-06,1.052487735929791e-05,11,4,7
5377,Fuck,1.278340387257504e-05,1.570104655239525e-05,16,7,9
5378,Fuel,6.517440335034157e-05,6.918812821440096e-05,80,35,45
5379,Fueled,1.278340387257504e-05,5.348708166200577e-06,10,7,3
5380,Fueling,1.48790438516857e-05,5.348708166200577e-06,12,8,4
5381,Fuente,4.400843956132392e-06,1.8979287041356905e-06,3,2,1
5382,Fugitive,1.278340387257504e-05,3.6233184351681345e-06,10,7,3
5383,Fuji,4.400843956132392e-06,3.6233184351681345e-06,5,3,2
5384,Fujimori,2.095639979110664e-07,1.8979287041356905e-06,3,2,1
5385,Fukushima,0.0002349212416583052,0.0002313747629314509,274,122,152
5386,Fulfill,2.3052039770217305e-06,7.074097897233022e-06,6,2,4
5387,Full,9.03220830996695e-05,0.0001036959228350498,112,47,65
5388,Fully,1.278340387257504e-05,2.2602605476525032e-05,21,8,13
5389,Fume,2.3052039770217305e-06,8.79948762826546e-06,6,1,5
5390,Fuming,6.496483935243052e-06,1.8979287041356905e-06,5,4,1
5391,Fun,1.278340387257504e-05,1.570104655239525e-05,16,7,9
5392,Fund,0.0001385218026192147,0.00017616229153841266,179,69,110
5393,Fundamental,4.400843956132392e-06,7.074097897233022e-06,6,2,4
5394,Fundamentalist,1.0687763893464371e-05,3.6233184351681345e-06,7,5,2
5395,Fundamentally,6.496483935243052e-06,1.8979287041356905e-06,5,3,2
5396,Funded,1.48790438516857e-05,1.3975656821362803e-05,15,7,8
5397,Funding,8.193952318322689e-05,0.00010024514337298497,113,44,69
5398,Fundraise,2.095639979110664e-07,7.074097897233022e-06,5,0,5
5399,Fundraiser,2.7452883726349685e-05,1.570104655239525e-05,24,14,10
5400,Fundraising,3.583544364279237e-05,2.2602605476525032e-05,34,18,16
5401,Funeral,2.7452883726349685e-05,1.2250267090330355e-05,24,14,10
5402,Funnel,2.3052039770217305e-06,3.6233184351681345e-06,3,1,2
5403,Funneled,2.3052039770217305e-06,1.8979287041356905e-06,3,2,1
5404,Funny,6.496483935243052e-06,2.087721574549256e-05,17,4,13
5405,Furiou,1.48790438516857e-05,1.742643628342769e-05,19,9,10
5406,Furniture,1.278340387257504e-05,7.074097897233022e-06,10,6,4
5407,Furthermore,2.3052039770217305e-06,7.074097897233022e-06,5,1,4
5408,Fury,2.116596378901769e-05,2.6053384938589907e-05,27,11,16
5409,Fusion,1.6974683830796368e-05,1.3975656821362803e-05,19,9,10
5410,Future,0.0001259479627445509,0.00017961307100047735,186,70,116
5411,Fuzzy,6.496483935243052e-06,1.8979287041356905e-06,4,3,1
5412,G20,0.00012175668278632962,7.781507686956326e-05,117,61,56
5413,G7,2.116596378901769e-05,7.074097897233022e-06,17,10,7
5414,G8,1.278340387257504e-05,2.2602605476525032e-05,20,6,14
5415,GCHQ,4.6313643538345614e-05,4.6758061710979285e-05,56,22,34
5416,GCSB,4.400843956132392e-06,3.6233184351681345e-06,5,2,3
5417,GDP,3.1644163684570994e-05,6.056117955923882e-05,54,17,37
5418,GE,2.095639979110664e-07,5.348708166200577e-06,3,0,3
5419,GETTING,6.496483935243052e-06,1.7253897310324457e-07,3,3,0
5420,GI,2.095639979110664e-07,7.074097897233022e-06,4,0,4
5421,GIF,1.0687763893464371e-05,8.79948762826546e-06,11,5,6
5422,GM,5.6791843433898893e-05,4.330728224891437e-05,54,27,27
5423,GMO,1.48790438516857e-05,2.9504164400654783e-05,29,9,20
5424,GMT,1.0687763893464371e-05,1.8979287041356905e-06,7,5,2
5425,GO,2.3052039770217305e-06,3.6233184351681345e-06,3,1,2
5426,GOOD,2.095639979110664e-07,3.6233184351681345e-06,3,0,3
5427,GOP,0.0018653291454064005,0.001823909484674397,2172,980,1192
5428,GOPBacked,6.496483935243052e-06,1.8979287041356905e-06,6,4,2
5429,GOPLed,4.400843956132392e-06,1.7253897310324457e-07,4,4,0
5430,GOPbacked,2.095639979110664e-07,5.348708166200577e-06,3,0,3
5431,GOPcontrolled,2.3052039770217305e-06,7.074097897233022e-06,5,1,4
5432,GOPer,4.400843956132392e-06,3.6233184351681345e-06,5,3,2
5433,GOPled,2.3052039770217305e-06,8.79948762826546e-06,6,1,5
5434,GP,2.7452883726349685e-05,1.570104655239525e-05,24,13,11
5435,GRAPHIC,1.9070323809907035e-05,1.8979287041356905e-06,11,10,1
5436,GVP,2.095639979110664e-07,5.348708166200577e-06,3,0,3
5437,GW,4.400843956132392e-06,8.79948762826546e-06,7,2,5
5438,Ga,0.00010499156295344414,7.436429740749831e-05,102,54,48
5439,Gabbard,4.400843956132392e-06,5.348708166200577e-06,6,2,4
5440,Gabby,8.592123914353715e-06,7.074097897233022e-06,9,4,5
5441,Gabon,1.0687763893464371e-05,5.348708166200577e-06,8,5,3
5442,Gabriel,8.592123914353715e-06,8.79948762826546e-06,10,4,6
5443,Gadaffi,8.592123914353715e-06,7.074097897233022e-06,9,5,4
5444,Gaddafi,0.00015947820241032126,0.00013302754826260141,170,80,90
5445,Gadget,2.095639979110664e-07,7.074097897233022e-06,6,0,6
5446,Gadhafi,2.116596378901769e-05,4.8483451442011706e-05,42,10,32
5447,Gaffe,1.48790438516857e-05,8.79948762826546e-06,13,7,6
5448,Gaffney,4.400843956132392e-06,1.8979287041356905e-06,3,2,1
5449,Gag,1.0687763893464371e-05,5.348708166200577e-06,8,5,3
5450,Gaga,8.592123914353715e-06,1.052487735929791e-05,10,4,6
5451,Gail,4.400843956132392e-06,3.6233184351681345e-06,4,2,2
5452,Gain,3.583544364279237e-05,3.468033359375216e-05,41,20,21
5453,Gained,1.0687763893464371e-05,3.6233184351681345e-06,7,5,2
5454,Gaining,8.592123914353715e-06,8.79948762826546e-06,11,4,7
5455,Gala,2.3052039770217305e-06,3.6233184351681345e-06,3,1,2
5456,Galactic,2.3052039770217305e-06,1.3975656821362803e-05,10,2,8
5457,Galapago,1.0687763893464371e-05,1.7253897310324457e-07,5,5,0
5458,Galaxy,3.3739803663681634e-05,2.4327995207557487e-05,31,16,15
5459,Gale,2.3052039770217305e-06,8.79948762826546e-06,7,2,5
5460,Galilee,4.400843956132392e-06,8.79948762826546e-06,8,2,6
5461,Galileo,4.400843956132392e-06,3.6233184351681345e-06,4,2,2
5462,Gallery,4.400843956132392e-06,1.052487735929791e-05,8,2,6
5463,Gallipoli,2.3052039770217305e-06,3.6233184351681345e-06,3,1,2
5464,Gallon,8.592123914353715e-06,7.074097897233022e-06,8,4,4
5465,Galloway,1.0687763893464371e-05,1.7253897310324457e-07,5,5,0
5466,Gallup,4.400843956132392e-06,1.9151826014460126e-05,17,2,15
5467,Gambia,1.0687763893464371e-05,1.052487735929791e-05,12,6,6
5468,Gambian,8.592123914353715e-06,1.7253897310324457e-07,5,4,1
5469,Gambit,2.3052039770217305e-06,3.6233184351681345e-06,3,1,2
5470,Gamble,1.278340387257504e-05,3.6233184351681345e-06,9,6,3
5471,Gambler,2.3052039770217305e-06,3.6233184351681345e-06,3,1,2
5472,Gambling,1.278340387257504e-05,1.052487735929791e-05,12,6,6
5473,Game,0.00016995640230587486,0.0001589083942280881,190,88,102
5474,GameChanger,2.3052039770217305e-06,5.348708166200577e-06,4,1,3
5475,Gamer,4.400843956132392e-06,1.8979287041356905e-06,3,2,1
5476,Gaming,4.400843956132392e-06,3.6233184351681345e-06,4,2,2
5477,Gandhi,1.278340387257504e-05,3.6233184351681345e-06,9,6,3
5478,Gang,2.116596378901769e-05,1.3975656821362803e-05,22,13,9
5479,Gangnam,2.095639979110664e-07,5.348708166200577e-06,3,0,3
5480,Gangster,8.592123914353715e-06,1.8979287041356905e-06,5,4,1
5481,Gao,1.278340387257504e-05,1.8979287041356905e-06,7,6,1
5482,Gap,6.307876337123095e-05,5.5385010366141504e-05,69,33,36
5483,Garage,6.496483935243052e-06,1.8979287041356905e-06,4,3,1
5484,Garbage,1.278340387257504e-05,2.6053384938589907e-05,22,7,15
5485,Garcia,1.48790438516857e-05,1.9151826014460126e-05,20,7,13
5486,García,2.3052039770217305e-06,1.8979287041356905e-06,3,1,2
5487,Garda,2.3052039770217305e-06,3.6233184351681345e-06,3,1,2
5488,Garden,1.48790438516857e-05,1.3975656821362803e-05,18,9,9
5489,Gardner,3.3739803663681634e-05,4.8483451442011706e-05,44,16,28
5490,Gareth,8.592123914353715e-06,1.8979287041356905e-06,5,4,1
5491,Garland,4.6313643538345614e-05,5.711040009717395e-05,61,24,37
5492,Garment,2.3052039770217305e-06,3.6233184351681345e-06,3,1,2
5493,Garner,2.116596378901769e-05,2.777877466962238e-05,31,15,16
5494,Garrett,8.592123914353715e-06,1.8979287041356905e-06,7,6,1
5495,Garry,4.400843956132392e-06,5.348708166200577e-06,5,2,3
5496,Gary,4.212236358012434e-05,5.3659620635109e-05,63,25,38
5497,Gas,2.095639979110664e-07,5.348708166200577e-06,3,0,3
5498,Gasoline,4.400843956132392e-06,8.79948762826546e-06,7,2,5
5499,Gate,8.193952318322689e-05,8.644202552472544e-05,97,45,52
5500,Gateway,4.400843956132392e-06,8.79948762826546e-06,7,2,5
5501,Gather,1.0687763893464371e-05,1.2250267090330355e-05,14,5,9
5502,Gathering,4.400843956132392e-06,5.348708166200577e-06,5,2,3
5503,Gauck,2.3052039770217305e-06,1.8979287041356905e-06,3,1,2
5504,Gave,5.260056347567764e-05,6.228656929027126e-05,68,27,41
5505,Gavel,4.400843956132392e-06,1.8979287041356905e-06,3,2,1
5506,Gavin,1.9070323809907035e-05,1.570104655239525e-05,19,9,10
5507,Gawker,6.496483935243052e-06,3.6233184351681345e-06,6,3,3
5508,Gay,0.00021396484186719832,0.00017961307100047735,239,114,125
5509,Gayle,4.400843956132392e-06,1.8979287041356905e-06,4,3,1
5510,Gaza,0.0008342742756839545,0.0006989553800412431,913,444,469
5511,Gazabound,1.0687763893464371e-05,1.2250267090330355e-05,12,5,7
5512,Gazan,2.954852370546031e-05,3.122955413168725e-05,36,16,20
5513,Gazette,2.3052039770217305e-06,3.6233184351681345e-06,3,1,2
5514,Gazprom,2.095639979110664e-07,7.074097897233022e-06,4,0,4
5515,Gbagbo,4.400843956132392e-06,3.6233184351681345e-06,5,2,3
5516,Gear,2.954852370546031e-05,1.742643628342769e-05,26,16,10
5517,Gearing,1.0687763893464371e-05,1.8979287041356905e-06,6,5,1
5518,Gecko,4.400843956132392e-06,1.8979287041356905e-06,3,2,1
5519,Gee,2.095639979110664e-07,7.074097897233022e-06,4,0,4
5520,Geek,4.400843956132392e-06,3.6233184351681345e-06,4,2,2
5521,Geert,1.278340387257504e-05,8.79948762826546e-06,12,7,5
5522,Geithner,2.3052039770217305e-06,3.6233184351681345e-06,3,1,2
5523,Gem,2.095639979110664e-07,7.074097897233022e-06,4,0,4
5524,Gen,4.4218003559234974e-05,4.330728224891437e-05,51,24,27
5525,Gender,5.6791843433898893e-05,4.50326719799468e-05,56,30,26
5526,Gene,4.400843956132392e-06,1.2250267090330355e-05,11,2,9
5527,General,0.00027054712130318646,0.00026760794728313193,320,144,176
5528,Generally,2.3052039770217305e-06,1.8979287041356905e-06,3,1,2
5529,Generating,6.496483935243052e-06,3.6233184351681345e-06,6,4,2
5530,Generation,6.72700433294523e-05,4.50326719799468e-05,62,35,27
5531,Generational,2.3052039770217305e-06,3.6233184351681345e-06,3,1,2
5532,Generic,4.400843956132392e-06,3.6233184351681345e-06,4,2,2
5533,Generosity,6.496483935243052e-06,1.7253897310324457e-07,3,3,0
5534,Generou,1.0687763893464371e-05,8.79948762826546e-06,11,6,5
5535,Genetic,1.0687763893464371e-05,5.348708166200577e-06,9,6,3
5536,Genetically,1.0687763893464371e-05,5.348708166200577e-06,8,5,3
5537,Geneva,3.3739803663681634e-05,2.2602605476525032e-05,30,16,14
5538,Genital,1.6974683830796368e-05,1.742643628342769e-05,23,11,12
5539,Geniu,6.496483935243052e-06,1.3975656821362803e-05,13,3,10
5540,Genocidal,2.095639979110664e-07,5.348708166200577e-06,3,0,3
5541,Genocide,4.4218003559234974e-05,3.640572332478458e-05,50,23,27
5542,Gentle,4.400843956132392e-06,3.6233184351681345e-06,5,3,2
5543,Gentleman,2.095639979110664e-07,7.074097897233022e-06,4,0,4
5544,Gentrification,6.496483935243052e-06,5.348708166200577e-06,6,3,3
5545,Geoff,2.3052039770217305e-06,5.348708166200577e-06,4,1,3
5546,Geographic,1.0687763893464371e-05,3.6233184351681345e-06,7,5,2
5547,Geologist,4.400843956132392e-06,5.348708166200577e-06,5,2,3
5548,George,0.00021396484186719832,0.00020549391696596386,243,111,132
5549,Georgetown,6.496483935243052e-06,8.79948762826546e-06,9,3,6
5550,Georgia,0.00030617300094806777,0.000286587234324489,334,151,183
5551,Georgian,3.3739803663681634e-05,3.468033359375216e-05,37,16,21
5552,Gerald,4.400843956132392e-06,1.052487735929791e-05,8,2,6
5553,Gerhard,4.400843956132392e-06,1.8979287041356905e-06,3,2,1
5554,Germ,6.496483935243052e-06,1.8979287041356905e-06,4,3,1
5555,German,0.0007714050763106348,0.0006540952470343997,802,386,416
5556,Germanwing,8.592123914353715e-06,7.074097897233022e-06,8,4,4
5557,Germany,0.0007336835566866429,0.0006989553800412431,835,384,451
5558,Gerry,8.592123914353715e-06,1.7253897310324457e-07,4,4,0
5559,Gerrymandered,2.095639979110664e-07,1.2250267090330355e-05,9,2,7
5560,Gerrymandering,2.5357243747239038e-05,2.4327995207557487e-05,28,13,15
5561,Gesture,4.400843956132392e-06,5.348708166200577e-06,9,4,5
5562,Get,0.0008133178758928479,0.0008318103893307415,964,428,536
5563,GetRichQuick,2.095639979110664e-07,5.348708166200577e-06,3,0,3
5564,Getting,0.00017205204228498542,0.00016235917369015308,206,95,111
5565,Gettysburg,2.3052039770217305e-06,5.348708166200577e-06,4,1,3
5566,Gezi,2.3052039770217305e-06,8.79948762826546e-06,6,1,5
5567,Ghana,2.5357243747239038e-05,1.9151826014460126e-05,28,15,13
5568,Ghazala,2.3052039770217305e-06,5.348708166200577e-06,4,1,3
5569,Ghetto,4.400843956132392e-06,8.79948762826546e-06,7,2,5
5570,Ghonim,2.3052039770217305e-06,7.074097897233022e-06,5,1,4
5571,Ghost,2.326160376812834e-05,1.570104655239525e-05,21,11,10
5572,Ghrai,2.3052039770217305e-06,3.6233184351681345e-06,3,1,2
5573,Ghraib,2.095639979110664e-07,1.2250267090330355e-05,8,1,7
5574,Gianforte,6.496483935243052e-06,2.087721574549256e-05,15,3,12
5575,Gianni,4.400843956132392e-06,1.8979287041356905e-06,3,2,1
5576,Giant,8.193952318322689e-05,8.816741525575797e-05,103,46,57
5577,Gibb,2.095639979110664e-07,3.6233184351681345e-06,3,0,3
5578,Gibraltar,1.278340387257504e-05,3.6233184351681345e-06,8,6,2
5579,Gibson,2.3052039770217305e-06,5.348708166200577e-06,4,1,3
5580,Gifford,1.0687763893464371e-05,1.052487735929791e-05,12,5,7
5581,Gift,7.774824322500554e-05,7.091351794543343e-05,90,44,46
5582,Gig,1.278340387257504e-05,8.79948762826546e-06,13,7,6
5583,Gigantic,4.400843956132392e-06,1.7253897310324457e-07,3,2,1
5584,Gilad,1.0687763893464371e-05,7.074097897233022e-06,10,6,4
5585,Gilbert,1.48790438516857e-05,5.348708166200577e-06,10,7,3
5586,Gillard,1.48790438516857e-05,1.052487735929791e-05,17,8,9
5587,Gillespie,8.592123914353715e-06,1.052487735929791e-05,14,7,7
5588,Gillibrand,1.6974683830796368e-05,1.9151826014460126e-05,20,9,11
5589,Gilmore,6.496483935243052e-06,1.8979287041356905e-06,5,3,2
5590,Gina,1.278340387257504e-05,2.777877466962238e-05,22,6,16
5591,Gingrich,2.954852370546031e-05,3.468033359375216e-05,36,15,21
5592,Ginsburg,3.1644163684570994e-05,5.3659620635109e-05,50,15,35
5593,Girl,0.00021186920188808795,0.0002451778807797103,268,112,156
5594,Girlfriend,6.496483935243052e-06,5.348708166200577e-06,7,4,3
5595,Gitmo,1.6974683830796368e-05,2.9504164400654783e-05,27,9,18
5596,Giuliani,5.050492349656699e-05,7.781507686956326e-05,76,24,52
5597,Give,0.0003501814405093918,0.000302115741903781,385,188,197
5598,Giveaway,6.496483935243052e-06,8.79948762826546e-06,8,3,5
5599,Given,3.583544364279237e-05,4.50326719799468e-05,47,19,28
5600,Giver,2.3052039770217305e-06,1.8979287041356905e-06,3,1,2
5601,Giving,0.00012804360272366158,0.00012612598933847184,143,65,78
5602,Giza,2.3052039770217305e-06,5.348708166200577e-06,4,1,3
5603,Gizmodo,6.496483935243052e-06,5.348708166200577e-06,6,3,3
5604,Glacier,4.400843956132392e-06,1.052487735929791e-05,8,2,6
5605,Glad,4.400843956132392e-06,3.6233184351681345e-06,5,2,3
5606,Gladiator,4.400843956132392e-06,1.8979287041356905e-06,3,2,1
5607,Glas,1.6974683830796368e-05,1.570104655239525e-05,19,9,10
5608,Glasgow,8.592123914353715e-06,3.6233184351681345e-06,8,6,2
5609,Glass,2.095639979110664e-07,7.074097897233022e-06,5,1,4
5610,GlaxoSmithKline,1.0687763893464371e-05,1.052487735929791e-05,11,5,6
5611,Glenn,4.6313643538345614e-05,5.1934230904076595e-05,59,27,32
5612,Glimpse,2.3052039770217305e-06,7.074097897233022e-06,5,1,4
5613,Glitch,1.278340387257504e-05,5.348708166200577e-06,10,6,4
5614,Global,0.00025587764144941177,0.00025898099862796983,307,140,167
5615,GlobalPost,6.496483935243052e-06,1.8979287041356905e-06,4,3,1
5616,Globalist,2.095639979110664e-07,7.074097897233022e-06,4,0,4
5617,Globally,1.0687763893464371e-05,1.052487735929791e-05,13,6,7
5618,Globe,2.954852370546031e-05,3.8131113055817005e-05,38,14,24
5619,Gloria,2.3052039770217305e-06,5.348708166200577e-06,4,1,3
5620,Gloriou,4.400843956132392e-06,3.6233184351681345e-06,4,2,2
5621,Glow,2.3052039770217305e-06,5.348708166200577e-06,4,1,3
5622,Glowing,6.496483935243052e-06,3.6233184351681345e-06,5,3,2
5623,Glue,6.496483935243052e-06,1.7253897310324457e-07,3,3,0
5624,Gmail,2.7452883726349685e-05,7.074097897233022e-06,17,13,4
5625,Go,0.00032503376076006407,0.00044014692038637674,464,173,291
5626,GoDaddy,2.3052039770217305e-06,8.79948762826546e-06,6,1,5
5627,GoFundMe,2.095639979110664e-07,1.8979287041356905e-06,3,1,2
5628,GoPro,2.3052039770217305e-06,7.074097897233022e-06,8,3,5
5629,Goal,3.3739803663681634e-05,3.985650278684949e-05,45,17,28
5630,Goat,4.400843956132392e-06,5.348708166200577e-06,5,2,3
5631,God,0.00013642616264010403,0.00015028144557292604,175,73,102
5632,Godfather,8.592123914353715e-06,3.6233184351681345e-06,6,4,2
5633,Gogh,6.496483935243052e-06,3.6233184351681345e-06,6,3,3
5634,Gohmert,8.592123914353715e-06,5.348708166200577e-06,7,4,3
5635,Going,0.0001531912824729893,0.00017616229153841266,204,87,117
5636,Golan,1.0687763893464371e-05,1.9151826014460126e-05,17,5,12
5637,Gold,6.936568330856297e-05,6.228656929027126e-05,76,35,41
5638,Goldberg,8.592123914353715e-06,1.742643628342769e-05,14,4,10
5639,Golden,5.050492349656699e-05,5.5385010366141504e-05,63,29,34
5640,Goldman,6.72700433294523e-05,7.781507686956326e-05,89,37,52
5641,Goldstone,2.3052039770217305e-06,1.2250267090330355e-05,10,1,9
5642,Golf,2.954852370546031e-05,2.087721574549256e-05,28,14,14
5643,Golfer,2.3052039770217305e-06,3.6233184351681345e-06,3,1,2
5644,Golfing,2.3052039770217305e-06,3.6233184351681345e-06,3,1,2
5645,Goliath,2.3052039770217305e-06,1.8979287041356905e-06,3,1,2
5646,Gomez,6.496483935243052e-06,1.7253897310324457e-07,3,3,0
5647,Gone,2.7452883726349685e-05,3.122955413168725e-05,32,13,19
5648,Gong,4.400843956132392e-06,1.8979287041356905e-06,3,2,1
5649,Gonna,6.496483935243052e-06,8.79948762826546e-06,8,3,5
5650,Gonzale,2.3052039770217305e-06,1.8979287041356905e-06,3,1,2
5651,Gonzalez,2.3052039770217305e-06,1.8979287041356905e-06,3,2,1
5652,Good,0.0002642602013658546,0.0002934887932486187,331,140,191
5653,Goodall,4.400843956132392e-06,3.6233184351681345e-06,4,2,2
5654,Goodbye,8.592123914353715e-06,1.9151826014460126e-05,16,4,12
5655,Goodman,6.496483935243052e-06,3.6233184351681345e-06,5,3,2
5656,Goodwill,8.592123914353715e-06,5.348708166200577e-06,8,4,4
5657,Goodyear,2.095639979110664e-07,7.074097897233022e-06,4,0,4
5658,Goof,6.496483935243052e-06,1.8979287041356905e-06,4,3,1
5659,Goofy,4.400843956132392e-06,1.8979287041356905e-06,3,2,1
5660,Google,0.0004507721595067034,0.00041771685388295495,516,240,276
5661,Googled,6.496483935243052e-06,1.7253897310324457e-07,4,3,1
5662,Goran,2.3052039770217305e-06,1.8979287041356905e-06,3,1,2
5663,Gorbachev,2.7452883726349685e-05,2.087721574549256e-05,27,13,14
5664,Gordon,6.098312339212028e-05,2.4327995207557487e-05,49,29,20
5665,Gore,2.5357243747239038e-05,2.6053384938589907e-05,29,12,17
5666,Gorge,4.400843956132392e-06,5.348708166200577e-06,5,2,3
5667,Gorgeou,6.496483935243052e-06,1.7253897310324457e-07,3,3,0
5668,Gorilla,8.592123914353715e-06,7.074097897233022e-06,8,4,4
5669,Gorka,8.592123914353715e-06,1.7253897310324457e-07,4,4,0
5670,Gorsuch,9.451336305789087e-05,6.746273848336857e-05,91,48,43
5671,Got,0.00018881716211787043,0.00017443690180738014,208,95,113
5672,Gotcha,4.400843956132392e-06,1.8979287041356905e-06,3,2,1
5673,Gotta,2.3052039770217305e-06,8.79948762826546e-06,7,1,6
5674,Gotten,1.0687763893464371e-05,1.2250267090330355e-05,13,5,8
5675,Gottesfeld,2.3052039770217305e-06,8.79948762826546e-06,6,1,5
5676,Gottfrid,6.496483935243052e-06,5.348708166200577e-06,6,3,3
5677,Gottlieb,2.3052039770217305e-06,5.348708166200577e-06,5,1,4
5678,Gov,0.00019091280209698145,0.0002520794397038401,282,113,169
5679,Goverment,4.400843956132392e-06,1.8979287041356905e-06,4,3,1
5680,Govern,4.400843956132392e-06,5.348708166200577e-06,5,2,3
5681,Governance,2.3052039770217305e-06,3.6233184351681345e-06,4,2,2
5682,Governing,8.592123914353715e-06,7.074097897233022e-06,10,5,5
5683,Government,0.0005052587989635808,0.0005574734220965829,632,275,357
5684,GovernmentFunded,4.400843956132392e-06,1.8979287041356905e-06,3,2,1
5685,Governor,0.0002244430417627521,0.0003090173008279106,316,125,191
5686,Govt,8.193952318322689e-05,6.573734875233614e-05,90,45,45
5687,Gowdy,4.400843956132392e-06,2.2602605476525032e-05,21,5,16
5688,Gra,4.400843956132392e-06,3.6233184351681345e-06,4,2,2
5689,Grab,1.6974683830796368e-05,2.6053384938589907e-05,23,8,15
5690,Grace,2.3052039770217305e-06,1.2250267090330355e-05,12,1,11
5691,Grad,1.0687763893464371e-05,1.052487735929791e-05,12,6,6
5692,Grade,6.496483935243052e-06,1.2250267090330355e-05,11,3,8
5693,Graduate,2.116596378901769e-05,1.9151826014460126e-05,23,11,12
5694,Graduation,1.0687763893464371e-05,8.79948762826546e-06,11,5,6
5695,Graffiti,4.400843956132392e-06,7.074097897233022e-06,6,2,4
5696,Graham,6.307876337123095e-05,6.746273848336857e-05,82,37,45
5697,GrahamCassidy,1.6974683830796368e-05,5.348708166200577e-06,11,8,3
5698,Grail,4.400843956132392e-06,1.8979287041356905e-06,3,2,1
5699,Grain,2.095639979110664e-07,5.348708166200577e-06,3,0,3
5700,Gram,4.400843956132392e-06,1.8979287041356905e-06,3,2,1
5701,Grammy,8.592123914353715e-06,5.348708166200577e-06,8,4,4
5702,Grand,7.565260324589493e-05,4.1581892517881935e-05,65,38,27
5703,Granddaughter,6.496483935243052e-06,1.8979287041356905e-06,4,3,1
5704,Grande,6.496483935243052e-06,5.348708166200577e-06,8,3,5
5705,Grandfather,4.400843956132392e-06,1.8979287041356905e-06,3,2,1
5706,Grandma,1.0687763893464371e-05,7.074097897233022e-06,9,5,4
5707,Grandmother,6.496483935243052e-06,1.3975656821362803e-05,11,3,8
5708,Grandparent,2.095639979110664e-07,7.074097897233022e-06,4,0,4
5709,Grandson,6.496483935243052e-06,5.348708166200577e-06,6,3,3
5710,Granite,1.0687763893464371e-05,3.6233184351681345e-06,9,7,2
5711,Grant,1.9070323809907035e-05,2.6053384938589907e-05,29,10,19
5712,Granted,1.278340387257504e-05,5.348708166200577e-06,13,6,7
5713,Graph,4.400843956132392e-06,1.7253897310324457e-07,3,3,0
5714,Graphic,2.7452883726349685e-05,2.2602605476525032e-05,30,13,17
5715,Grapple,6.496483935243052e-06,5.348708166200577e-06,10,5,5
5716,Gras,4.400843956132392e-06,1.7253897310324457e-07,3,3,0
5717,Grasp,6.496483935243052e-06,1.8979287041356905e-06,4,3,1
5718,Grassley,3.3739803663681634e-05,2.777877466962238e-05,34,16,18
5719,Grassroot,6.496483935243052e-06,1.742643628342769e-05,13,3,10
5720,Grateful,2.3052039770217305e-06,1.8979287041356905e-06,4,2,2
5721,Gratitude,6.496483935243052e-06,1.3975656821362803e-05,12,4,8
5722,Grave,3.3739803663681634e-05,1.570104655239525e-05,25,16,9
5723,Gravitational,2.3052039770217305e-06,3.6233184351681345e-06,4,1,3
5724,Gravity,8.592123914353715e-06,3.6233184351681345e-06,6,4,2
5725,Gray,2.5357243747239038e-05,2.777877466962238e-05,34,12,22
5726,Grayson,1.0687763893464371e-05,1.8979287041356905e-06,9,7,2
5727,Great,0.00029779044103162505,0.00023655093212454826,310,151,159
5728,Greater,2.326160376812834e-05,2.4327995207557487e-05,26,11,15
5729,Greatest,3.3739803663681634e-05,2.2602605476525032e-05,33,19,14
5730,Greatnes,4.400843956132392e-06,7.074097897233022e-06,6,2,4
5731,Greece,0.0003208424808018424,0.00029693957271068364,368,168,200
5732,Greed,8.592123914353715e-06,1.052487735929791e-05,11,5,6
5733,Greek,0.00027054712130318646,0.0002520794397038401,301,137,164
5734,Green,0.00010708720293255492,0.0001278513790695043,140,57,83
5735,Greenberg,2.3052039770217305e-06,7.074097897233022e-06,5,1,4
5736,Greenblatt,4.400843956132392e-06,1.8979287041356905e-06,3,2,1
5737,Greene,2.7452883726349685e-05,3.2954943862719716e-05,34,13,21
5738,Greenhouse,6.496483935243052e-06,5.348708166200577e-06,7,4,3
5739,Greenland,2.116596378901769e-05,1.742643628342769e-05,21,10,11
5740,Greenpeace,5.888748341300963e-05,3.640572332478458e-05,52,29,23
5741,Greenwald,4.212236358012434e-05,4.6758061710979285e-05,50,22,28
5742,Greenwich,2.3052039770217305e-06,3.6233184351681345e-06,3,1,2
5743,Greet,1.0687763893464371e-05,3.6233184351681345e-06,7,5,2
5744,Greeting,6.496483935243052e-06,3.6233184351681345e-06,5,3,2
5745,Greg,3.583544364279237e-05,4.50326719799468e-05,46,18,28
5746,Gregg,4.400843956132392e-06,5.348708166200577e-06,5,2,3
5747,Gregory,6.496483935243052e-06,1.8979287041356905e-06,5,3,2
5748,Greiten,1.0687763893464371e-05,1.570104655239525e-05,14,5,9
5749,Grenada,2.3052039770217305e-06,1.8979287041356905e-06,3,2,1
5750,Grenoble,2.095639979110664e-07,3.6233184351681345e-06,3,0,3
5751,Greta,2.3052039770217305e-06,5.348708166200577e-06,4,1,3
5752,Gretchen,8.592123914353715e-06,3.6233184351681345e-06,6,4,2
5753,Grew,4.400843956132392e-06,3.6233184351681345e-06,5,3,2
5754,Grey,2.3052039770217305e-06,1.052487735929791e-05,7,1,6
5755,Greyhound,4.400843956132392e-06,5.348708166200577e-06,5,2,3
5756,Grid,1.0687763893464371e-05,1.3975656821362803e-05,14,5,9
5757,Gridlock,6.496483935243052e-06,1.8979287041356905e-06,5,4,1
5758,Grief,6.496483935243052e-06,8.79948762826546e-06,8,3,5
5759,Grievance,2.095639979110664e-07,1.3975656821362803e-05,8,0,8
5760,Grieve,1.0687763893464371e-05,1.8979287041356905e-06,6,5,1
5761,Grieving,4.400843956132392e-06,5.348708166200577e-06,5,2,3
5762,Griffin,2.3052039770217305e-06,8.79948762826546e-06,10,4,6
5763,Griffith,2.095639979110664e-07,5.348708166200577e-06,4,0,4
5764,Grill,1.9070323809907035e-05,1.570104655239525e-05,20,9,11
5765,Grilled,2.3052039770217305e-06,1.8979287041356905e-06,3,2,1
5766,Grim,2.116596378901769e-05,8.79948762826546e-06,15,10,5
5767,Grime,4.400843956132392e-06,5.348708166200577e-06,5,2,3
5768,Grimm,2.3052039770217305e-06,1.052487735929791e-05,7,1,6
5769,Grip,4.400843956132392e-06,3.6233184351681345e-06,6,2,4
5770,Gripe,2.3052039770217305e-06,5.348708166200577e-06,4,1,3
5771,Grisham,2.3052039770217305e-06,5.348708166200577e-06,4,1,3
5772,Grizzly,2.3052039770217305e-06,3.6233184351681345e-06,3,1,2
5773,Grocery,2.5357243747239038e-05,1.742643628342769e-05,23,13,10
5774,Groom,2.095639979110664e-07,5.348708166200577e-06,3,0,3
5775,Groove,2.3052039770217305e-06,3.6233184351681345e-06,3,1,2
5776,Groped,1.0687763893464371e-05,5.348708166200577e-06,8,5,3
5777,Groping,6.496483935243052e-06,8.79948762826546e-06,9,4,5
5778,Gros,1.0687763893464371e-05,1.2250267090330355e-05,13,5,8
5779,Grossly,2.3052039770217305e-06,3.6233184351681345e-06,3,1,2
5780,Ground,4.4218003559234974e-05,5.020884117304414e-05,52,23,29
5781,Groundbreaking,2.095639979110664e-07,3.6233184351681345e-06,3,1,2
5782,Grounded,6.496483935243052e-06,1.7253897310324457e-07,3,3,0
5783,Groundhog,2.095639979110664e-07,7.074097897233022e-06,5,0,5
5784,Groundwater,6.496483935243052e-06,3.6233184351681345e-06,5,3,2
5785,Groundwork,2.095639979110664e-07,8.79948762826546e-06,5,0,5
5786,Group,0.00035437272046761313,0.0003728567208761114,426,184,242
5787,Groupon,2.3052039770217305e-06,5.348708166200577e-06,5,1,4
5788,Grouse,4.400843956132392e-06,1.8979287041356905e-06,3,2,1
5789,Grow,6.098312339212028e-05,6.056117955923882e-05,74,34,40
5790,Grower,4.400843956132392e-06,3.6233184351681345e-06,4,2,2
5791,Growing,8.403516316233764e-05,9.161819471782287e-05,106,45,61
5792,Growth,3.7931083621902995e-05,5.5385010366141504e-05,53,21,32
5793,Gruesome,2.3052039770217305e-06,1.8979287041356905e-06,3,1,2
5794,Guadalupe,2.095639979110664e-07,3.6233184351681345e-06,3,0,3
5795,Guam,8.592123914353715e-06,7.074097897233022e-06,8,4,4
5796,Guangdong,2.3052039770217305e-06,1.8979287041356905e-06,3,2,1
5797,Guangzhou,4.400843956132392e-06,3.6233184351681345e-06,4,2,2
5798,Guantanamo,9.24177230787802e-05,8.299124606266055e-05,99,46,53
5799,Guantnamo,2.954852370546031e-05,2.087721574549256e-05,27,14,13
5800,Guantánamo,8.592123914353715e-06,1.8979287041356905e-06,5,4,1
5801,Guarantee,1.0687763893464371e-05,1.052487735929791e-05,15,6,9
5802,Guaranteed,2.3052039770217305e-06,1.052487735929791e-05,7,1,6
5803,Guard,8.193952318322689e-05,9.161819471782287e-05,102,45,57
5804,Guardian,0.00010289592297433347,8.816741525575797e-05,118,57,61
5805,Guardsman,2.3052039770217305e-06,3.6233184351681345e-06,4,1,3
5806,Guatemala,4.840928351745632e-05,4.330728224891437e-05,54,28,26
5807,Guatemalan,2.116596378901769e-05,2.4327995207557487e-05,25,10,15
5808,Gubernatorial,1.6974683830796368e-05,2.2602605476525032e-05,23,10,13
5809,Guccifer,2.095639979110664e-07,5.348708166200577e-06,3,0,3
5810,Guerrero,6.496483935243052e-06,5.348708166200577e-06,6,3,3
5811,Gues,1.6974683830796368e-05,1.3975656821362803e-05,20,9,11
5812,Guest,1.6974683830796368e-05,2.4327995207557487e-05,27,9,18
5813,Guidance,2.3052039770217305e-06,1.570104655239525e-05,11,1,10
5814,Guide,5.260056347567764e-05,4.50326719799468e-05,55,25,30
5815,Guideline,2.3052039770217305e-06,5.348708166200577e-06,5,2,3
5816,Guild,2.3052039770217305e-06,5.348708166200577e-06,5,1,4
5817,Guilty,6.517440335034157e-05,7.263890767646595e-05,81,33,48
5818,Guinea,5.4696203454788295e-05,5.1934230904076595e-05,60,28,32
5819,GuineaBissau,2.3052039770217305e-06,3.6233184351681345e-06,3,1,2
5820,Guinnes,4.400843956132392e-06,7.074097897233022e-06,8,3,5
5821,Guitar,6.496483935243052e-06,1.8979287041356905e-06,4,3,1
5822,Gul,4.400843956132392e-06,1.7253897310324457e-07,3,3,0
5823,Gulag,1.0687763893464371e-05,1.7253897310324457e-07,6,5,1
5824,Gulf,0.00011127848289077625,0.0001019705331040174,126,61,65
5825,Gun,0.00045496343946492464,0.00044704847931050624,536,251,285
5826,Gunfire,2.3052039770217305e-06,1.052487735929791e-05,9,3,6
5827,Gunman,4.002672360101368e-05,6.746273848336857e-05,66,20,46
5828,Gunning,2.3052039770217305e-06,1.7253897310324457e-07,3,2,1
5829,Gunshot,6.496483935243052e-06,7.074097897233022e-06,7,3,4
5830,Gurion,4.400843956132392e-06,1.7253897310324457e-07,3,2,1
5831,Gurkha,2.3052039770217305e-06,5.348708166200577e-06,4,1,3
5832,Guru,2.095639979110664e-07,8.79948762826546e-06,7,1,6
5833,Gut,1.6974683830796368e-05,3.2954943862719716e-05,28,8,20
5834,Gutierrez,2.3052039770217305e-06,3.6233184351681345e-06,3,1,2
5835,Gutiérrez,2.3052039770217305e-06,8.79948762826546e-06,6,1,5
5836,Gutted,2.095639979110664e-07,5.348708166200577e-06,3,0,3
5837,Gutting,2.3052039770217305e-06,7.074097897233022e-06,6,1,5
5838,Guy,0.00012385232276544028,8.989280498679035e-05,119,61,58
5839,Guzman,1.0687763893464371e-05,8.79948762826546e-06,10,5,5
5840,Gwen,2.095639979110664e-07,3.6233184351681345e-06,5,1,4
5841,Gym,6.496483935243052e-06,5.348708166200577e-06,7,3,4
5842,Gymnastic,6.496483935243052e-06,1.7253897310324457e-07,3,3,0
5843,Gynecologist,2.095639979110664e-07,3.6233184351681345e-06,3,0,3
5844,Gypsy,1.6974683830796368e-05,1.052487735929791e-05,14,8,6
5845,H1N1,6.496483935243052e-06,1.052487735929791e-05,12,3,9
5846,H5N1,6.496483935243052e-06,1.7253897310324457e-07,3,3,0
5847,H7N9,8.592123914353715e-06,3.6233184351681345e-06,7,5,2
5848,HB,1.0687763893464371e-05,1.2250267090330355e-05,13,5,8
5849,HB2,1.278340387257504e-05,7.074097897233022e-06,10,6,4
5850,HBO,6.496483935243052e-06,5.348708166200577e-06,7,3,4
5851,HELP,4.400843956132392e-06,1.8979287041356905e-06,3,2,1
5852,HH,1.9070323809907035e-05,1.052487735929791e-05,19,12,7
5853,HILL,0.0002600689214076331,0.0002486286602417749,300,138,162
5854,HIV,0.00011337412286988677,0.00013130215853156914,144,60,84
5855,HIVAID,1.48790438516857e-05,1.742643628342769e-05,19,8,11
5856,HIVpositive,4.400843956132392e-06,1.052487735929791e-05,8,2,6
5857,HM,6.496483935243052e-06,5.348708166200577e-06,6,3,3
5858,HONY,6.496483935243052e-06,1.7253897310324457e-07,3,3,0
5859,HOUSTON,2.3052039770217305e-06,3.6233184351681345e-06,3,1,2
5860,HP,4.400843956132392e-06,1.3975656821362803e-05,11,3,8
5861,HPV,6.496483935243052e-06,7.074097897233022e-06,9,3,6
5862,HQ,1.6974683830796368e-05,2.777877466962238e-05,28,9,19
5863,HR,1.48790438516857e-05,7.074097897233022e-06,12,7,5
5864,HRW,2.3052039770217305e-06,1.2250267090330355e-05,11,2,9
5865,HSBC,5.260056347567764e-05,3.2954943862719716e-05,48,26,22
5866,HUD,2.116596378901769e-05,1.9151826014460126e-05,22,10,12
5867,HUFFPOLLSTER,0.00024120816159563723,0.00022792398346938586,277,127,150
5868,HUFFPOST,0.00025797328142852257,0.0002486286602417749,299,137,162
5869,HUGE,2.3052039770217305e-06,3.6233184351681345e-06,4,2,2
5870,HW,2.5357243747239038e-05,1.570104655239525e-05,23,13,10
5871,Haaland,2.095639979110664e-07,1.052487735929791e-05,6,0,6
5872,Haaretz,8.592123914353715e-06,1.9151826014460126e-05,21,7,14
5873,Habit,1.0687763893464371e-05,2.4327995207557487e-05,23,8,15
5874,Habitat,6.496483935243052e-06,1.8979287041356905e-06,7,5,2
5875,Hack,6.72700433294523e-05,6.228656929027126e-05,76,36,40
5876,Hacked,3.583544364279237e-05,3.985650278684949e-05,40,17,23
5877,Hacker,9.03220830996695e-05,0.00010024514337298497,109,46,63
5878,Hacking,7.146132328767358e-05,4.330728224891437e-05,61,35,26
5879,Hacktivist,2.095639979110664e-07,5.348708166200577e-06,3,0,3
5880,Hadfield,8.592123914353715e-06,7.074097897233022e-06,8,4,4
5881,Hadron,1.0687763893464371e-05,7.074097897233022e-06,10,5,5
5882,Hagan,6.496483935243052e-06,1.7253897310324457e-07,3,3,0
5883,Hagel,8.592123914353715e-06,1.2250267090330355e-05,12,5,7
5884,Hague,1.278340387257504e-05,2.2602605476525032e-05,22,6,16
5885,Haider,2.3052039770217305e-06,3.6233184351681345e-06,3,1,2
5886,Hail,1.0687763893464371e-05,1.570104655239525e-05,18,6,12
5887,Hailed,4.400843956132392e-06,3.6233184351681345e-06,4,2,2
5888,Hair,2.095639979110664e-07,1.2250267090330355e-05,9,0,9
5889,Haircut,8.592123914353715e-06,1.7253897310324457e-07,4,4,0
5890,Haiti,0.00015109564249387862,0.00012440059960743937,161,85,76
5891,Haitian,2.954852370546031e-05,3.468033359375216e-05,40,17,23
5892,Haiyan,8.592123914353715e-06,1.052487735929791e-05,10,4,6
5893,Hajj,1.278340387257504e-05,8.79948762826546e-06,11,6,5
5894,Halal,2.095639979110664e-07,5.348708166200577e-06,3,0,3
5895,Haley,3.3739803663681634e-05,3.122955413168725e-05,42,19,23
5896,Half,0.0001154697628489974,0.00010024514337298497,124,57,67
5897,Halifax,2.3052039770217305e-06,3.6233184351681345e-06,3,1,2
5898,Hall,7.355696326678427e-05,6.228656929027126e-05,73,37,36
5899,Halliburton,4.400843956132392e-06,8.79948762826546e-06,7,2,5
5900,Halloween,2.5357243747239038e-05,3.468033359375216e-05,34,12,22
5901,Halt,3.7931083621902995e-05,4.6758061710979285e-05,50,19,31
5902,Halted,8.592123914353715e-06,5.348708166200577e-06,8,4,4
5903,Halting,2.3052039770217305e-06,3.6233184351681345e-06,3,1,2
5904,Hama,0.000304077360968957,0.00032799658786926807,381,166,215
5905,Hamas,6.496483935243052e-06,1.7253897310324457e-07,3,3,0
5906,Hamburg,8.592123914353715e-06,1.3975656821362803e-05,12,4,8
5907,Hamid,2.116596378901769e-05,1.3975656821362803e-05,22,13,9
5908,Hamilton,1.9070323809907035e-05,7.074097897233022e-06,13,9,4
5909,Hammer,2.095639979110664e-07,1.2250267090330355e-05,9,0,9
5910,Hammered,6.496483935243052e-06,3.6233184351681345e-06,5,3,2
5911,Hammond,1.0687763893464371e-05,1.052487735929791e-05,12,6,6
5912,HampM,4.400843956132392e-06,5.348708166200577e-06,5,2,3
5913,Hampshire,0.00016995640230587486,6.401195902130366e-05,132,89,43
5914,Hampton,4.400843956132392e-06,3.6233184351681345e-06,4,2,2
5915,Hamster,2.3052039770217305e-06,1.8979287041356905e-06,3,2,1
5916,Hamza,6.496483935243052e-06,1.8979287041356905e-06,4,3,1
5917,Han,2.326160376812834e-05,1.052487735929791e-05,17,11,6
5918,Hand,7.774824322500554e-05,0.00010887209202814718,111,44,67
5919,Handbag,2.095639979110664e-07,5.348708166200577e-06,3,0,3
5920,Handbook,2.3052039770217305e-06,3.6233184351681345e-06,4,1,3
5921,Handcuff,2.3052039770217305e-06,1.8979287041356905e-06,3,1,2
5922,Handcuffed,4.400843956132392e-06,8.79948762826546e-06,7,2,5
5923,Handed,2.095639979110664e-07,5.348708166200577e-06,3,0,3
5924,Handel,8.592123914353715e-06,3.6233184351681345e-06,6,4,2
5925,Handing,8.592123914353715e-06,1.3975656821362803e-05,13,5,8
5926,Handle,1.6974683830796368e-05,2.777877466962238e-05,27,9,18
5927,Handled,2.3052039770217305e-06,1.8979287041356905e-06,3,2,1
5928,Handling,2.116596378901769e-05,1.3975656821362803e-05,20,11,9
5929,Handout,4.400843956132392e-06,5.348708166200577e-06,7,3,4
5930,Handshake,2.3052039770217305e-06,7.074097897233022e-06,5,1,4
5931,Handy,2.095639979110664e-07,5.348708166200577e-06,3,0,3
5932,Hang,1.9070323809907035e-05,2.087721574549256e-05,26,11,15
5933,Hanging,6.496483935243052e-06,5.348708166200577e-06,7,4,3
5934,Haniyeh,2.095639979110664e-07,3.6233184351681345e-06,3,1,2
5935,Hank,4.400843956132392e-06,7.074097897233022e-06,6,2,4
5936,Hannah,2.3052039770217305e-06,5.348708166200577e-06,4,1,3
5937,Hannity,1.6974683830796368e-05,2.9504164400654783e-05,28,8,20
5938,Hanoi,6.496483935243052e-06,5.348708166200577e-06,6,3,3
5939,Hansen,4.400843956132392e-06,5.348708166200577e-06,5,2,3
5940,Happen,8.403516316233764e-05,0.0001036959228350498,110,44,66
5941,Happened,5.4696203454788295e-05,6.056117955923882e-05,68,29,39
5942,Happening,1.0687763893464371e-05,1.742643628342769e-05,16,5,11
5943,Happier,6.496483935243052e-06,7.074097897233022e-06,7,3,4
5944,Happiest,2.3052039770217305e-06,5.348708166200577e-06,4,1,3
5945,Happily,2.3052039770217305e-06,3.6233184351681345e-06,3,1,2
5946,Happines,1.0687763893464371e-05,2.2602605476525032e-05,20,6,14
5947,Happy,7.146132328767358e-05,0.00011232287149021227,107,37,70
5948,Haram,9.03220830996695e-05,7.781507686956326e-05,96,44,52
5949,Haras,2.3052039770217305e-06,5.348708166200577e-06,5,1,4
5950,Harassed,1.48790438516857e-05,1.8979287041356905e-06,9,8,1
5951,Harasser,6.496483935243052e-06,5.348708166200577e-06,6,3,3
5952,Harassing,1.0687763893464371e-05,5.348708166200577e-06,8,5,3
5953,Harassment,9.660900303700153e-05,8.126585633162811e-05,102,51,51
5954,Harbor,1.278340387257504e-05,1.2250267090330355e-05,15,7,8
5955,Harbour,4.400843956132392e-06,1.8979287041356905e-06,3,2,1
5956,Hard,6.517440335034157e-05,0.0001036959228350498,107,38,69
5957,HardLiner,2.3052039770217305e-06,3.6233184351681345e-06,3,1,2
5958,HardRight,2.3052039770217305e-06,3.6233184351681345e-06,3,1,2
5959,Hardball,4.400843956132392e-06,1.7253897310324457e-07,3,2,1
5960,Hardee,4.400843956132392e-06,5.348708166200577e-06,7,2,5
5961,Harder,3.583544364279237e-05,3.2954943862719716e-05,38,18,20
5962,Hardest,2.3052039770217305e-06,1.570104655239525e-05,10,1,9
5963,Hardline,2.3052039770217305e-06,8.79948762826546e-06,6,1,5
5964,Hardliner,6.496483935243052e-06,1.8979287041356905e-06,4,3,1
5965,Hardly,8.592123914353715e-06,8.79948762826546e-06,13,5,8
5966,Hardship,2.095639979110664e-07,3.6233184351681345e-06,3,1,2
5967,Hari,4.400843956132392e-06,7.074097897233022e-06,7,2,5
5968,Hariri,2.095639979110664e-07,1.3975656821362803e-05,8,0,8
5969,Harlem,2.3052039770217305e-06,1.052487735929791e-05,7,1,6
5970,Harley,6.496483935243052e-06,5.348708166200577e-06,6,3,3
5971,Harm,2.116596378901769e-05,1.3975656821362803e-05,22,12,10
5972,Harmed,2.095639979110664e-07,3.6233184351681345e-06,3,1,2
5973,Harmful,8.592123914353715e-06,1.8979287041356905e-06,5,4,1
5974,Harming,6.496483935243052e-06,1.8979287041356905e-06,5,4,1
5975,Harmles,6.496483935243052e-06,1.7253897310324457e-07,3,3,0
5976,Harold,4.400843956132392e-06,1.052487735929791e-05,8,2,6
5977,Harper,6.72700433294523e-05,6.228656929027126e-05,76,35,41
5978,Harri,2.7452883726349685e-05,5.711040009717395e-05,50,15,35
5979,Harriet,1.0687763893464371e-05,1.8979287041356905e-06,6,5,1
5980,Harrison,1.48790438516857e-05,5.348708166200577e-06,10,7,3
5981,Harrowing,8.592123914353715e-06,5.348708166200577e-06,7,4,3
5982,Harry,8.403516316233764e-05,0.0001019705331040174,112,50,62
5983,Harsh,1.278340387257504e-05,1.3975656821362803e-05,17,9,8
5984,Harsher,2.3052039770217305e-06,1.7253897310324457e-07,3,2,1
5985,Hart,8.592123914353715e-06,3.6233184351681345e-06,8,6,2
5986,Harvard,4.002672360101368e-05,5.3659620635109e-05,51,19,32
5987,Harvest,4.400843956132392e-06,1.2250267090330355e-05,9,2,7
5988,Harvey,6.517440335034157e-05,0.0001295767688005365,112,37,75
5989,Hasan,2.3052039770217305e-06,3.6233184351681345e-06,4,1,3
5990,Hash,2.095639979110664e-07,5.348708166200577e-06,3,0,3
5991,Hashtag,6.496483935243052e-06,8.79948762826546e-06,8,3,5
5992,Haslam,4.400843956132392e-06,3.6233184351681345e-06,4,2,2
5993,Hasn,6.496483935243052e-06,8.79948762826546e-06,8,3,5
5994,Haspel,8.592123914353715e-06,2.4327995207557487e-05,18,4,14
5995,Hassan,2.326160376812834e-05,7.074097897233022e-06,17,12,5
5996,Hastert,1.48790438516857e-05,7.074097897233022e-06,14,8,6
5997,Hasty,2.3052039770217305e-06,3.6233184351681345e-06,3,1,2
5998,Hat,8.592123914353715e-06,1.742643628342769e-05,17,5,12
5999,Hatch,1.0687763893464371e-05,4.1581892517881935e-05,32,6,26
6000,Hate,0.0001259479627445509,0.0001036959228350498,134,67,67
6001,Hated,8.592123914353715e-06,1.052487735929791e-05,10,4,6
6002,Hateful,8.592123914353715e-06,7.074097897233022e-06,10,5,5
6003,Hater,8.592123914353715e-06,1.2250267090330355e-05,11,4,7
6004,Hathaway,1.0687763893464371e-05,1.8979287041356905e-06,6,5,1
6005,Hating,8.592123914353715e-06,7.074097897233022e-06,8,4,4
6006,Hatred,1.0687763893464371e-05,1.3975656821362803e-05,13,5,8
6007,Haul,8.592123914353715e-06,5.348708166200577e-06,9,5,4
6008,Haunt,8.592123914353715e-06,1.052487735929791e-05,10,4,6
6009,Haunting,2.3052039770217305e-06,8.79948762826546e-06,7,2,5
6010,Havana,2.116596378901769e-05,1.2250267090330355e-05,18,10,8
6011,Haven,8.592123914353715e-06,1.2250267090330355e-05,12,4,8
6012,Havoc,2.3052039770217305e-06,5.348708166200577e-06,4,1,3
6013,Hawaii,7.355696326678427e-05,0.00010024514337298497,96,38,58
6014,Hawaiian,6.496483935243052e-06,7.074097897233022e-06,8,4,4
6015,Hawk,6.496483935243052e-06,2.087721574549256e-05,17,4,13
6016,Hawking,3.583544364279237e-05,3.122955413168725e-05,39,18,21
6017,Hawley,8.592123914353715e-06,3.6233184351681345e-06,7,5,2
6018,Hayden,6.496483935243052e-06,5.348708166200577e-06,7,3,4
6019,Haye,1.0687763893464371e-05,1.8979287041356905e-06,6,5,1
6020,Hazard,2.3052039770217305e-06,3.6233184351681345e-06,4,1,3
6021,Hazardou,2.3052039770217305e-06,5.348708166200577e-06,4,1,3
6022,Hazare,1.0687763893464371e-05,1.7253897310324457e-07,5,5,0
6023,Hazy,2.095639979110664e-07,5.348708166200577e-06,3,0,3
6024,He,0.00045705907944403545,0.000379758279800241,491,243,248
6025,Head,0.00016157384238943198,0.00013992910718673112,177,83,94
6026,HeadSpinning,6.496483935243052e-06,1.7253897310324457e-07,3,3,0
6027,Headache,6.496483935243052e-06,1.8979287041356905e-06,4,3,1
6028,Headed,1.48790438516857e-05,1.2250267090330355e-05,17,10,7
6029,Heading,1.0687763893464371e-05,1.3975656821362803e-05,15,6,9
6030,Headline,3.1644163684570994e-05,5.020884117304414e-05,48,16,32
6031,Headphone,4.400843956132392e-06,5.348708166200577e-06,5,2,3
6032,Headquarters,1.278340387257504e-05,7.074097897233022e-06,12,7,5
6033,Headset,4.400843956132392e-06,1.8979287041356905e-06,3,2,1
6034,Heal,8.592123914353715e-06,1.052487735929791e-05,11,4,7
6035,Healing,6.496483935243052e-06,1.570104655239525e-05,12,3,9
6036,Health,0.0007253009967702005,0.0006972299903102106,830,376,454
6037,HealthCareGov,4.400843956132392e-06,1.8979287041356905e-06,3,2,1
6038,HealthCaregov,6.496483935243052e-06,5.348708166200577e-06,6,3,3
6039,Healthcare,2.326160376812834e-05,1.570104655239525e-05,23,12,11
6040,Healthier,8.592123914353715e-06,7.074097897233022e-06,8,4,4
6041,Healthy,2.5357243747239038e-05,2.087721574549256e-05,26,13,13
6042,Heap,4.400843956132392e-06,1.8979287041356905e-06,3,2,1
6043,Hear,5.260056347567764e-05,4.50326719799468e-05,57,28,29
6044,Heard,2.326160376812834e-05,2.6053384938589907e-05,28,12,16
6045,Hearing,9.03220830996695e-05,9.334358444885519e-05,110,50,60
6046,Heart,4.212236358012434e-05,6.228656929027126e-05,65,25,40
6047,Heartbeat,6.496483935243052e-06,1.8979287041356905e-06,5,3,2
6048,Heartbreaking,1.6974683830796368e-05,7.074097897233022e-06,13,9,4
6049,Heartfelt,4.400843956132392e-06,5.348708166200577e-06,7,3,4
6050,Heartland,4.400843956132392e-06,7.074097897233022e-06,6,2,4
6051,Heartwarming,6.496483935243052e-06,7.074097897233022e-06,8,3,5
6052,Heat,3.583544364279237e-05,3.640572332478458e-05,48,22,26
6053,Heated,4.400843956132392e-06,5.348708166200577e-06,5,2,3
6054,Heath,6.496483935243052e-06,1.7253897310324457e-07,3,3,0
6055,Heather,1.6974683830796368e-05,5.348708166200577e-06,12,9,3
6056,Heathrow,1.0687763893464371e-05,8.79948762826546e-06,12,5,7
6057,Heating,4.400843956132392e-06,7.074097897233022e-06,6,2,4
6058,Heaven,4.400843956132392e-06,1.8979287041356905e-06,3,2,1
6059,Heavily,1.278340387257504e-05,7.074097897233022e-06,11,7,4
6060,Heavy,2.116596378901769e-05,2.2602605476525032e-05,24,10,14
6061,Heavyweight,2.3052039770217305e-06,3.6233184351681345e-06,4,2,2
6062,Hebdo,6.517440335034157e-05,3.8131113055817005e-05,56,31,25
6063,Hebrew,1.6974683830796368e-05,1.3975656821362803e-05,16,8,8
6064,Hebron,1.278340387257504e-05,1.9151826014460126e-05,17,6,11
6065,Heck,2.3052039770217305e-06,1.052487735929791e-05,7,1,6
6066,Heckled,2.3052039770217305e-06,5.348708166200577e-06,4,1,3
6067,Heckler,8.592123914353715e-06,3.6233184351681345e-06,7,4,3
6068,Hedge,1.48790438516857e-05,2.087721574549256e-05,20,7,13
6069,Heed,2.3052039770217305e-06,7.074097897233022e-06,6,1,5
6070,Heel,2.3052039770217305e-06,3.6233184351681345e-06,3,1,2
6071,Heidi,8.592123914353715e-06,3.6233184351681345e-06,6,4,2
6072,Height,1.278340387257504e-05,2.2602605476525032e-05,20,6,14
6073,Heightened,2.3052039770217305e-06,3.6233184351681345e-06,3,1,2
6074,Heil,6.496483935243052e-06,3.6233184351681345e-06,5,3,2
6075,Heir,4.400843956132392e-06,7.074097897233022e-06,8,2,6
6076,Heires,2.3052039770217305e-06,1.8979287041356905e-06,3,1,2
6077,Heist,4.400843956132392e-06,5.348708166200577e-06,6,2,4
6078,Held,4.6313643538345614e-05,4.1581892517881935e-05,54,26,28
6079,Helen,8.592123914353715e-06,8.79948762826546e-06,10,4,6
6080,Helena,4.400843956132392e-06,1.8979287041356905e-06,4,3,1
6081,Helicopter,2.7452883726349685e-05,2.6053384938589907e-05,35,17,18
6082,Helium,2.3052039770217305e-06,1.8979287041356905e-06,3,1,2
6083,Hell,0.00011337412286988677,0.00010887209202814718,136,64,72
6084,Heller,1.278340387257504e-05,8.79948762826546e-06,13,6,7
6085,Hello,1.9070323809907035e-05,1.2250267090330355e-05,21,12,9
6086,Helm,1.0687763893464371e-05,1.8979287041356905e-06,8,5,3
6087,Helmand,2.095639979110664e-07,7.074097897233022e-06,4,0,4
6088,Helmet,4.400843956132392e-06,1.2250267090330355e-05,9,2,7
6089,Helmut,2.095639979110664e-07,8.79948762826546e-06,5,0,5
6090,Help,0.0004633459993813674,0.00045912620742773343,548,249,299
6091,Helped,7.984388320411623e-05,6.746273848336857e-05,85,42,43
6092,Helping,7.565260324589493e-05,7.608968713853079e-05,92,40,52
6093,Helsinki,4.400843956132392e-06,3.6233184351681345e-06,6,3,3
6094,Hemisphere,4.400843956132392e-06,7.074097897233022e-06,7,3,4
6095,Hemp,6.496483935243052e-06,5.348708166200577e-06,6,3,3
6096,Hen,2.3052039770217305e-06,3.6233184351681345e-06,3,1,2
6097,Henderson,2.3052039770217305e-06,7.074097897233022e-06,6,1,5
6098,Henry,2.326160376812834e-05,2.777877466962238e-05,27,11,16
6099,Hepatiti,6.496483935243052e-06,7.074097897233022e-06,7,3,4
6100,Herald,1.0687763893464371e-05,1.8979287041356905e-06,7,6,1
6101,Herb,2.3052039770217305e-06,1.8979287041356905e-06,3,1,2
6102,Hercule,2.3052039770217305e-06,3.6233184351681345e-06,3,1,2
6103,Herd,2.095639979110664e-07,7.074097897233022e-06,5,1,4
6104,Here,0.0005262151987546874,0.0005022609507035446,598,274,324
6105,Heritage,4.002672360101368e-05,2.6053384938589907e-05,41,23,18
6106,Herman,1.0687763893464371e-05,5.348708166200577e-06,8,5,3
6107,Hermit,4.400843956132392e-06,1.8979287041356905e-06,3,2,1
6108,Hernandez,6.496483935243052e-06,1.052487735929791e-05,12,4,8
6109,Hero,8.403516316233764e-05,6.746273848336857e-05,88,42,46
6110,Heroic,2.3052039770217305e-06,1.2250267090330355e-05,9,1,8
6111,Heroin,4.4218003559234974e-05,4.50326719799468e-05,50,22,28
6112,Heroism,2.095639979110664e-07,1.8979287041356905e-06,3,1,2
6113,Herschel,4.400843956132392e-06,5.348708166200577e-06,5,2,3
6114,Hersh,4.400843956132392e-06,5.348708166200577e-06,5,2,3
6115,Hershey,6.496483935243052e-06,1.7253897310324457e-07,3,3,0
6116,Heslin,2.3052039770217305e-06,3.6233184351681345e-06,3,1,2
6117,Hewitt,6.496483935243052e-06,3.6233184351681345e-06,5,3,2
6118,Hewlett,2.3052039770217305e-06,3.6233184351681345e-06,3,1,2
6119,HewlettPackard,6.496483935243052e-06,5.348708166200577e-06,8,4,4
6120,Hey,4.4218003559234974e-05,4.50326719799468e-05,53,23,30
6121,Heyer,4.400843956132392e-06,1.8979287041356905e-06,3,2,1
6122,Heywood,2.3052039770217305e-06,5.348708166200577e-06,4,1,3
6123,Hezbollah,6.307876337123095e-05,4.6758061710979285e-05,63,31,32
6124,Hi,4.400843956132392e-06,5.348708166200577e-06,6,3,3
6125,Hick,2.116596378901769e-05,5.348708166200577e-06,13,10,3
6126,Hickenlooper,2.095639979110664e-07,7.074097897233022e-06,5,1,4
6127,Hid,6.496483935243052e-06,1.052487735929791e-05,9,3,6
6128,Hidalgo,6.496483935243052e-06,1.7253897310324457e-07,3,3,0
6129,Hidden,2.954852370546031e-05,3.8131113055817005e-05,42,16,26
6130,Hide,2.7452883726349685e-05,1.742643628342769e-05,32,16,16
6131,Hiding,1.9070323809907035e-05,1.742643628342769e-05,23,12,11
6132,Hierarchy,2.095639979110664e-07,3.6233184351681345e-06,3,1,2
6133,Higg,8.592123914353715e-06,1.8979287041356905e-06,6,5,1
6134,Higgin,6.496483935243052e-06,3.6233184351681345e-06,5,3,2
6135,High,0.00022025176180453062,0.0002382763218555804,271,113,158
6136,HighCapacity,6.496483935243052e-06,1.7253897310324457e-07,3,3,0
6137,HighPowered,2.095639979110664e-07,5.348708166200577e-06,3,0,3
6138,HighProfile,2.095639979110664e-07,5.348708166200577e-06,4,0,4
6139,HighSpeed,1.278340387257504e-05,1.052487735929791e-05,14,6,8
6140,HighStake,4.400843956132392e-06,1.8979287041356905e-06,3,2,1
6141,HighTech,6.496483935243052e-06,1.8979287041356905e-06,4,3,1
6142,Higher,3.583544364279237e-05,4.8483451442011706e-05,49,19,30
6143,Highest,1.9070323809907035e-05,1.570104655239525e-05,25,11,14
6144,Highland,8.592123914353715e-06,3.6233184351681345e-06,6,4,2
6145,Highlight,4.4218003559234974e-05,3.8131113055817005e-05,44,22,22
6146,Highly,2.7452883726349685e-05,1.570104655239525e-05,24,14,10
6147,Highprofile,2.095639979110664e-07,5.348708166200577e-06,5,2,3
6148,Highway,4.212236358012434e-05,3.468033359375216e-05,43,20,23
6149,Hijab,2.3052039770217305e-06,1.8979287041356905e-06,4,2,2
6150,Hijack,2.3052039770217305e-06,1.3975656821362803e-05,11,2,9
6151,Hijacked,6.496483935243052e-06,8.79948762826546e-06,9,4,5
6152,Hijacker,6.496483935243052e-06,1.8979287041356905e-06,5,3,2
6153,Hike,3.3739803663681634e-05,2.087721574549256e-05,30,17,13
6154,Hiker,2.3052039770217305e-06,3.6233184351681345e-06,3,1,2
6155,Hilariou,1.0687763893464371e-05,1.570104655239525e-05,14,5,9
6156,Hilariously,1.0687763893464371e-05,8.79948762826546e-06,12,6,6
6157,Hilary,4.400843956132392e-06,3.6233184351681345e-06,4,2,2
6158,Hill,7.774824322500554e-05,0.00010887209202814718,110,38,72
6159,Hillary,0.001343514790607846,0.0010888934592545763,1403,687,716
6160,Hillbilly,2.3052039770217305e-06,5.348708166200577e-06,4,1,3
6161,Hilton,4.400843956132392e-06,1.8979287041356905e-06,3,2,1
6162,Himalaya,6.496483935243052e-06,1.8979287041356905e-06,4,3,1
6163,Himalayan,1.0687763893464371e-05,7.074097897233022e-06,9,5,4
6164,Hindu,5.050492349656699e-05,5.020884117304414e-05,58,25,33
6165,Hindustan,4.400843956132392e-06,1.8979287041356905e-06,3,2,1
6166,Hinge,6.496483935243052e-06,8.79948762826546e-06,8,3,5
6167,Hint,5.4696203454788295e-05,3.2954943862719716e-05,47,27,20
6168,Hinting,4.400843956132392e-06,3.6233184351681345e-06,4,2,2
6169,Hip,2.3052039770217305e-06,7.074097897233022e-06,6,2,4
6170,HipHop,2.095639979110664e-07,3.6233184351681345e-06,3,1,2
6171,Hipster,2.3052039770217305e-06,3.6233184351681345e-06,3,1,2
6172,Hire,5.260056347567764e-05,2.777877466962238e-05,47,28,19
6173,Hired,2.116596378901769e-05,1.742643628342769e-05,21,10,11
6174,Hiring,2.5357243747239038e-05,3.985650278684949e-05,43,15,28
6175,Hirono,8.592123914353715e-06,8.79948762826546e-06,9,4,5
6176,Hiroshima,2.116596378901769e-05,2.4327995207557487e-05,26,11,15
6177,Hirsi,8.592123914353715e-06,1.7253897310324457e-07,4,4,0
6178,Hispanic,4.840928351745632e-05,2.9504164400654783e-05,45,25,20
6179,Historian,1.48790438516857e-05,1.3975656821362803e-05,15,7,8
6180,Historic,8.193952318322689e-05,5.5385010366141504e-05,75,41,34
6181,Historical,4.400843956132392e-06,1.052487735929791e-05,10,3,7
6182,Historically,6.496483935243052e-06,1.052487735929791e-05,9,3,6
6183,History,0.00020767792192986646,0.00018133846073150993,225,108,117
6184,Hit,0.0002265386817418625,0.00022792398346938586,264,123,141
6185,Hitchen,2.7452883726349685e-05,3.6233184351681345e-06,17,13,4
6186,Hitler,7.565260324589493e-05,9.334358444885519e-05,101,44,57
6187,Hitman,6.496483935243052e-06,3.6233184351681345e-06,5,3,2
6188,Hitting,1.278340387257504e-05,1.570104655239525e-05,16,7,9
6189,Hizbollah,6.496483935243052e-06,1.8979287041356905e-06,4,3,1
6190,Hm,8.592123914353715e-06,1.7253897310324457e-07,4,4,0
6191,Hmm,2.3052039770217305e-06,3.6233184351681345e-06,3,1,2
6192,Hmong,2.095639979110664e-07,3.6233184351681345e-06,3,0,3
6193,Ho,2.3052039770217305e-06,8.79948762826546e-06,7,1,6
6194,Hoard,2.3052039770217305e-06,3.6233184351681345e-06,3,1,2
6195,Hoax,8.592123914353715e-06,1.3975656821362803e-05,13,5,8
6196,Hobby,1.278340387257504e-05,1.2250267090330355e-05,15,8,7
6197,Hochul,4.400843956132392e-06,3.6233184351681345e-06,4,2,2
6198,Hockey,8.592123914353715e-06,7.074097897233022e-06,8,4,4
6199,Hodge,2.095639979110664e-07,3.6233184351681345e-06,3,0,3
6200,Hog,6.496483935243052e-06,1.7253897310324457e-07,3,3,0
6201,Hogan,1.6974683830796368e-05,8.79948762826546e-06,15,9,6
6202,Hogg,2.3052039770217305e-06,7.074097897233022e-06,5,1,4
6203,Hogue,4.400843956132392e-06,1.8979287041356905e-06,3,2,1
6204,Hold,0.00011337412286988677,0.00011404826122124471,137,60,77
6205,Holder,2.326160376812834e-05,4.50326719799468e-05,38,11,27
6206,Holding,3.7931083621902995e-05,3.468033359375216e-05,45,23,22
6207,Holdout,2.3052039770217305e-06,3.6233184351681345e-06,5,2,3
6208,Hole,3.3739803663681634e-05,2.087721574549256e-05,34,21,13
6209,Holiday,7.984388320411623e-05,0.00012612598933847184,116,39,77
6210,Holland,8.592123914353715e-06,1.742643628342769e-05,14,4,10
6211,Hollande,3.7931083621902995e-05,2.777877466962238e-05,38,19,19
6212,Hollen,4.400843956132392e-06,3.6233184351681345e-06,4,2,2
6213,Hollow,4.400843956132392e-06,3.6233184351681345e-06,5,3,2
6214,Hollywood,6.307876337123095e-05,5.1934230904076595e-05,63,32,31
6215,Holme,4.400843956132392e-06,1.742643628342769e-05,12,2,10
6216,Holocaust,0.00014061744259832545,0.0001019705331040174,140,74,66
6217,Holt,2.3052039770217305e-06,8.79948762826546e-06,6,1,5
6218,Holy,5.050492349656699e-05,2.4327995207557487e-05,41,25,16
6219,Hom,4.002672360101368e-05,3.468033359375216e-05,42,20,22
6220,Homan,6.496483935243052e-06,1.8979287041356905e-06,4,3,1
6221,Home,0.0002537820014703013,0.0002520794397038401,309,136,173
6222,Homebuyer,4.400843956132392e-06,1.8979287041356905e-06,3,2,1
6223,Homecoming,2.3052039770217305e-06,8.79948762826546e-06,6,1,5
6224,Homeland,6.517440335034157e-05,5.1934230904076595e-05,73,36,37
6225,Homeles,0.00017205204228498542,0.00017271151207634748,205,94,111
6226,Homelessnes,4.4218003559234974e-05,3.122955413168725e-05,41,22,19
6227,Homeopathy,8.592123914353715e-06,1.8979287041356905e-06,5,4,1
6228,Homeowner,1.6974683830796368e-05,1.570104655239525e-05,18,9,9
6229,Hometown,4.400843956132392e-06,8.79948762826546e-06,10,2,8
6230,Homework,2.095639979110664e-07,5.348708166200577e-06,3,0,3
6231,Homicide,2.3052039770217305e-06,3.6233184351681345e-06,5,2,3
6232,Homo,6.496483935243052e-06,3.6233184351681345e-06,5,3,2
6233,Homophobic,6.496483935243052e-06,7.074097897233022e-06,7,3,4
6234,Homosexual,1.6974683830796368e-05,1.052487735929791e-05,14,8,6
6235,Homosexuality,1.6974683830796368e-05,1.052487735929791e-05,14,8,6
6236,Honda,1.48790438516857e-05,1.2250267090330355e-05,15,8,7
6237,Hondura,9.451336305789087e-05,5.020884117304414e-05,83,48,35
6238,Honduran,3.3739803663681634e-05,3.468033359375216e-05,41,17,24
6239,Honest,1.9070323809907035e-05,1.2250267090330355e-05,19,11,8
6240,Honestly,4.400843956132392e-06,8.79948762826546e-06,9,2,7
6241,Honesty,2.095639979110664e-07,5.348708166200577e-06,3,0,3
6242,Honey,4.400843956132392e-06,1.8979287041356905e-06,3,2,1
6243,Honeybee,1.0687763893464371e-05,3.6233184351681345e-06,8,5,3
6244,Honeymoon,2.3052039770217305e-06,5.348708166200577e-06,4,1,3
6245,Hong,0.0001825302421805385,0.0001382037174556987,184,95,89
6246,Honor,6.307876337123095e-05,6.401195902130366e-05,74,36,38
6247,Honorable,2.095639979110664e-07,3.6233184351681345e-06,3,0,3
6248,Honorary,4.400843956132392e-06,1.8979287041356905e-06,3,2,1
6249,Honored,1.48790438516857e-05,3.6233184351681345e-06,10,8,2
6250,Honoring,1.0687763893464371e-05,1.052487735929791e-05,11,5,6
6251,Honour,4.400843956132392e-06,7.074097897233022e-06,6,2,4
6252,Hood,1.0687763893464371e-05,1.9151826014460126e-05,18,6,12
6253,Hooded,4.400843956132392e-06,1.8979287041356905e-06,3,2,1
6254,Hook,3.583544364279237e-05,3.640572332478458e-05,42,19,23
6255,Hoosier,2.3052039770217305e-06,3.6233184351681345e-06,3,1,2
6256,Hoover,6.496483935243052e-06,3.6233184351681345e-06,5,3,2
6257,Hop,2.095639979110664e-07,5.348708166200577e-06,3,0,3
6258,Hope,0.00014271308257743603,0.0001347529379936339,157,73,84
6259,Hopeful,1.9070323809907035e-05,2.4327995207557487e-05,25,10,15
6260,Hopefully,2.3052039770217305e-06,3.6233184351681345e-06,3,1,2
6261,Hopi,8.592123914353715e-06,1.7253897310324457e-07,5,4,1
6262,Hoping,1.48790438516857e-05,1.7253897310324457e-07,7,7,0
6263,Horizon,1.9070323809907035e-05,2.777877466962238e-05,31,13,18
6264,Hormone,4.400843956132392e-06,1.8979287041356905e-06,4,2,2
6265,Hormuz,2.5357243747239038e-05,3.6233184351681345e-06,16,14,2
6266,Horn,1.9070323809907035e-05,1.3975656821362803e-05,18,9,9
6267,Horrible,1.0687763893464371e-05,1.570104655239525e-05,15,5,10
6268,Horrific,1.278340387257504e-05,1.9151826014460126e-05,17,6,11
6269,Horrified,2.3052039770217305e-06,1.8979287041356905e-06,3,2,1
6270,Horrifying,1.0687763893464371e-05,1.052487735929791e-05,11,5,6
6271,Horror,1.9070323809907035e-05,1.742643628342769e-05,21,10,11
6272,Horse,2.5357243747239038e-05,3.2954943862719716e-05,34,15,19
6273,Horton,2.095639979110664e-07,3.6233184351681345e-06,3,0,3
6274,Hosni,2.5357243747239038e-05,3.2954943862719716e-05,33,12,21
6275,Hospital,0.00010289592297433347,0.0001036959228350498,120,52,68
6276,Hospitalized,1.278340387257504e-05,8.79948762826546e-06,11,6,5
6277,Hossein,8.592123914353715e-06,1.8979287041356905e-06,5,4,1
6278,Host,7.355696326678427e-05,5.5385010366141504e-05,72,38,34
6279,Hostage,2.7452883726349685e-05,3.640572332478458e-05,39,16,23
6280,Hosted,2.3052039770217305e-06,5.348708166200577e-06,7,3,4
6281,Hostile,4.400843956132392e-06,5.348708166200577e-06,5,2,3
6282,Hostility,2.095639979110664e-07,7.074097897233022e-06,4,0,4
6283,Hosting,2.095639979110664e-07,1.052487735929791e-05,8,2,6
6284,Hot,2.5357243747239038e-05,4.8483451442011706e-05,44,14,30
6285,Hotel,7.565260324589493e-05,6.746273848336857e-05,88,41,47
6286,Hotline,1.0687763893464371e-05,7.074097897233022e-06,11,6,5
6287,Hotmail,4.400843956132392e-06,1.8979287041356905e-06,4,3,1
6288,Hotspot,4.400843956132392e-06,1.8979287041356905e-06,3,2,1
6289,Hottest,6.496483935243052e-06,1.2250267090330355e-05,13,5,8
6290,Houla,6.496483935243052e-06,1.8979287041356905e-06,4,3,1
6291,Hour,7.774824322500554e-05,7.091351794543343e-05,88,42,46
6292,Hourly,4.400843956132392e-06,3.6233184351681345e-06,4,2,2
6293,House,0.0017186343468686537,0.0018497903306398833,2113,908,1205
6294,Housed,2.095639979110664e-07,3.6233184351681345e-06,3,1,2
6295,Household,1.278340387257504e-05,1.2250267090330355e-05,16,8,8
6296,Housing,7.355696326678427e-05,5.883578982820635e-05,79,39,40
6297,Houston,4.212236358012434e-05,5.1934230904076595e-05,53,21,32
6298,Houthi,2.3052039770217305e-06,3.6233184351681345e-06,4,1,3
6299,Hoverboard,4.400843956132392e-06,1.8979287041356905e-06,4,3,1
6300,How,1.278340387257504e-05,1.742643628342769e-05,17,6,11
6301,Howard,4.212236358012434e-05,2.6053384938589907e-05,37,20,17
6302,Howe,2.3052039770217305e-06,1.8979287041356905e-06,4,3,1
6303,However,6.72700433294523e-05,7.608968713853079e-05,87,37,50
6304,Hoyer,2.3052039770217305e-06,3.6233184351681345e-06,3,1,2
6305,Hu,4.400843956132392e-06,5.348708166200577e-06,5,2,3
6306,Huawei,4.400843956132392e-06,1.8979287041356905e-06,4,3,1
6307,Hub,2.095639979110664e-07,5.348708166200577e-06,3,0,3
6308,Hubbard,2.3052039770217305e-06,7.074097897233022e-06,5,1,4
6309,Hubble,1.0687763893464371e-05,1.570104655239525e-05,15,6,9
6310,Hubri,6.496483935243052e-06,1.8979287041356905e-06,4,3,1
6311,Huckabee,5.260056347567764e-05,5.5385010366141504e-05,63,28,35
6312,Huddle,2.095639979110664e-07,5.348708166200577e-06,3,0,3
6313,Hudson,8.592123914353715e-06,5.348708166200577e-06,7,4,3
6314,HuffPollster,1.9070323809907035e-05,2.087721574549256e-05,21,9,12
6315,HuffPost,0.00043400703967381825,0.000438421530655344,528,240,288
6316,HuffPostYouGov,4.400843956132392e-06,7.074097897233022e-06,6,2,4
6317,Huffington,3.1644163684570994e-05,4.50326719799468e-05,47,18,29
6318,Hug,1.48790438516857e-05,8.79948762826546e-06,12,7,5
6319,Huge,0.00015109564249387862,0.0001295767688005365,165,84,81
6320,Hugh,1.278340387257504e-05,7.074097897233022e-06,10,6,4
6321,Hughe,4.400843956132392e-06,8.79948762826546e-06,7,2,5
6322,Hugo,4.6313643538345614e-05,5.1934230904076595e-05,62,28,34
6323,Huh,4.400843956132392e-06,7.074097897233022e-06,7,3,4
6324,Hulk,2.3052039770217305e-06,1.8979287041356905e-06,3,1,2
6325,Huma,8.592123914353715e-06,1.052487735929791e-05,10,4,6
6326,Human,0.0003438945205720597,0.00034870126464165704,423,192,231
6327,Humane,4.400843956132392e-06,1.2250267090330355e-05,9,2,7
6328,Humanitarian,1.278340387257504e-05,2.2602605476525032e-05,21,7,14
6329,Humanity,2.954852370546031e-05,1.570104655239525e-05,27,18,9
6330,Humankind,6.496483935243052e-06,1.7253897310324457e-07,3,3,0
6331,Humayun,6.496483935243052e-06,1.8979287041356905e-06,4,3,1
6332,Humble,2.3052039770217305e-06,7.074097897233022e-06,5,1,4
6333,Humiliated,2.3052039770217305e-06,1.7253897310324457e-07,3,2,1
6334,Humiliating,2.095639979110664e-07,8.79948762826546e-06,6,1,5
6335,Humiliation,6.496483935243052e-06,3.6233184351681345e-06,6,4,2
6336,Humongou,2.3052039770217305e-06,5.348708166200577e-06,4,1,3
6337,Humpback,6.496483935243052e-06,1.8979287041356905e-06,4,3,1
6338,Humphrey,2.3052039770217305e-06,5.348708166200577e-06,4,1,3
6339,Humvee,2.3052039770217305e-06,1.8979287041356905e-06,3,2,1
6340,Hundred,0.00019091280209698145,0.00017616229153841266,214,100,114
6341,Hungarian,2.7452883726349685e-05,3.122955413168725e-05,33,15,18
6342,Hungary,6.72700433294523e-05,8.126585633162811e-05,83,34,49
6343,Hunger,5.260056347567764e-05,4.330728224891437e-05,55,29,26
6344,Hungry,1.9070323809907035e-05,1.9151826014460126e-05,25,10,15
6345,Hunk,2.3052039770217305e-06,5.348708166200577e-06,4,1,3
6346,Hunt,5.050492349656699e-05,4.1581892517881935e-05,53,26,27
6347,Hunted,2.3052039770217305e-06,3.6233184351681345e-06,3,1,2
6348,Hunter,1.9070323809907035e-05,2.087721574549256e-05,22,9,13
6349,Hunting,8.592123914353715e-06,1.3975656821362803e-05,14,5,9
6350,Huntington,4.400843956132392e-06,3.6233184351681345e-06,4,2,2
6351,Huntsman,2.3052039770217305e-06,5.348708166200577e-06,4,1,3
6352,Hurdle,8.592123914353715e-06,1.052487735929791e-05,10,4,6
6353,Hurricane,7.984388320411623e-05,0.0001485560558418934,136,48,88
6354,Hurry,2.3052039770217305e-06,8.79948762826546e-06,6,1,5
6355,Hurt,5.6791843433898893e-05,7.436429740749831e-05,76,29,47
6356,Hurtful,2.095639979110664e-07,5.348708166200577e-06,3,0,3
6357,Hurting,2.954852370546031e-05,2.087721574549256e-05,28,14,14
6358,Husband,2.326160376812834e-05,3.640572332478458e-05,33,12,21
6359,HushMoney,2.095639979110664e-07,5.348708166200577e-06,3,0,3
6360,Hussein,4.6313643538345614e-05,3.122955413168725e-05,45,26,19
6361,Hustling,4.400843956132392e-06,1.7253897310324457e-07,3,2,1
6362,Hut,4.400843956132392e-06,3.6233184351681345e-06,4,2,2
6363,Hutchinson,2.095639979110664e-07,1.8979287041356905e-06,3,1,2
6364,Hutu,2.3052039770217305e-06,5.348708166200577e-06,6,2,4
6365,Hyatt,6.496483935243052e-06,1.7253897310324457e-07,5,3,2
6366,Hybrid,2.095639979110664e-07,7.074097897233022e-06,5,0,5
6367,Hyde,4.400843956132392e-06,3.6233184351681345e-06,4,2,2
6368,Hyderabad,6.496483935243052e-06,1.8979287041356905e-06,4,3,1
6369,Hype,2.3052039770217305e-06,7.074097897233022e-06,5,1,4
6370,Hyperloop,1.278340387257504e-05,1.7253897310324457e-07,6,6,0
6371,Hypocrisy,3.3739803663681634e-05,2.777877466962238e-05,36,18,18
6372,Hypocrite,2.3052039770217305e-06,5.348708166200577e-06,4,1,3
6373,Hypocritical,4.400843956132392e-06,3.6233184351681345e-06,5,2,3
6374,Hysteria,4.400843956132392e-06,3.6233184351681345e-06,4,2,2
6375,Hyundai,4.400843956132392e-06,1.2250267090330355e-05,10,2,8
6376,IAEA,2.5357243747239038e-05,2.777877466962238e-05,29,12,17
6377,IBM,8.592123914353715e-06,7.074097897233022e-06,9,4,5
6378,ICBM,8.592123914353715e-06,5.348708166200577e-06,9,5,4
6379,ICC,2.326160376812834e-05,1.570104655239525e-05,20,11,9
6380,ICE,6.307876337123095e-05,6.401195902130366e-05,72,30,42
6381,ICRC,2.095639979110664e-07,5.348708166200577e-06,3,0,3
6382,ICU,2.3052039770217305e-06,5.348708166200577e-06,6,1,5
6383,ID,0.00010499156295344414,9.851975364195259e-05,125,62,63
6384,IDF,9.660900303700153e-05,7.781507686956326e-05,104,51,53
6385,IEA,1.0687763893464371e-05,1.8979287041356905e-06,7,5,2
6386,IED,2.3052039770217305e-06,1.742643628342769e-05,11,1,10
6387,II,7.984388320411623e-05,9.506897417988779e-05,106,45,61
6388,III,2.7452883726349685e-05,3.985650278684949e-05,36,13,23
6389,IKEA,6.496483935243052e-06,1.570104655239525e-05,13,3,10
6390,IMF,9.03220830996695e-05,8.299124606266055e-05,97,46,51
6391,INDIA,2.3052039770217305e-06,3.6233184351681345e-06,3,1,2
6392,INFOGRAPHIC,2.095639979110664e-07,5.348708166200577e-06,4,1,3
6393,ING,2.3052039770217305e-06,3.6233184351681345e-06,3,1,2
6394,INTERPOL,2.3052039770217305e-06,3.6233184351681345e-06,3,1,2
6395,IOC,6.496483935243052e-06,1.052487735929791e-05,10,3,7
6396,IOWA,6.496483935243052e-06,1.7253897310324457e-07,4,4,0
6397,IP,2.326160376812834e-05,2.2602605476525032e-05,27,11,16
6398,IPCC,4.400843956132392e-06,1.8979287041356905e-06,6,5,1
6399,IPO,1.48790438516857e-05,1.2250267090330355e-05,17,9,8
6400,IQ,1.0687763893464371e-05,7.074097897233022e-06,9,5,4
6401,IR,6.72700433294523e-05,7.608968713853079e-05,85,36,49
6402,IRA,1.6974683830796368e-05,2.6053384938589907e-05,26,10,16
6403,IRAN,6.496483935243052e-06,3.6233184351681345e-06,5,3,2
6404,IRAQ,2.095639979110664e-07,5.348708166200577e-06,4,0,4
6405,IRL,4.400843956132392e-06,5.348708166200577e-06,5,2,3
6406,IS,2.7452883726349685e-05,1.2250267090330355e-05,21,14,7
6407,ISI,0.0006456666775639949,0.0005712765399448426,728,325,403
6408,ISIL,5.888748341300963e-05,5.3659620635109e-05,60,29,31
6409,ISIS,4.400843956132392e-06,8.79948762826546e-06,7,2,5
6410,ISISheld,4.400843956132392e-06,1.8979287041356905e-06,3,2,1
6411,ISISlinked,4.400843956132392e-06,1.8979287041356905e-06,3,2,1
6412,ISP,7.355696326678427e-05,9.334358444885519e-05,94,37,57
6413,ISRAEL,4.400843956132392e-06,1.8979287041356905e-06,3,2,1
6414,ISRO,1.278340387257504e-05,1.8979287041356905e-06,7,6,1
6415,ITN,2.3052039770217305e-06,3.6233184351681345e-06,3,1,2
6416,ITT,2.095639979110664e-07,5.348708166200577e-06,3,0,3
6417,IV,6.496483935243052e-06,1.8979287041356905e-06,4,3,1
6418,IVt,1.0687763893464371e-05,3.6233184351681345e-06,7,5,2
6419,IX,6.496483935243052e-06,7.074097897233022e-06,9,3,6
6420,Ian,1.48790438516857e-05,2.4327995207557487e-05,26,8,18
6421,Ibrahim,6.496483935243052e-06,7.074097897233022e-06,7,3,4
6422,Icahn,2.3052039770217305e-06,5.348708166200577e-06,4,1,3
6423,Ice,5.260056347567764e-05,5.1934230904076595e-05,58,25,33
6424,Iceberg,1.0687763893464371e-05,8.79948762826546e-06,10,5,5
6425,Iceland,0.00016786076232676425,0.0001847892401935746,206,87,119
6426,Icelander,1.0687763893464371e-05,8.79948762826546e-06,11,5,6
6427,Icelandic,6.307876337123095e-05,3.985650278684949e-05,58,33,25
6428,Icesave,4.400843956132392e-06,1.8979287041356905e-06,3,2,1
6429,Icon,2.3052039770217305e-06,7.074097897233022e-06,5,1,4
6430,Iconic,8.592123914353715e-06,3.6233184351681345e-06,6,4,2
6431,Icy,6.496483935243052e-06,5.348708166200577e-06,7,3,4
6432,Id,4.002672360101368e-05,4.8483451442011706e-05,53,22,31
6433,Idaho,1.9070323809907035e-05,2.087721574549256e-05,23,10,13
6434,Idea,0.00014690436253565753,9.506897417988779e-05,137,73,64
6435,Ideal,4.400843956132392e-06,5.348708166200577e-06,7,3,4
6436,Identified,1.9070323809907035e-05,7.074097897233022e-06,13,9,4
6437,Identify,2.116596378901769e-05,1.052487735929791e-05,19,11,8
6438,Identifying,2.3052039770217305e-06,3.6233184351681345e-06,4,2,2
6439,Identity,3.7931083621902995e-05,3.122955413168725e-05,40,21,19
6440,Ideological,2.3052039770217305e-06,1.7253897310324457e-07,3,1,2
6441,Ideology,8.592123914353715e-06,5.348708166200577e-06,9,5,4
6442,Idiocy,4.400843956132392e-06,1.8979287041356905e-06,3,2,1
6443,Idiot,1.6974683830796368e-05,1.570104655239525e-05,17,8,9
6444,Idol,6.496483935243052e-06,5.348708166200577e-06,7,3,4
6445,If,4.4218003559234974e-05,3.122955413168725e-05,42,23,19
6446,Ignite,4.400843956132392e-06,3.6233184351681345e-06,4,2,2
6447,Ignorance,1.278340387257504e-05,8.79948762826546e-06,11,6,5
6448,Ignorant,1.0687763893464371e-05,1.8979287041356905e-06,6,5,1
6449,Ignore,5.050492349656699e-05,3.2954943862719716e-05,50,27,23
6450,Ignored,1.0687763893464371e-05,1.052487735929791e-05,13,6,7
6451,Ignoring,2.5357243747239038e-05,2.4327995207557487e-05,28,12,16
6452,Igor,4.400843956132392e-06,7.074097897233022e-06,6,2,4
6453,Iguala,4.400843956132392e-06,1.8979287041356905e-06,3,2,1
6454,Ike,2.3052039770217305e-06,1.8979287041356905e-06,3,2,1
6455,Ikea,1.9070323809907035e-05,1.9151826014460126e-05,22,10,12
6456,Il,3.583544364279237e-05,2.4327995207557487e-05,33,17,16
6457,Ilhan,2.3052039770217305e-06,8.79948762826546e-06,7,2,5
6458,Ill,7.565260324589493e-05,6.401195902130366e-05,74,36,38
6459,Illegal,8.613080314144832e-05,0.0001019705331040174,108,45,63
6460,Illegally,1.6974683830796368e-05,2.087721574549256e-05,20,8,12
6461,Illinois,6.936568330856297e-05,5.1934230904076595e-05,75,41,34
6462,Illnes,1.6974683830796368e-05,1.052487735929791e-05,21,13,8
6463,Illness,1.0687763893464371e-05,3.6233184351681345e-06,7,5,2
6464,Illusion,6.496483935243052e-06,5.348708166200577e-06,7,3,4
6465,Illustrate,2.3052039770217305e-06,7.074097897233022e-06,6,2,4
6466,Illustration,8.592123914353715e-06,1.7253897310324457e-07,4,4,0
6467,Ilyse,4.400843956132392e-06,1.8979287041356905e-06,3,2,1
6468,Im,0.00022863432172097337,0.0002727841164762295,309,132,177
6469,Image,5.6791843433898893e-05,5.020884117304414e-05,66,31,35
6470,Imaginary,4.400843956132392e-06,1.8979287041356905e-06,3,2,1
6471,Imagination,4.400843956132392e-06,5.348708166200577e-06,5,2,3
6472,Imagine,3.3739803663681634e-05,4.1581892517881935e-05,48,20,28
6473,Imagined,2.3052039770217305e-06,5.348708166200577e-06,4,1,3
6474,Imagining,4.400843956132392e-06,5.348708166200577e-06,6,2,4
6475,Imam,2.116596378901769e-05,1.3975656821362803e-05,19,10,9
6476,Imitate,2.095639979110664e-07,3.6233184351681345e-06,3,0,3
6477,Immediate,6.496483935243052e-06,1.3975656821362803e-05,12,4,8
6478,Immediately,2.326160376812834e-05,1.3975656821362803e-05,21,12,9
6479,Immigrant,0.00015738256243121094,0.00020549391696596386,211,82,129
6480,Immigration,0.0002621645613867441,0.00027796028566932717,312,135,177
6481,Imminent,6.496483935243052e-06,3.6233184351681345e-06,6,4,2
6482,Immoral,1.0687763893464371e-05,3.6233184351681345e-06,7,5,2
6483,Immune,1.278340387257504e-05,1.8979287041356905e-06,7,6,1
6484,Immunity,1.278340387257504e-05,3.6233184351681345e-06,11,6,5
6485,Impact,5.6791843433898893e-05,7.091351794543343e-05,71,28,43
6486,Impacting,6.496483935243052e-06,3.6233184351681345e-06,6,4,2
6487,Impasse,6.496483935243052e-06,3.6233184351681345e-06,5,3,2
6488,Impeach,1.6974683830796368e-05,1.3975656821362803e-05,16,8,8
6489,Impeachable,8.592123914353715e-06,1.8979287041356905e-06,5,4,1
6490,Impeached,6.496483935243052e-06,5.348708166200577e-06,6,3,3
6491,Impeaching,2.3052039770217305e-06,1.8979287041356905e-06,3,2,1
6492,Impeachment,4.212236358012434e-05,5.5385010366141504e-05,59,25,34
6493,Impede,2.095639979110664e-07,3.6233184351681345e-06,3,1,2
6494,Impending,4.400843956132392e-06,5.348708166200577e-06,5,2,3
6495,Imperative,6.496483935243052e-06,1.8979287041356905e-06,5,4,1
6496,Imperial,4.400843956132392e-06,7.074097897233022e-06,7,2,5
6497,Imperil,4.400843956132392e-06,7.074097897233022e-06,6,2,4
6498,Implement,2.3052039770217305e-06,3.6233184351681345e-06,3,1,2
6499,Implementation,2.3052039770217305e-06,7.074097897233022e-06,5,1,4
6500,Implementing,6.496483935243052e-06,8.79948762826546e-06,8,3,5
6501,Implicate,6.496483935243052e-06,1.7253897310324457e-07,3,3,0
6502,Implicated,1.0687763893464371e-05,3.6233184351681345e-06,7,5,2
6503,Implication,2.3052039770217305e-06,1.8979287041356905e-06,4,1,3
6504,Implode,8.592123914353715e-06,3.6233184351681345e-06,6,4,2
6505,Implore,4.400843956132392e-06,3.6233184351681345e-06,4,2,2
6506,Implosion,2.3052039770217305e-06,5.348708166200577e-06,5,2,3
6507,Imply,4.400843956132392e-06,1.2250267090330355e-05,10,2,8
6508,Import,2.326160376812834e-05,8.79948762826546e-06,16,11,5
6509,Importance,1.48790438516857e-05,1.052487735929791e-05,13,7,6
6510,Important,5.6791843433898893e-05,6.401195902130366e-05,75,35,40
6511,Imported,2.3052039770217305e-06,5.348708166200577e-06,4,1,3
6512,Impose,1.48790438516857e-05,8.79948762826546e-06,14,8,6
6513,Imposing,2.3052039770217305e-06,7.074097897233022e-06,5,1,4
6514,Impossible,1.9070323809907035e-05,1.742643628342769e-05,21,9,12
6515,Impressed,4.400843956132392e-06,8.79948762826546e-06,7,2,5
6516,Impression,8.592123914353715e-06,8.79948762826546e-06,10,4,6
6517,Impressive,2.095639979110664e-07,7.074097897233022e-06,4,0,4
6518,Imprisoned,1.278340387257504e-05,1.052487735929791e-05,12,6,6
6519,Imprisonment,4.400843956132392e-06,3.6233184351681345e-06,4,2,2
6520,Improve,3.1644163684570994e-05,4.6758061710979285e-05,45,17,28
6521,Improved,2.3052039770217305e-06,7.074097897233022e-06,6,1,5
6522,Improvement,2.3052039770217305e-06,3.6233184351681345e-06,4,1,3
6523,Improving,1.278340387257504e-05,7.074097897233022e-06,11,7,4
6524,Impunity,2.095639979110664e-07,3.6233184351681345e-06,3,0,3
6525,Imran,2.3052039770217305e-06,1.3975656821362803e-05,9,1,8
6526,In,1.48790438516857e-05,1.052487735929791e-05,13,7,6
6527,Inaccurate,8.592123914353715e-06,3.6233184351681345e-06,6,4,2
6528,Inaction,4.400843956132392e-06,8.79948762826546e-06,8,2,6
6529,Inadequate,4.400843956132392e-06,7.074097897233022e-06,6,2,4
6530,Inappropriate,1.6974683830796368e-05,3.6233184351681345e-06,12,8,4
6531,Inaugural,1.278340387257504e-05,5.348708166200577e-06,13,8,5
6532,Inauguration,3.1644163684570994e-05,4.1581892517881935e-05,64,31,33
6533,Inbox,6.496483935243052e-06,1.7253897310324457e-07,3,3,0
6534,Inc,7.984388320411623e-05,5.020884117304414e-05,75,41,34
6535,Incarcerated,1.278340387257504e-05,5.348708166200577e-06,9,6,3
6536,Incarceration,8.592123914353715e-06,2.2602605476525032e-05,17,4,13
6537,Incentive,4.400843956132392e-06,5.348708166200577e-06,5,2,3
6538,Incest,4.400843956132392e-06,1.8979287041356905e-06,3,2,1
6539,Inch,1.48790438516857e-05,1.3975656821362803e-05,15,7,8
6540,Incident,2.954852370546031e-05,2.087721574549256e-05,28,14,14
6541,Include,2.954852370546031e-05,3.2954943862719716e-05,36,15,21
6542,Included,4.400843956132392e-06,8.79948762826546e-06,8,3,5
6543,Including,3.583544364279237e-05,2.6053384938589907e-05,36,20,16
6544,Inclusion,2.3052039770217305e-06,8.79948762826546e-06,6,1,5
6545,Inclusive,1.0687763893464371e-05,7.074097897233022e-06,9,5,4
6546,Incoherent,4.400843956132392e-06,1.7253897310324457e-07,3,2,1
6547,Income,5.888748341300963e-05,4.330728224891437e-05,58,31,27
6548,Incoming,4.400843956132392e-06,1.8979287041356905e-06,4,3,1
6549,Incompetence,8.592123914353715e-06,1.8979287041356905e-06,5,4,1
6550,Incompetent,2.095639979110664e-07,5.348708166200577e-06,3,0,3
6551,Incorrectly,2.3052039770217305e-06,3.6233184351681345e-06,3,1,2
6552,Increase,6.72700433294523e-05,5.3659620635109e-05,69,35,34
6553,Increased,8.592123914353715e-06,1.052487735929791e-05,14,5,9
6554,Increasing,1.6974683830796368e-05,1.052487735929791e-05,15,9,6
6555,Increasingly,3.1644163684570994e-05,1.742643628342769e-05,30,18,12
6556,Incredible,2.954852370546031e-05,2.2602605476525032e-05,34,17,17
6557,Incredibly,1.0687763893464371e-05,5.348708166200577e-06,9,5,4
6558,Incumbent,4.400843956132392e-06,2.777877466962238e-05,18,2,16
6559,Indeed,4.400843956132392e-06,1.3975656821362803e-05,11,2,9
6560,Indefensible,6.496483935243052e-06,1.8979287041356905e-06,5,3,2
6561,Indefinitely,8.592123914353715e-06,7.074097897233022e-06,9,5,4
6562,Independence,4.840928351745632e-05,4.50326719799468e-05,51,24,27
6563,Independent,3.583544364279237e-05,6.573734875233614e-05,64,20,44
6564,Independentcouk,2.095639979110664e-07,7.074097897233022e-06,4,0,4
6565,Independentie,4.400843956132392e-06,1.8979287041356905e-06,3,2,1
6566,Index,4.400843956132392e-06,1.9151826014460126e-05,15,4,11
6567,India,0.0008740914352870574,0.0008162818817514497,985,458,527
6568,Indian,0.00040885935992449035,0.0003728567208761114,464,222,242
6569,IndianAmerican,2.3052039770217305e-06,7.074097897233022e-06,6,2,4
6570,Indiana,8.193952318322689e-05,8.816741525575797e-05,94,41,53
6571,Indianapoli,6.496483935243052e-06,7.074097897233022e-06,7,3,4
6572,Indicate,2.3052039770217305e-06,5.348708166200577e-06,4,1,3
6573,Indication,4.400843956132392e-06,1.8979287041356905e-06,3,2,1
6574,Indict,8.592123914353715e-06,3.6233184351681345e-06,7,5,2
6575,Indicted,2.116596378901769e-05,2.4327995207557487e-05,29,15,14
6576,Indictment,6.496483935243052e-06,1.052487735929791e-05,16,9,7
6577,Indifference,2.3052039770217305e-06,3.6233184351681345e-06,3,1,2
6578,Indigenou,3.1644163684570994e-05,2.9504164400654783e-05,40,21,19
6579,Inditex,2.3052039770217305e-06,3.6233184351681345e-06,3,1,2
6580,Individual,1.0687763893464371e-05,1.742643628342769e-05,19,7,12
6581,Indonesia,0.0001154697628489974,0.0001295767688005365,148,61,87
6582,Indonesian,7.565260324589493e-05,5.3659620635109e-05,75,39,36
6583,Indoor,4.400843956132392e-06,1.8979287041356905e-06,4,2,2
6584,Industrial,6.496483935243052e-06,1.3975656821362803e-05,12,4,8
6585,Industry,8.613080314144832e-05,0.00010887209202814718,112,43,69
6586,Inequality,5.050492349656699e-05,5.020884117304414e-05,60,29,31
6587,Inevitable,1.48790438516857e-05,5.348708166200577e-06,10,7,3
6588,Infamou,4.400843956132392e-06,8.79948762826546e-06,7,2,5
6589,Infant,4.400843956132392e-06,1.2250267090330355e-05,13,4,9
6590,Infect,4.400843956132392e-06,1.8979287041356905e-06,3,2,1
6591,Infected,2.3052039770217305e-06,1.8979287041356905e-06,4,2,2
6592,Infecting,2.3052039770217305e-06,1.8979287041356905e-06,3,2,1
6593,Infection,2.3052039770217305e-06,1.052487735929791e-05,8,2,6
6594,Infectiou,6.496483935243052e-06,3.6233184351681345e-06,7,4,3
6595,Infidelity,2.095639979110664e-07,8.79948762826546e-06,5,0,5
6596,Infighting,2.095639979110664e-07,5.348708166200577e-06,3,0,3
6597,Infiltrate,4.400843956132392e-06,3.6233184351681345e-06,5,3,2
6598,Infiltrated,4.400843956132392e-06,1.8979287041356905e-06,4,2,2
6599,Infiltrating,2.3052039770217305e-06,3.6233184351681345e-06,3,1,2
6600,Inflammatory,2.3052039770217305e-06,3.6233184351681345e-06,4,1,3
6601,Inflation,1.9070323809907035e-05,1.3975656821362803e-05,19,9,10
6602,Influence,2.954852370546031e-05,4.1581892517881935e-05,41,15,26
6603,Influenced,2.3052039770217305e-06,7.074097897233022e-06,6,2,4
6604,Influencer,2.3052039770217305e-06,5.348708166200577e-06,5,1,4
6605,Influential,4.400843956132392e-06,8.79948762826546e-06,8,3,5
6606,Influx,2.3052039770217305e-06,1.8979287041356905e-06,3,1,2
6607,Info,3.3739803663681634e-05,2.087721574549256e-05,34,18,16
6608,Infographic,1.0687763893464371e-05,3.6233184351681345e-06,8,6,2
6609,Informant,3.1644163684570994e-05,1.570104655239525e-05,25,16,9
6610,Information,7.565260324589493e-05,5.883578982820635e-05,76,37,39
6611,Infowar,6.496483935243052e-06,1.052487735929791e-05,9,3,6
6612,Infrastructure,4.4218003559234974e-05,6.573734875233614e-05,67,25,42
6613,Infringe,2.3052039770217305e-06,1.8979287041356905e-06,3,1,2
6614,Infringement,4.400843956132392e-06,3.6233184351681345e-06,4,2,2
6615,Infuriating,2.3052039770217305e-06,1.8979287041356905e-06,3,1,2
6616,Ingeniou,6.496483935243052e-06,1.8979287041356905e-06,4,3,1
6617,Ingraham,8.592123914353715e-06,5.348708166200577e-06,9,4,5
6618,Ingredient,6.496483935243052e-06,1.8979287041356905e-06,4,3,1
6619,Inhabitant,4.400843956132392e-06,3.6233184351681345e-06,4,2,2
6620,Inherit,2.3052039770217305e-06,3.6233184351681345e-06,3,1,2
6621,Inheritance,4.400843956132392e-06,3.6233184351681345e-06,6,4,2
6622,Inhofe,6.496483935243052e-06,1.3975656821362803e-05,11,3,8
6623,Inhumane,2.095639979110664e-07,5.348708166200577e-06,3,0,3
6624,Initial,1.278340387257504e-05,7.074097897233022e-06,12,7,5
6625,Initially,6.496483935243052e-06,3.6233184351681345e-06,5,3,2
6626,Initiative,3.3739803663681634e-05,3.468033359375216e-05,38,17,21
6627,Injection,1.6974683830796368e-05,1.2250267090330355e-05,15,8,7
6628,Injure,2.3052039770217305e-06,3.6233184351681345e-06,3,1,2
6629,Injured,2.954852370546031e-05,2.6053384938589907e-05,32,14,18
6630,Injury,2.326160376812834e-05,7.074097897233022e-06,16,12,4
6631,Injustice,1.278340387257504e-05,7.074097897233022e-06,11,6,5
6632,Ink,2.3052039770217305e-06,7.074097897233022e-06,5,1,4
6633,Inmate,4.002672360101368e-05,4.330728224891437e-05,55,23,32
6634,Inner,6.496483935243052e-06,1.9151826014460126e-05,16,4,12
6635,Innocence,4.400843956132392e-06,8.79948762826546e-06,8,2,6
6636,Innocent,2.7452883726349685e-05,2.2602605476525032e-05,26,13,13
6637,Innovation,1.6974683830796368e-05,4.6758061710979285e-05,40,12,28
6638,Innovative,2.095639979110664e-07,7.074097897233022e-06,5,1,4
6639,Inquiry,3.3739803663681634e-05,2.6053384938589907e-05,35,18,17
6640,Insane,6.496483935243052e-06,2.087721574549256e-05,17,3,14
6641,Insanity,8.592123914353715e-06,1.8979287041356905e-06,6,4,2
6642,Insecticide,4.400843956132392e-06,1.7253897310324457e-07,3,3,0
6643,Insecurity,8.592123914353715e-06,1.8979287041356905e-06,7,5,2
6644,Inseparable,2.3052039770217305e-06,5.348708166200577e-06,4,1,3
6645,Inside,0.00014061744259832545,0.00015028144557292604,169,74,95
6646,Insider,2.116596378901769e-05,3.8131113055817005e-05,42,15,27
6647,Insight,4.400843956132392e-06,1.052487735929791e-05,10,2,8
6648,Insist,1.6974683830796368e-05,4.6758061710979285e-05,43,13,30
6649,Insisting,2.095639979110664e-07,5.348708166200577e-06,3,0,3
6650,Inslee,2.095639979110664e-07,7.074097897233022e-06,7,3,4
6651,Inspect,2.095639979110664e-07,3.6233184351681345e-06,3,0,3
6652,Inspection,4.400843956132392e-06,5.348708166200577e-06,5,2,3
6653,Inspector,1.6974683830796368e-05,1.3975656821362803e-05,20,9,11
6654,Inspiration,8.592123914353715e-06,1.8979287041356905e-06,5,4,1
6655,Inspire,2.5357243747239038e-05,4.1581892517881935e-05,39,12,27
6656,Inspired,1.48790438516857e-05,1.2250267090330355e-05,19,10,9
6657,Inspiring,6.496483935243052e-06,1.052487735929791e-05,11,4,7
6658,Instagram,6.72700433294523e-05,4.50326719799468e-05,65,35,30
6659,Install,4.400843956132392e-06,7.074097897233022e-06,7,3,4
6660,Instant,8.592123914353715e-06,5.348708166200577e-06,8,5,3
6661,Instead,0.00010708720293255492,0.0001278513790695043,141,61,80
6662,Instinct,4.400843956132392e-06,3.6233184351681345e-06,4,2,2
6663,Institute,4.6313643538345614e-05,6.573734875233614e-05,63,24,39
6664,Institution,2.326160376812834e-05,1.052487735929791e-05,21,12,9
6665,Institutional,4.400843956132392e-06,5.348708166200577e-06,5,2,3
6666,Instruction,4.400843956132392e-06,1.8979287041356905e-06,3,2,1
6667,Instrument,2.095639979110664e-07,5.348708166200577e-06,3,0,3
6668,Insult,4.002672360101368e-05,1.570104655239525e-05,29,19,10
6669,Insulted,6.496483935243052e-06,5.348708166200577e-06,6,3,3
6670,Insulting,1.48790438516857e-05,1.2250267090330355e-05,16,8,8
6671,Insurance,6.098312339212028e-05,0.0001019705331040174,101,31,70
6672,Insure,2.3052039770217305e-06,3.6233184351681345e-06,3,1,2
6673,Insurer,1.6974683830796368e-05,1.742643628342769e-05,22,8,14
6674,Insurgency,4.400843956132392e-06,1.7253897310324457e-07,3,3,0
6675,Insurgent,6.496483935243052e-06,3.6233184351681345e-06,7,4,3
6676,Insurrection,4.400843956132392e-06,8.79948762826546e-06,7,2,5
6677,Insurrectionist,4.400843956132392e-06,3.6233184351681345e-06,4,2,2
6678,Int,2.3052039770217305e-06,1.8979287041356905e-06,3,2,1
6679,Intact,4.400843956132392e-06,1.8979287041356905e-06,3,2,1
6680,Integration,4.400843956132392e-06,5.348708166200577e-06,6,3,3
6681,Integrity,1.9070323809907035e-05,1.2250267090330355e-05,17,10,7
6682,Intel,5.6791843433898893e-05,2.9504164400654783e-05,45,27,18
6683,Intellectual,4.400843956132392e-06,7.074097897233022e-06,7,3,4
6684,Intelligence,0.00013642616264010403,0.00018133846073150993,183,71,112
6685,Intelligent,2.3052039770217305e-06,7.074097897233022e-06,5,1,4
6686,Intend,4.400843956132392e-06,3.6233184351681345e-06,5,2,3
6687,Intended,8.592123914353715e-06,3.6233184351681345e-06,7,4,3
6688,Intense,4.400843956132392e-06,3.6233184351681345e-06,4,2,2
6689,Intensify,1.0687763893464371e-05,5.348708166200577e-06,9,6,3
6690,Intensity,4.400843956132392e-06,1.8979287041356905e-06,4,3,1
6691,Intent,4.400843956132392e-06,5.348708166200577e-06,5,2,3
6692,Intention,6.496483935243052e-06,5.348708166200577e-06,7,3,4
6693,Intentionally,6.496483935243052e-06,1.7253897310324457e-07,5,4,1
6694,Interaction,4.400843956132392e-06,1.8979287041356905e-06,3,2,1
6695,Intercept,4.400843956132392e-06,1.052487735929791e-05,8,2,6
6696,Intercepted,2.095639979110664e-07,3.6233184351681345e-06,3,1,2
6697,Interest,6.936568330856297e-05,6.056117955923882e-05,74,36,38
6698,Interested,1.0687763893464371e-05,1.3975656821362803e-05,14,5,9
6699,Interesting,1.48790438516857e-05,8.79948762826546e-06,12,7,5
6700,Interfax,8.592123914353715e-06,5.348708166200577e-06,7,4,3
6701,Interfere,4.400843956132392e-06,5.348708166200577e-06,5,2,3
6702,Interference,4.400843956132392e-06,1.9151826014460126e-05,13,2,11
6703,Interfering,2.3052039770217305e-06,3.6233184351681345e-06,3,1,2
6704,Interior,7.565260324589493e-05,8.816741525575797e-05,101,41,60
6705,Intern,1.0687763893464371e-05,8.79948762826546e-06,11,6,5
6706,Internal,1.278340387257504e-05,2.9504164400654783e-05,25,7,18
6707,International,0.0003501814405093918,0.0003141934700210085,398,190,208
6708,Internationally,2.3052039770217305e-06,7.074097897233022e-06,5,1,4
6709,Internet,0.0004926849590889169,0.0004504992587725714,551,261,290
6710,Internetorg,4.400843956132392e-06,1.8979287041356905e-06,3,2,1
6711,Internment,4.400843956132392e-06,8.79948762826546e-06,7,2,5
6712,Internship,2.3052039770217305e-06,5.348708166200577e-06,5,2,3
6713,Interpol,3.1644163684570994e-05,2.087721574549256e-05,29,15,14
6714,Interpreter,4.400843956132392e-06,3.6233184351681345e-06,4,2,2
6715,Interrogation,6.496483935243052e-06,1.2250267090330355e-05,13,4,9
6716,Interstate,2.095639979110664e-07,5.348708166200577e-06,3,0,3
6717,Interstellar,2.3052039770217305e-06,8.79948762826546e-06,6,1,5
6718,Intervene,4.400843956132392e-06,1.8979287041356905e-06,3,2,1
6719,Intervention,1.0687763893464371e-05,1.052487735929791e-05,12,5,7
6720,Interview,8.613080314144832e-05,0.00011922443041434203,129,51,78
6721,Interviewing,2.3052039770217305e-06,5.348708166200577e-06,4,1,3
6722,Intifada,6.496483935243052e-06,5.348708166200577e-06,6,3,3
6723,Intimate,2.3052039770217305e-06,3.6233184351681345e-06,3,1,2
6724,Intimidate,4.400843956132392e-06,3.6233184351681345e-06,4,2,2
6725,Intimidated,6.496483935243052e-06,1.8979287041356905e-06,5,4,1
6726,Intimidating,2.3052039770217305e-06,1.8979287041356905e-06,3,1,2
6727,Intimidation,1.278340387257504e-05,3.6233184351681345e-06,10,6,4
6728,Intl,4.400843956132392e-06,7.074097897233022e-06,6,2,4
6729,Intolerance,4.400843956132392e-06,5.348708166200577e-06,5,2,3
6730,Intolerant,2.3052039770217305e-06,5.348708166200577e-06,4,1,3
6731,Introduce,4.002672360101368e-05,3.8131113055817005e-05,43,20,23
6732,Introduced,8.592123914353715e-06,3.6233184351681345e-06,6,4,2
6733,Introducing,4.400843956132392e-06,1.742643628342769e-05,12,2,10
6734,Introduction,2.3052039770217305e-06,3.6233184351681345e-06,3,1,2
6735,Intrusion,2.3052039770217305e-06,1.8979287041356905e-06,3,1,2
6736,Inuit,4.400843956132392e-06,3.6233184351681345e-06,5,2,3
6737,Invade,8.592123914353715e-06,1.052487735929791e-05,12,4,8
6738,Invaded,2.3052039770217305e-06,1.8979287041356905e-06,3,2,1
6739,Invalid,2.3052039770217305e-06,5.348708166200577e-06,4,1,3
6740,Invalidate,4.400843956132392e-06,3.6233184351681345e-06,4,2,2
6741,Invasion,1.6974683830796368e-05,2.777877466962238e-05,27,10,17
6742,Invent,2.3052039770217305e-06,8.79948762826546e-06,6,1,5
6743,Invented,2.3052039770217305e-06,7.074097897233022e-06,5,1,4
6744,Inventing,2.3052039770217305e-06,1.8979287041356905e-06,3,2,1
6745,Invention,2.3052039770217305e-06,5.348708166200577e-06,4,1,3
6746,Inventor,1.0687763893464371e-05,1.2250267090330355e-05,13,6,7
6747,Inventory,2.3052039770217305e-06,1.8979287041356905e-06,3,1,2
6748,Invest,1.48790438516857e-05,2.087721574549256e-05,22,8,14
6749,Invested,2.3052039770217305e-06,5.348708166200577e-06,4,1,3
6750,Investigate,4.6313643538345614e-05,5.883578982820635e-05,62,24,38
6751,Investigated,1.9070323809907035e-05,1.2250267090330355e-05,16,9,7
6752,Investigating,4.6313643538345614e-05,2.9504164400654783e-05,44,25,19
6753,Investigation,0.00013642616264010403,0.00017788768126944505,183,72,111
6754,Investigative,2.3052039770217305e-06,3.6233184351681345e-06,3,1,2
6755,Investigator,2.7452883726349685e-05,1.9151826014460126e-05,27,14,13
6756,Investing,5.260056347567764e-05,4.50326719799468e-05,53,26,27
6757,Investment,6.098312339212028e-05,5.020884117304414e-05,60,29,31
6758,Investor,6.517440335034157e-05,4.6758061710979285e-05,66,36,30
6759,Invisible,1.9070323809907035e-05,7.074097897233022e-06,13,9,4
6760,Invitation,2.095639979110664e-07,1.3975656821362803e-05,9,1,8
6761,Invite,6.496483935243052e-06,3.122955413168725e-05,23,4,19
6762,Invited,2.116596378901769e-05,1.8979287041356905e-06,12,10,2
6763,Invoke,8.592123914353715e-06,1.2250267090330355e-05,11,4,7
6764,Involve,2.095639979110664e-07,5.348708166200577e-06,3,0,3
6765,Involved,2.116596378901769e-05,2.2602605476525032e-05,25,11,14
6766,Involvement,1.278340387257504e-05,5.348708166200577e-06,9,6,3
6767,Involving,2.095639979110664e-07,3.6233184351681345e-06,4,1,3
6768,Iowa,0.0002244430417627521,0.00013130215853156914,208,125,83
6769,Iowan,4.400843956132392e-06,1.8979287041356905e-06,3,2,1
6770,Iran,0.001460870629438043,0.0012165722993509763,1557,764,793
6771,Iranian,0.00048430239917247403,0.0004021883463036628,500,251,249
6772,IranianAmerican,8.592123914353715e-06,7.074097897233022e-06,8,4,4
6773,Iraq,0.0007043445969790938,0.0007369139541239569,839,368,471
6774,Iraqi,0.00021186920188808795,0.00023310015266248305,268,113,155
6775,Irate,2.3052039770217305e-06,5.348708166200577e-06,4,1,3
6776,Ireland,0.00022863432172097337,0.00017788768126944505,241,120,121
6777,Irish,0.00014480872255654665,0.00017788768126944505,204,79,125
6778,Irma,8.592123914353715e-06,2.9504164400654783e-05,22,5,17
6779,Iron,2.954852370546031e-05,1.9151826014460126e-05,27,15,12
6780,Ironic,6.496483935243052e-06,1.8979287041356905e-06,4,3,1
6781,Irony,8.592123914353715e-06,1.2250267090330355e-05,11,4,7
6782,Irregularity,4.400843956132392e-06,1.8979287041356905e-06,4,2,2
6783,Irrelevant,6.496483935243052e-06,1.8979287041356905e-06,4,3,1
6784,Irresponsible,2.095639979110664e-07,5.348708166200577e-06,3,0,3
6785,Irreversible,2.095639979110664e-07,3.6233184351681345e-06,4,1,3
6786,Irving,4.400843956132392e-06,1.8979287041356905e-06,3,2,1
6787,Irwin,1.0687763893464371e-05,1.7253897310324457e-07,6,5,1
6788,Isaac,4.400843956132392e-06,1.8979287041356905e-06,3,2,1
6789,Isfahan,6.496483935243052e-06,1.8979287041356905e-06,4,3,1
6790,Isi,9.870464301611217e-05,7.091351794543343e-05,99,51,48
6791,Isil,2.3052039770217305e-06,5.348708166200577e-06,4,1,3
6792,Isis,2.095639979110664e-07,3.6233184351681345e-06,3,0,3
6793,Islam,0.00019091280209698145,0.0001951415785797695,226,97,129
6794,Islamabad,2.326160376812834e-05,7.074097897233022e-06,18,13,5
6795,Islamic,0.0005199282788173553,0.00048328166366218777,599,274,325
6796,Islamisation,4.400843956132392e-06,1.7253897310324457e-07,3,3,0
6797,Islamist,0.00018672152213876006,0.00017961307100047735,217,101,116
6798,Islamistled,6.496483935243052e-06,3.6233184351681345e-06,5,3,2
6799,Islamization,4.400843956132392e-06,1.8979287041356905e-06,3,2,1
6800,Islamophobe,4.400843956132392e-06,7.074097897233022e-06,6,2,4
6801,Islamophobia,4.212236358012434e-05,1.742643628342769e-05,33,20,13
6802,Islamophobic,1.6974683830796368e-05,1.742643628342769e-05,19,8,11
6803,Island,0.00013223488268188294,0.00015373222503499084,163,69,94
6804,Islander,1.6974683830796368e-05,1.052487735929791e-05,14,8,6
6805,Isle,4.400843956132392e-06,3.6233184351681345e-06,4,2,2
6806,Ismail,4.400843956132392e-06,1.8979287041356905e-06,4,3,1
6807,Isn,4.002672360101368e-05,4.330728224891437e-05,48,19,29
6808,Isolated,6.496483935243052e-06,1.8979287041356905e-06,5,4,1
6809,Isolation,6.496483935243052e-06,3.6233184351681345e-06,6,3,3
6810,Israel,0.001921911424842388,0.0019222566993432456,2274,1033,1241
6811,IsraelGaza,8.592123914353715e-06,7.074097897233022e-06,8,4,4
6812,IsraelPalestine,4.400843956132392e-06,5.348708166200577e-06,5,2,3
6813,Israeli,0.0013665668303780632,0.0011734375560751658,1497,727,770
6814,IsraeliArab,2.3052039770217305e-06,3.6233184351681345e-06,3,1,2
6815,IsraeliPalestinian,4.400843956132392e-06,1.3975656821362803e-05,12,3,9
6816,Isreal,2.3052039770217305e-06,1.8979287041356905e-06,3,2,1
6817,Issa,2.3052039770217305e-06,1.3975656821362803e-05,9,1,8
6818,Issue,0.00015947820241032126,0.00014337988664879628,171,82,89
6819,Issued,1.48790438516857e-05,7.074097897233022e-06,12,7,5
6820,Issuing,2.095639979110664e-07,7.074097897233022e-06,4,0,4
6821,Istanbul,4.840928351745632e-05,5.883578982820635e-05,59,25,34
6822,It,0.0003271294007391747,0.00034352509544855977,390,169,221
6823,Italian,0.0001741476822640959,0.00016063378395912072,202,93,109
6824,Italy,0.0002621645613867441,0.00019341618884873702,256,132,124
6825,Item,6.496483935243052e-06,1.570104655239525e-05,13,3,10
6826,Itll,2.116596378901769e-05,1.570104655239525e-05,19,10,9
6827,Ivana,4.400843956132392e-06,3.6233184351681345e-06,4,2,2
6828,Ivanka,7.565260324589493e-05,8.126585633162811e-05,95,42,53
6829,Ive,0.00012385232276544028,0.0001019705331040174,138,65,73
6830,Ivory,4.212236358012434e-05,3.8131113055817005e-05,47,20,27
6831,Ivy,2.095639979110664e-07,7.074097897233022e-06,5,0,5
6832,Izzard,2.3052039770217305e-06,5.348708166200577e-06,4,1,3
6833,J20,2.3052039770217305e-06,5.348708166200577e-06,4,1,3
6834,JD,2.3052039770217305e-06,7.074097897233022e-06,7,1,6
6835,JFK,1.0687763893464371e-05,5.348708166200577e-06,8,5,3
6836,JJ,2.3052039770217305e-06,3.6233184351681345e-06,4,1,3
6837,JK,8.592123914353715e-06,1.8979287041356905e-06,7,6,1
6838,JP,1.0687763893464371e-05,1.742643628342769e-05,15,5,10
6839,JPMorgan,4.002672360101368e-05,3.2954943862719716e-05,42,21,21
6840,JPost,2.3052039770217305e-06,5.348708166200577e-06,4,1,3
6841,Jab,6.496483935243052e-06,8.79948762826546e-06,9,4,5
6842,Jack,5.260056347567764e-05,6.056117955923882e-05,67,29,38
6843,Jackie,1.278340387257504e-05,1.570104655239525e-05,15,6,9
6844,Jackpot,6.496483935243052e-06,5.348708166200577e-06,9,4,5
6845,Jackson,4.212236358012434e-05,4.6758061710979285e-05,48,20,28
6846,Jacob,1.48790438516857e-05,3.2954943862719716e-05,28,8,20
6847,Jacque,4.400843956132392e-06,1.3975656821362803e-05,10,2,8
6848,Jacqui,4.400843956132392e-06,3.6233184351681345e-06,4,2,2
6849,Jade,8.592123914353715e-06,3.6233184351681345e-06,6,4,2
6850,Jaffa,2.3052039770217305e-06,1.8979287041356905e-06,3,2,1
6851,Jail,0.00010289592297433347,0.00010024514337298497,114,51,63
6852,Jailed,5.6791843433898893e-05,2.6053384938589907e-05,44,28,16
6853,Jailhouse,8.592123914353715e-06,8.79948762826546e-06,10,4,6
6854,Jailing,4.400843956132392e-06,7.074097897233022e-06,7,3,4
6855,Jaime,4.400843956132392e-06,3.6233184351681345e-06,4,2,2
6856,Jair,2.3052039770217305e-06,3.6233184351681345e-06,3,1,2
6857,Jairo,2.3052039770217305e-06,5.348708166200577e-06,4,1,3
6858,Jakarta,8.592123914353715e-06,8.79948762826546e-06,10,4,6
6859,Jake,4.400843956132392e-06,1.2250267090330355e-05,13,5,8
6860,Jam,2.3052039770217305e-06,1.2250267090330355e-05,9,1,8
6861,Jamaica,1.6974683830796368e-05,2.2602605476525032e-05,23,9,14
6862,Jamaican,1.0687763893464371e-05,1.8979287041356905e-06,11,5,6
6863,Jamal,4.400843956132392e-06,7.074097897233022e-06,6,2,4
6864,Jame,0.00029988608101073563,0.00022619859373835345,289,151,138
6865,Jamie,1.9070323809907035e-05,8.79948762826546e-06,17,11,6
6866,Jan,0.00014061744259832545,9.161819471782287e-05,135,75,60
6867,Jane,8.592123914353715e-06,2.087721574549256e-05,18,5,13
6868,Janeiro,2.326160376812834e-05,1.3975656821362803e-05,20,12,8
6869,Janet,1.9070323809907035e-05,1.742643628342769e-05,20,9,11
6870,Jang,4.400843956132392e-06,1.8979287041356905e-06,3,2,1
6871,Janitor,4.400843956132392e-06,3.6233184351681345e-06,4,2,2
6872,Janner,6.496483935243052e-06,1.7253897310324457e-07,3,3,0
6873,January,0.00012804360272366158,0.00012612598933847184,146,67,79
6874,Japan,0.0007525443164986387,0.000709307718427438,841,381,460
6875,Japanese,0.0003019817209898466,0.0002607063883590024,334,155,179
6876,JapaneseAmerican,6.496483935243052e-06,8.79948762826546e-06,8,3,5
6877,Jar,4.400843956132392e-06,1.8979287041356905e-06,3,2,1
6878,Jared,6.72700433294523e-05,8.989280498679035e-05,92,35,57
6879,Jasmine,4.400843956132392e-06,5.348708166200577e-06,5,2,3
6880,Jason,4.6313643538345614e-05,4.8483451442011706e-05,56,25,31
6881,Java,2.3052039770217305e-06,3.6233184351681345e-06,5,3,2
6882,Javan,4.400843956132392e-06,1.7253897310324457e-07,3,2,1
6883,Jaw,1.0687763893464371e-05,1.8979287041356905e-06,6,5,1
6884,JawDropping,4.400843956132392e-06,1.8979287041356905e-06,3,2,1
6885,Jay,6.496483935243052e-06,2.9504164400654783e-05,26,7,19
6886,JayZ,2.095639979110664e-07,5.348708166200577e-06,4,0,4
6887,Jayapal,4.400843956132392e-06,3.6233184351681345e-06,4,2,2
6888,Jazeera,9.451336305789087e-05,0.0001019705331040174,119,52,67
6889,Jazz,2.095639979110664e-07,5.348708166200577e-06,3,0,3
6890,Je,6.496483935243052e-06,1.052487735929791e-05,11,5,6
6891,Jealou,2.095639979110664e-07,5.348708166200577e-06,4,0,4
6892,Jean,2.954852370546031e-05,1.570104655239525e-05,24,14,10
6893,JeanClaude,4.400843956132392e-06,1.8979287041356905e-06,3,2,1
6894,Jeb,0.00018881716211787043,0.00014337988664879628,200,109,91
6895,Jeddah,6.496483935243052e-06,5.348708166200577e-06,10,4,6
6896,Jedi,4.400843956132392e-06,8.79948762826546e-06,7,2,5
6897,Jeep,8.592123914353715e-06,1.7253897310324457e-07,4,4,0
6898,Jeff,0.00019510408205520246,0.00023310015266248305,251,100,151
6899,Jefferson,1.278340387257504e-05,1.2250267090330355e-05,14,7,7
6900,Jeffrey,2.954852370546031e-05,2.2602605476525032e-05,28,15,13
6901,Jeh,8.592123914353715e-06,7.074097897233022e-06,9,4,5
6902,Jehovah,1.278340387257504e-05,1.2250267090330355e-05,14,7,7
6903,Jekyll,6.496483935243052e-06,1.7253897310324457e-07,3,3,0
6904,Jellyfish,2.3052039770217305e-06,3.6233184351681345e-06,3,1,2
6905,Jemele,2.095639979110664e-07,8.79948762826546e-06,5,0,5
6906,Jen,1.278340387257504e-05,1.052487735929791e-05,13,6,7
6907,Jenna,2.3052039770217305e-06,5.348708166200577e-06,4,1,3
6908,Jenner,4.400843956132392e-06,5.348708166200577e-06,5,2,3
6909,Jennifer,1.0687763893464371e-05,1.3975656821362803e-05,15,5,10
6910,Jeopardy,8.592123914353715e-06,8.79948762826546e-06,10,5,5
6911,Jeremy,4.002672360101368e-05,1.570104655239525e-05,30,19,11
6912,Jerk,6.496483935243052e-06,3.6233184351681345e-06,6,4,2
6913,Jerome,4.400843956132392e-06,1.3975656821362803e-05,10,2,8
6914,Jerry,4.4218003559234974e-05,5.5385010366141504e-05,56,24,32
6915,Jersey,8.613080314144832e-05,0.00010887209202814718,123,52,71
6916,Jerusalem,0.00016786076232676425,0.00018824001965563945,207,89,118
6917,Jesse,4.400843956132392e-06,3.6233184351681345e-06,5,3,2
6918,Jessica,1.278340387257504e-05,7.074097897233022e-06,11,6,5
6919,Jessie,6.496483935243052e-06,1.7253897310324457e-07,3,3,0
6920,Jesu,3.7931083621902995e-05,2.4327995207557487e-05,37,19,18
6921,Jesú,4.400843956132392e-06,1.8979287041356905e-06,3,2,1
6922,Jet,4.840928351745632e-05,3.468033359375216e-05,47,24,23
6923,JetBlue,4.400843956132392e-06,1.8979287041356905e-06,3,2,1
6924,Jew,0.00018672152213876006,0.00025725560889693777,260,97,163
6925,Jewel,6.496483935243052e-06,1.8979287041356905e-06,4,3,1
6926,Jewish,0.00030617300094806777,0.0003072919110968788,362,163,199
6927,JewishArab,4.400843956132392e-06,1.8979287041356905e-06,3,2,1
6928,JewishIsraeli,2.3052039770217305e-06,3.6233184351681345e-06,3,1,2
6929,Ji,4.400843956132392e-06,1.7253897310324457e-07,3,3,0
6930,Jiabao,4.400843956132392e-06,1.052487735929791e-05,9,2,7
6931,Jiangsu,2.3052039770217305e-06,3.6233184351681345e-06,3,1,2
6932,Jihad,1.9070323809907035e-05,1.9151826014460126e-05,20,9,11
6933,Jihadi,2.326160376812834e-05,1.052487735929791e-05,22,12,10
6934,Jihadist,1.0687763893464371e-05,1.2250267090330355e-05,15,7,8
6935,Jill,2.7452883726349685e-05,2.9504164400654783e-05,35,14,21
6936,Jim,4.840928351745632e-05,9.334358444885519e-05,88,24,64
6937,Jimmy,7.355696326678427e-05,6.573734875233614e-05,76,36,40
6938,Jindal,2.116596378901769e-05,8.79948762826546e-06,17,11,6
6939,Jinping,2.116596378901769e-05,2.6053384938589907e-05,29,11,18
6940,Jintao,4.400843956132392e-06,1.8979287041356905e-06,3,2,1
6941,Jo,1.9070323809907035e-05,2.2602605476525032e-05,23,10,13
6942,Joan,2.3052039770217305e-06,8.79948762826546e-06,6,1,5
6943,Joaquin,1.0687763893464371e-05,1.742643628342769e-05,15,5,10
6944,Job,0.0003166512008436211,0.0003417997057175273,390,167,223
6945,Jobles,1.278340387257504e-05,2.777877466962238e-05,22,6,16
6946,Joblessnes,2.095639979110664e-07,5.348708166200577e-06,4,0,4
6947,Jody,4.400843956132392e-06,3.6233184351681345e-06,5,3,2
6948,Joe,0.0003166512008436211,0.00039183600791746807,405,163,242
6949,Joel,6.496483935243052e-06,7.074097897233022e-06,7,3,4
6950,Johan,4.400843956132392e-06,5.348708166200577e-06,5,2,3
6951,Johann,2.095639979110664e-07,7.074097897233022e-06,4,0,4
6952,Johannesburg,1.0687763893464371e-05,8.79948762826546e-06,10,5,5
6953,Johansson,2.095639979110664e-07,3.6233184351681345e-06,3,0,3
6954,John,0.0006079451579400031,0.0005281417966690313,674,318,356
6955,Johnny,1.278340387257504e-05,3.6233184351681345e-06,8,6,2
6956,Johnson,0.0001343305226609934,0.00013302754826260141,160,75,85
6957,Join,9.451336305789087e-05,7.781507686956326e-05,110,56,54
6958,Joined,6.496483935243052e-06,7.074097897233022e-06,8,4,4
6959,Joining,1.278340387257504e-05,8.79948762826546e-06,11,6,5
6960,Joint,2.5357243747239038e-05,3.2954943862719716e-05,36,15,21
6961,Joke,3.583544364279237e-05,6.228656929027126e-05,65,18,47
6962,Joker,2.095639979110664e-07,5.348708166200577e-06,3,0,3
6963,Joking,4.400843956132392e-06,3.6233184351681345e-06,5,2,3
6964,Jolly,4.400843956132392e-06,1.8979287041356905e-06,5,3,2
6965,Jon,5.4696203454788295e-05,6.746273848336857e-05,68,28,40
6966,Jona,1.0687763893464371e-05,3.6233184351681345e-06,8,6,2
6967,Jonathan,1.48790438516857e-05,2.087721574549256e-05,20,7,13
6968,Jone,6.72700433294523e-05,0.00011404826122124471,112,45,67
6969,Jones,6.496483935243052e-06,7.074097897233022e-06,7,3,4
6970,Jong,8.403516316233764e-05,0.00010024514337298497,104,41,63
6971,JongIl,1.0687763893464371e-05,5.348708166200577e-06,9,5,4
6972,JongUn,1.6974683830796368e-05,1.570104655239525e-05,20,11,9
6973,Jongil,2.326160376812834e-05,3.122955413168725e-05,29,11,18
6974,Jongun,3.583544364279237e-05,4.330728224891437e-05,47,21,26
6975,Joni,4.400843956132392e-06,1.742643628342769e-05,15,3,12
6976,Jordan,8.822644312055891e-05,0.0001278513790695043,129,49,80
6977,Jordanian,2.326160376812834e-05,2.4327995207557487e-05,25,11,14
6978,Jorge,2.3052039770217305e-06,3.6233184351681345e-06,7,2,5
6979,Jose,2.326160376812834e-05,1.570104655239525e-05,23,13,10
6980,Josef,6.496483935243052e-06,7.074097897233022e-06,7,3,4
6981,Joseph,4.002672360101368e-05,2.9504164400654783e-05,39,22,17
6982,Josh,2.116596378901769e-05,2.4327995207557487e-05,27,13,14
6983,Joshua,2.3052039770217305e-06,3.6233184351681345e-06,4,2,2
6984,Journal,4.212236358012434e-05,2.777877466962238e-05,38,21,17
6985,Journalism,2.7452883726349685e-05,1.742643628342769e-05,24,13,11
6986,Journalist,0.00012804360272366158,0.00016408456342118544,165,64,101
6987,Journey,1.0687763893464371e-05,1.570104655239525e-05,16,7,9
6988,Joy,1.6974683830796368e-05,2.4327995207557487e-05,25,9,16
6989,Joya,2.095639979110664e-07,3.6233184351681345e-06,3,0,3
6990,Jr,0.00010289592297433347,0.00015028144557292604,153,53,100
6991,Juan,3.1644163684570994e-05,3.122955413168725e-05,34,16,18
6992,Juarez,2.326160376812834e-05,1.570104655239525e-05,23,11,12
6993,Judaism,4.400843956132392e-06,3.6233184351681345e-06,4,2,2
6994,Judge,0.00029779044103162505,0.0004246184128070847,439,163,276
6995,Judging,4.400843956132392e-06,1.8979287041356905e-06,5,2,3
6996,Judgment,1.0687763893464371e-05,7.074097897233022e-06,10,6,4
6997,Judicial,3.3739803663681634e-05,3.122955413168725e-05,39,19,20
6998,Judiciary,3.583544364279237e-05,4.1581892517881935e-05,42,17,25
6999,Judy,4.400843956132392e-06,3.6233184351681345e-06,4,2,2
7000,Juggernaut,2.095639979110664e-07,3.6233184351681345e-06,3,1,2
7001,Juli,2.3052039770217305e-06,1.8979287041356905e-06,3,1,2
7002,Julia,2.116596378901769e-05,1.570104655239525e-05,24,12,12
7003,Julian,0.00015738256243121094,0.0001571830044970555,192,85,107
7004,Julie,2.3052039770217305e-06,1.052487735929791e-05,8,1,7
7005,Juliet,2.095639979110664e-07,3.6233184351681345e-06,4,1,3
7006,Juliu,2.3052039770217305e-06,1.052487735929791e-05,8,1,7
7007,July,0.00019091280209698145,0.00017271151207634748,212,95,117
7008,Jump,2.7452883726349685e-05,1.9151826014460126e-05,34,20,14
7009,Jumped,2.095639979110664e-07,1.7253897310324457e-07,4,3,1
7010,Jumper,2.095639979110664e-07,3.6233184351681345e-06,3,1,2
7011,Jumping,4.400843956132392e-06,3.6233184351681345e-06,4,2,2
7012,Juncker,4.400843956132392e-06,1.8979287041356905e-06,3,2,1
7013,June,0.00015738256243121094,0.0001554576147660233,189,81,108
7014,Juneteenth,6.496483935243052e-06,1.8979287041356905e-06,4,3,1
7015,Jung,4.400843956132392e-06,3.6233184351681345e-06,4,2,2
7016,Jungle,6.496483935243052e-06,1.052487735929791e-05,10,3,7
7017,Junior,4.400843956132392e-06,1.7253897310324457e-07,3,2,1
7018,Juniper,2.095639979110664e-07,7.074097897233022e-06,4,0,4
7019,Junk,2.116596378901769e-05,8.79948762826546e-06,17,10,7
7020,Jupiter,1.48790438516857e-05,1.3975656821362803e-05,17,7,10
7021,Jurassic,6.496483935243052e-06,1.8979287041356905e-06,4,3,1
7022,Jurez,6.496483935243052e-06,1.3975656821362803e-05,12,4,8
7023,Jurisdiction,2.095639979110664e-07,3.6233184351681345e-06,3,0,3
7024,Juror,1.278340387257504e-05,7.074097897233022e-06,10,6,4
7025,Jury,3.7931083621902995e-05,2.777877466962238e-05,40,20,20
7026,Just,2.095639979110664e-07,5.348708166200577e-06,3,0,3
7027,Justice,0.00041724191984093297,0.00047120393554496063,534,227,307
7028,Justification,8.592123914353715e-06,5.348708166200577e-06,7,4,3
7029,Justified,2.095639979110664e-07,5.348708166200577e-06,3,0,3
7030,Justify,8.592123914353715e-06,1.570104655239525e-05,15,6,9
7031,Justin,4.6313643538345614e-05,2.6053384938589907e-05,39,23,16
7032,Justine,8.592123914353715e-06,3.6233184351681345e-06,6,4,2
7033,Juvenile,8.592123914353715e-06,1.3975656821362803e-05,12,4,8
7034,K12,2.3052039770217305e-06,3.6233184351681345e-06,3,1,2
7035,K9,4.400843956132392e-06,1.8979287041356905e-06,4,2,2
7036,KBR,6.496483935243052e-06,1.7253897310324457e-07,4,3,1
7037,KFC,1.48790438516857e-05,1.052487735929791e-05,13,7,6
7038,KGB,1.278340387257504e-05,2.087721574549256e-05,18,6,12
7039,KKK,1.48790438516857e-05,3.122955413168725e-05,32,10,22
7040,Kabul,4.212236358012434e-05,4.8483451442011706e-05,49,21,28
7041,Kaczynski,4.400843956132392e-06,1.8979287041356905e-06,4,2,2
7042,Kadima,2.3052039770217305e-06,7.074097897233022e-06,5,1,4
7043,Kadyrov,2.3052039770217305e-06,3.6233184351681345e-06,4,1,3
7044,Kaepernick,1.278340387257504e-05,1.9151826014460126e-05,18,7,11
7045,Kaesong,8.592123914353715e-06,1.8979287041356905e-06,7,5,2
7046,Kafka,2.095639979110664e-07,8.79948762826546e-06,5,0,5
7047,Kaine,3.3739803663681634e-05,4.6758061710979285e-05,45,17,28
7048,Kalanick,2.7452883726349685e-05,1.2250267090330355e-05,20,13,7
7049,Kalashnikov,1.278340387257504e-05,1.2250267090330355e-05,14,6,8
7050,Kaliningrad,4.400843956132392e-06,5.348708166200577e-06,5,2,3
7051,Kamala,1.9070323809907035e-05,4.330728224891437e-05,39,11,28
7052,Kamchatka,2.095639979110664e-07,3.6233184351681345e-06,4,0,4
7053,Kampf,1.278340387257504e-05,1.570104655239525e-05,17,7,10
7054,Kan,4.400843956132392e-06,8.79948762826546e-06,8,2,6
7055,Kandahar,1.278340387257504e-05,1.2250267090330355e-05,13,6,7
7056,Kane,1.0687763893464371e-05,5.348708166200577e-06,10,7,3
7057,Kangaroo,4.400843956132392e-06,1.8979287041356905e-06,3,2,1
7058,Kansa,8.193952318322689e-05,7.091351794543343e-05,92,43,49
7059,Kansan,2.3052039770217305e-06,3.6233184351681345e-06,3,1,2
7060,Kanye,1.278340387257504e-05,1.570104655239525e-05,15,6,9
7061,Kapital,2.3052039770217305e-06,1.7253897310324457e-07,3,2,1
7062,Kaplan,2.095639979110664e-07,5.348708166200577e-06,3,0,3
7063,Karachi,6.496483935243052e-06,1.2250267090330355e-05,12,4,8
7064,Karadzic,6.496483935243052e-06,1.7253897310324457e-07,3,3,0
7065,Kardashian,4.400843956132392e-06,1.2250267090330355e-05,10,2,8
7066,Kareem,2.3052039770217305e-06,3.6233184351681345e-06,3,1,2
7067,Karen,2.116596378901769e-05,1.742643628342769e-05,20,10,10
7068,Karine,2.3052039770217305e-06,1.8979287041356905e-06,3,2,1
7069,Karl,1.0687763893464371e-05,1.052487735929791e-05,15,5,10
7070,Karroubi,4.400843956132392e-06,7.074097897233022e-06,6,2,4
7071,Karzai,4.212236358012434e-05,3.985650278684949e-05,51,26,25
7072,Kasab,2.3052039770217305e-06,3.6233184351681345e-06,4,2,2
7073,Kashmir,1.9070323809907035e-05,2.2602605476525032e-05,26,11,15
7074,Kashmiri,2.3052039770217305e-06,5.348708166200577e-06,4,1,3
7075,Kasich,0.00010080028299522283,4.8483451442011706e-05,88,51,37
7076,Kasparov,6.496483935243052e-06,7.074097897233022e-06,7,3,4
7077,Kaspersky,4.400843956132392e-06,3.6233184351681345e-06,4,2,2
7078,Kate,2.116596378901769e-05,1.9151826014460126e-05,26,12,14
7079,Katherine,6.496483935243052e-06,5.348708166200577e-06,6,3,3
7080,Kathleen,1.6974683830796368e-05,8.79948762826546e-06,15,10,5
7081,Kathmandu,4.400843956132392e-06,3.6233184351681345e-06,4,2,2
7082,Kathryn,4.400843956132392e-06,5.348708166200577e-06,5,2,3
7083,Kathy,1.278340387257504e-05,1.3975656821362803e-05,14,6,8
7084,Katie,1.0687763893464371e-05,1.3975656821362803e-05,16,6,10
7085,Katrina,2.326160376812834e-05,1.3975656821362803e-05,19,11,8
7086,Katsav,6.496483935243052e-06,1.8979287041356905e-06,4,3,1
7087,Katyn,4.400843956132392e-06,1.7253897310324457e-07,4,2,2
7088,Kaupthing,6.496483935243052e-06,3.6233184351681345e-06,6,4,2
7089,Kavanaugh,3.1644163684570994e-05,2.087721574549256e-05,28,15,13
7090,Kay,6.496483935243052e-06,3.6233184351681345e-06,6,3,3
7091,Kayla,2.095639979110664e-07,7.074097897233022e-06,4,0,4
7092,Kayleigh,4.400843956132392e-06,3.6233184351681345e-06,5,2,3
7093,Kazakhstan,1.6974683830796368e-05,2.777877466962238e-05,25,9,16
7094,Kazan,2.3052039770217305e-06,3.6233184351681345e-06,3,1,2
7095,Keep,0.0002160604818463093,0.0002382763218555804,267,115,152
7096,Keeper,4.400843956132392e-06,5.348708166200577e-06,6,3,3
7097,Keeping,4.6313643538345614e-05,3.985650278684949e-05,47,23,24
7098,Keith,4.840928351745632e-05,3.640572332478458e-05,50,24,26
7099,Kelley,4.400843956132392e-06,3.6233184351681345e-06,4,2,2
7100,Kelli,2.3052039770217305e-06,3.6233184351681345e-06,3,1,2
7101,Kelly,0.00011337412286988677,0.00010542131256608228,133,60,73
7102,Kellyanne,5.260056347567764e-05,5.3659620635109e-05,63,26,37
7103,Kemp,8.592123914353715e-06,8.79948762826546e-06,11,4,7
7104,Ken,3.1644163684570994e-05,2.2602605476525032e-05,30,15,15
7105,Kendrick,4.400843956132392e-06,3.6233184351681345e-06,4,2,2
7106,Kennedy,6.098312339212028e-05,6.401195902130366e-05,70,30,40
7107,Kenneth,8.592123914353715e-06,1.3975656821362803e-05,13,5,8
7108,Kenny,8.592123914353715e-06,5.348708166200577e-06,7,4,3
7109,Kenosha,2.3052039770217305e-06,8.79948762826546e-06,6,1,5
7110,Kent,6.496483935243052e-06,7.074097897233022e-06,7,3,4
7111,Kentucky,6.517440335034157e-05,0.00010024514337298497,97,33,64
7112,Kenya,8.403516316233764e-05,8.644202552472544e-05,104,45,59
7113,Kenyan,4.212236358012434e-05,2.087721574549256e-05,39,23,16
7114,Kepler,2.3052039770217305e-06,5.348708166200577e-06,4,1,3
7115,Kept,1.9070323809907035e-05,1.2250267090330355e-05,17,9,8
7116,Kerala,4.400843956132392e-06,3.6233184351681345e-06,5,2,3
7117,Kerry,6.517440335034157e-05,0.00010714670229711469,104,37,67
7118,Kerviel,2.3052039770217305e-06,5.348708166200577e-06,4,1,3
7119,Kessler,4.400843956132392e-06,1.8979287041356905e-06,3,2,1
7120,Ketanji,4.400843956132392e-06,5.348708166200577e-06,5,2,3
7121,Kettle,2.3052039770217305e-06,3.6233184351681345e-06,3,1,2
7122,Kevin,5.6791843433898893e-05,7.091351794543343e-05,80,32,48
7123,Key,0.00018462588215964923,0.0001916907991177046,222,100,122
7124,Keyboard,2.3052039770217305e-06,5.348708166200577e-06,5,1,4
7125,Keynote,6.496483935243052e-06,3.6233184351681345e-06,5,3,2
7126,Keystone,6.098312339212028e-05,3.985650278684949e-05,53,30,23
7127,Khadr,2.3052039770217305e-06,1.8979287041356905e-06,3,1,2
7128,Khaled,6.496483935243052e-06,1.8979287041356905e-06,4,3,1
7129,Khalid,2.3052039770217305e-06,8.79948762826546e-06,7,1,6
7130,Khalifa,6.496483935243052e-06,1.8979287041356905e-06,4,3,1
7131,Khamenei,3.7931083621902995e-05,2.2602605476525032e-05,34,18,16
7132,Khan,7.355696326678427e-05,6.746273848336857e-05,78,38,40
7133,Khanna,4.400843956132392e-06,3.6233184351681345e-06,5,3,2
7134,Kharkiv,4.400843956132392e-06,3.6233184351681345e-06,4,2,2
7135,Khartoum,1.0687763893464371e-05,5.348708166200577e-06,9,5,4
7136,Khashoggi,6.496483935243052e-06,5.348708166200577e-06,6,3,3
7137,Khatami,8.592123914353715e-06,1.7253897310324457e-07,4,4,0
7138,Khizr,2.954852370546031e-05,1.9151826014460126e-05,27,16,11
7139,Khmer,4.400843956132392e-06,7.074097897233022e-06,8,2,6
7140,Khodorkovsky,1.0687763893464371e-05,3.6233184351681345e-06,7,5,2
7141,Khomeini,2.3052039770217305e-06,5.348708166200577e-06,4,1,3
7142,Khyber,4.400843956132392e-06,1.8979287041356905e-06,3,2,1
7143,KiMoon,2.3052039770217305e-06,1.7253897310324457e-07,3,1,2
7144,Kick,2.954852370546031e-05,4.50326719799468e-05,46,18,28
7145,Kickback,2.3052039770217305e-06,1.8979287041356905e-06,3,1,2
7146,Kicked,1.278340387257504e-05,1.570104655239525e-05,18,8,10
7147,Kicking,1.0687763893464371e-05,7.074097897233022e-06,10,5,5
7148,Kickstarter,8.592123914353715e-06,1.8979287041356905e-06,5,4,1
7149,Kid,0.00024539944155385846,0.0002538048294348729,297,131,166
7150,Kidding,4.400843956132392e-06,3.6233184351681345e-06,5,2,3
7151,Kidnap,1.0687763893464371e-05,5.348708166200577e-06,9,5,4
7152,Kidnapped,6.496483935243052e-06,2.6053384938589907e-05,21,5,16
7153,Kidnapping,1.0687763893464371e-05,1.3975656821362803e-05,15,5,10
7154,Kidney,4.400843956132392e-06,5.348708166200577e-06,6,3,3
7155,Kiev,6.936568330856297e-05,4.8483451442011706e-05,68,39,29
7156,Kilimanjaro,4.400843956132392e-06,5.348708166200577e-06,5,2,3
7157,Kill,0.00016576512234765329,0.00016753534288325053,209,92,117
7158,Killed,0.00016157384238943198,0.00017271151207634748,194,86,108
7159,Killer,5.4696203454788295e-05,4.50326719799468e-05,59,30,29
7160,Killing,0.00012385232276544028,0.00015028144557292604,163,65,98
7161,Kilmeade,2.3052039770217305e-06,8.79948762826546e-06,6,1,5
7162,Kim,0.00030826864092717824,0.00032109502894513814,357,161,196
7163,Kimberley,2.095639979110664e-07,5.348708166200577e-06,3,0,3
7164,Kimmel,2.116596378901769e-05,1.570104655239525e-05,19,10,9
7165,Kimoon,2.116596378901769e-05,2.087721574549256e-05,24,11,13
7166,Kind,4.840928351745632e-05,4.6758061710979285e-05,60,27,33
7167,Kinder,2.3052039770217305e-06,8.79948762826546e-06,6,1,5
7168,Kindergarten,2.3052039770217305e-06,1.8979287041356905e-06,3,1,2
7169,Kindle,4.400843956132392e-06,3.6233184351681345e-06,7,3,4
7170,Kindnes,1.48790438516857e-05,1.570104655239525e-05,17,7,10
7171,King,0.00020348664197164515,0.00022619859373835345,250,109,141
7172,Kingdom,3.7931083621902995e-05,5.1934230904076595e-05,53,18,35
7173,Kingpin,2.3052039770217305e-06,5.348708166200577e-06,5,1,4
7174,Kingston,4.400843956132392e-06,1.8979287041356905e-06,3,2,1
7175,Kinshasa,2.3052039770217305e-06,5.348708166200577e-06,4,1,3
7176,Kippur,6.496483935243052e-06,3.6233184351681345e-06,5,3,2
7177,Kirchner,1.6974683830796368e-05,5.348708166200577e-06,11,8,3
7178,Kiribati,1.278340387257504e-05,3.6233184351681345e-06,9,7,2
7179,Kirk,1.0687763893464371e-05,1.3975656821362803e-05,13,5,8
7180,Kirkuk,2.3052039770217305e-06,1.7253897310324457e-07,3,1,2
7181,Kirsten,1.48790438516857e-05,1.742643628342769e-05,18,8,10
7182,Kirstjen,8.592123914353715e-06,3.6233184351681345e-06,8,5,3
7183,Kis,6.496483935243052e-06,7.074097897233022e-06,7,3,4
7184,Kislyak,4.400843956132392e-06,3.6233184351681345e-06,4,2,2
7185,Kissing,2.3052039770217305e-06,5.348708166200577e-06,5,2,3
7186,Kissinger,1.9070323809907035e-05,1.742643628342769e-05,19,9,10
7187,Kit,1.6974683830796368e-05,1.2250267090330355e-05,15,8,7
7188,Kitchen,1.0687763893464371e-05,7.074097897233022e-06,12,6,6
7189,Kitten,8.592123914353715e-06,1.742643628342769e-05,16,6,10
7190,Kitty,4.400843956132392e-06,5.348708166200577e-06,5,2,3
7191,Kiwi,2.3052039770217305e-06,1.8979287041356905e-06,3,1,2
7192,Klan,8.592123914353715e-06,8.79948762826546e-06,12,7,5
7193,Klau,2.095639979110664e-07,5.348708166200577e-06,3,0,3
7194,Klein,2.095639979110664e-07,1.2250267090330355e-05,8,0,8
7195,Kline,2.095639979110664e-07,5.348708166200577e-06,4,0,4
7196,Klobuchar,2.3052039770217305e-06,5.348708166200577e-06,4,1,3
7197,Klux,6.496483935243052e-06,8.79948762826546e-06,11,6,5
7198,Kmart,6.496483935243052e-06,1.7253897310324457e-07,3,3,0
7199,Knee,8.592123914353715e-06,8.79948762826546e-06,9,4,5
7200,Knesset,1.278340387257504e-05,7.074097897233022e-06,12,6,6
7201,Knew,3.583544364279237e-05,2.9504164400654783e-05,41,21,20
7202,Knife,4.400843956132392e-06,1.570104655239525e-05,12,3,9
7203,Knight,2.116596378901769e-05,1.052487735929791e-05,17,11,6
7204,Knock,2.3052039770217305e-06,1.3975656821362803e-05,10,1,9
7205,Knocked,6.496483935243052e-06,3.6233184351681345e-06,5,3,2
7206,Knockout,4.400843956132392e-06,1.8979287041356905e-06,3,2,1
7207,Know,0.000459154719423146,0.00044704847931050624,549,248,301
7208,Knowing,1.0687763893464371e-05,1.8979287041356905e-06,10,9,1
7209,Knowledge,6.496483935243052e-06,8.79948762826546e-06,10,4,6
7210,Known,2.5357243747239038e-05,2.6053384938589907e-05,32,14,18
7211,Knox,2.095639979110664e-07,1.052487735929791e-05,7,1,6
7212,Ko,4.400843956132392e-06,3.6233184351681345e-06,4,2,2
7213,Kobach,2.5357243747239038e-05,3.8131113055817005e-05,40,14,26
7214,Kobane,8.592123914353715e-06,5.348708166200577e-06,7,4,3
7215,Kobani,6.496483935243052e-06,5.348708166200577e-06,11,3,8
7216,Kobe,4.400843956132392e-06,7.074097897233022e-06,8,3,5
7217,Koch,6.72700433294523e-05,7.263890767646595e-05,89,41,48
7218,KochLinked,2.3052039770217305e-06,1.8979287041356905e-06,3,1,2
7219,Kofi,8.592123914353715e-06,5.348708166200577e-06,9,6,3
7220,Kohl,4.400843956132392e-06,5.348708166200577e-06,5,2,3
7221,Kolkata,2.3052039770217305e-06,1.8979287041356905e-06,3,1,2
7222,Kong,0.0001762433222432067,0.00013302754826260141,178,92,86
7223,Kony,2.3052039770217305e-06,7.074097897233022e-06,5,1,4
7224,KoolAid,2.3052039770217305e-06,3.6233184351681345e-06,3,1,2
7225,Kopimism,4.400843956132392e-06,1.8979287041356905e-06,3,2,1
7226,Koran,2.954852370546031e-05,1.742643628342769e-05,26,14,12
7227,Koranburning,2.095639979110664e-07,7.074097897233022e-06,4,0,4
7228,Korea,0.0011255682327803373,0.0011320282025303863,1341,599,742
7229,Korean,0.0004633459993813674,0.0003780328900692085,482,236,246
7230,Kosher,2.095639979110664e-07,5.348708166200577e-06,3,0,3
7231,Kosovo,2.116596378901769e-05,3.2954943862719716e-05,32,12,20
7232,Kraft,6.496483935243052e-06,1.052487735929791e-05,9,3,6
7233,Krasner,4.400843956132392e-06,1.8979287041356905e-06,4,3,1
7234,Kremlin,6.307876337123095e-05,5.5385010366141504e-05,68,32,36
7235,Kremlinbacked,2.3052039770217305e-06,3.6233184351681345e-06,3,1,2
7236,Kremlinlinked,2.3052039770217305e-06,5.348708166200577e-06,4,1,3
7237,Kri,2.116596378901769e-05,3.122955413168725e-05,32,11,21
7238,Kristen,2.3052039770217305e-06,5.348708166200577e-06,5,1,4
7239,Kristi,4.400843956132392e-06,1.8979287041356905e-06,4,2,2
7240,Kristin,2.095639979110664e-07,5.348708166200577e-06,6,0,6
7241,Kristina,4.400843956132392e-06,3.6233184351681345e-06,4,2,2
7242,Kristol,4.400843956132392e-06,3.6233184351681345e-06,7,3,4
7243,Kroger,2.3052039770217305e-06,5.348708166200577e-06,5,1,4
7244,Krueger,4.400843956132392e-06,1.8979287041356905e-06,5,2,3
7245,Kruger,8.592123914353715e-06,5.348708166200577e-06,8,5,3
7246,Krugman,2.7452883726349685e-05,1.9151826014460126e-05,31,14,17
7247,Ku,4.400843956132392e-06,8.79948762826546e-06,9,4,5
7248,Kuan,6.496483935243052e-06,1.8979287041356905e-06,5,3,2
7249,Kucinich,8.592123914353715e-06,5.348708166200577e-06,7,4,3
7250,Kudlow,4.400843956132392e-06,8.79948762826546e-06,7,2,5
7251,Kumar,2.3052039770217305e-06,3.6233184351681345e-06,4,2,2
7252,Kunar,2.3052039770217305e-06,3.6233184351681345e-06,4,2,2
7253,Kunduz,4.400843956132392e-06,1.052487735929791e-05,9,2,7
7254,Kung,2.3052039770217305e-06,1.8979287041356905e-06,3,1,2
7255,Kurd,6.936568330856297e-05,5.5385010366141504e-05,79,39,40
7256,Kurdish,9.451336305789087e-05,7.608968713853079e-05,98,47,51
7257,Kurdistan,1.278340387257504e-05,2.087721574549256e-05,22,8,14
7258,Kurt,4.400843956132392e-06,1.8979287041356905e-06,4,2,2
7259,Kushner,8.193952318322689e-05,8.989280498679035e-05,98,42,56
7260,Kuwait,4.840928351745632e-05,2.9504164400654783e-05,46,24,22
7261,Kuwaiti,6.496483935243052e-06,1.3975656821362803e-05,11,3,8
7262,Kyi,3.583544364279237e-05,1.570104655239525e-05,32,18,14
7263,Kyiv,1.0687763893464371e-05,1.8979287041356905e-06,9,8,1
7264,Kyle,6.496483935243052e-06,1.9151826014460126e-05,14,3,11
7265,Kyoto,1.48790438516857e-05,8.79948762826546e-06,13,8,5
7266,Kyrgyz,4.400843956132392e-06,7.074097897233022e-06,6,2,4
7267,Kyrgyzstan,2.5357243747239038e-05,2.087721574549256e-05,27,12,15
7268,LA,4.6313643538345614e-05,2.9504164400654783e-05,45,26,19
7269,LAPD,6.496483935243052e-06,1.570104655239525e-05,12,3,9
7270,LAST,2.3052039770217305e-06,1.8979287041356905e-06,3,2,1
7271,LAquila,4.400843956132392e-06,5.348708166200577e-06,5,2,3
7272,LED,8.592123914353715e-06,1.8979287041356905e-06,6,4,2
7273,LET,2.3052039770217305e-06,3.6233184351681345e-06,3,1,2
7274,LGBT,0.00010289592297433347,9.851975364195259e-05,118,54,64
7275,LGBTQ,4.6313643538345614e-05,5.711040009717395e-05,59,25,34
7276,LHC,4.400843956132392e-06,3.6233184351681345e-06,4,2,2
7277,LIBOR,1.48790438516857e-05,8.79948762826546e-06,12,7,5
7278,LISTEN,2.095639979110664e-07,3.6233184351681345e-06,3,0,3
7279,LIVE,2.116596378901769e-05,2.4327995207557487e-05,26,11,15
7280,LLC,2.095639979110664e-07,3.6233184351681345e-06,4,1,3
7281,LNG,2.3052039770217305e-06,3.6233184351681345e-06,3,1,2
7282,LO,6.496483935243052e-06,1.8979287041356905e-06,4,3,1
7283,LOL,6.496483935243052e-06,1.052487735929791e-05,12,4,8
7284,LONDON,6.496483935243052e-06,1.8979287041356905e-06,4,3,1
7285,LOOK,2.3052039770217305e-06,8.79948762826546e-06,8,2,6
7286,LOT,2.3052039770217305e-06,3.6233184351681345e-06,3,1,2
7287,LOVE,2.3052039770217305e-06,3.6233184351681345e-06,3,1,2
7288,LSD,6.496483935243052e-06,1.3975656821362803e-05,12,4,8
7289,LTTE,6.496483935243052e-06,5.348708166200577e-06,8,4,4
7290,La,5.4696203454788295e-05,0.00010024514337298497,96,34,62
7291,Lab,1.278340387257504e-05,1.2250267090330355e-05,13,6,7
7292,Label,2.326160376812834e-05,1.742643628342769e-05,24,13,11
7293,Labeling,2.3052039770217305e-06,7.074097897233022e-06,6,1,5
7294,Labor,0.00011966104280721883,0.00014510527637982858,158,63,95
7295,Laboratory,4.400843956132392e-06,3.6233184351681345e-06,4,2,2
7296,Labour,4.002672360101368e-05,3.468033359375216e-05,44,21,23
7297,Labrador,6.496483935243052e-06,1.7253897310324457e-07,4,3,1
7298,Lack,3.7931083621902995e-05,3.2954943862719716e-05,40,18,22
7299,Lacking,4.400843956132392e-06,1.8979287041356905e-06,5,3,2
7300,Laden,0.00018043460220142793,8.989280498679035e-05,152,89,63
7301,Lady,5.050492349656699e-05,4.330728224891437e-05,53,27,26
7302,Lafayette,4.400843956132392e-06,1.8979287041356905e-06,3,2,1
7303,Lagarde,1.0687763893464371e-05,7.074097897233022e-06,9,5,4
7304,Lagging,6.496483935243052e-06,3.6233184351681345e-06,5,3,2
7305,Lago,6.496483935243052e-06,5.348708166200577e-06,6,3,3
7306,Lahore,1.6974683830796368e-05,1.2250267090330355e-05,16,9,7
7307,Lahren,1.6974683830796368e-05,7.074097897233022e-06,12,8,4
7308,Laid,4.400843956132392e-06,7.074097897233022e-06,6,2,4
7309,Lake,4.002672360101368e-05,3.468033359375216e-05,43,21,22
7310,Lama,7.355696326678427e-05,4.8483451442011706e-05,66,37,29
7311,Lamar,4.400843956132392e-06,1.3975656821362803e-05,11,2,9
7312,Lamb,1.48790438516857e-05,3.6233184351681345e-06,9,7,2
7313,Lambast,2.3052039770217305e-06,1.8979287041356905e-06,3,1,2
7314,Lambaste,2.3052039770217305e-06,5.348708166200577e-06,4,1,3
7315,Lambert,2.095639979110664e-07,3.6233184351681345e-06,3,1,2
7316,Lamborghini,2.3052039770217305e-06,3.6233184351681345e-06,3,1,2
7317,Lamborn,4.400843956132392e-06,1.8979287041356905e-06,3,2,1
7318,Lame,2.3052039770217305e-06,8.79948762826546e-06,6,1,5
7319,LameDuck,4.400843956132392e-06,7.074097897233022e-06,7,2,5
7320,Lament,6.496483935243052e-06,8.79948762826546e-06,9,3,6
7321,Lance,2.3052039770217305e-06,5.348708166200577e-06,4,1,3
7322,Lancet,6.496483935243052e-06,3.6233184351681345e-06,5,3,2
7323,Land,8.822644312055891e-05,9.679436391092026e-05,107,44,63
7324,Lander,2.3052039770217305e-06,3.6233184351681345e-06,3,1,2
7325,Landing,1.48790438516857e-05,1.052487735929791e-05,13,7,6
7326,Landlord,6.496483935243052e-06,1.052487735929791e-05,9,3,6
7327,Landmark,1.278340387257504e-05,2.6053384938589907e-05,24,8,16
7328,Landrieu,2.3052039770217305e-06,5.348708166200577e-06,5,2,3
7329,Landscape,4.400843956132392e-06,8.79948762826546e-06,7,2,5
7330,Landslide,6.496483935243052e-06,1.3975656821362803e-05,11,3,8
7331,Lane,1.0687763893464371e-05,1.2250267090330355e-05,13,6,7
7332,Lang,2.3052039770217305e-06,3.6233184351681345e-06,4,1,3
7333,Language,2.326160376812834e-05,4.1581892517881935e-05,40,14,26
7334,Languish,6.496483935243052e-06,1.7253897310324457e-07,3,3,0
7335,Lanka,6.936568330856297e-05,5.3659620635109e-05,80,43,37
7336,Lankan,2.7452883726349685e-05,4.6758061710979285e-05,49,18,31
7337,Lansing,4.400843956132392e-06,5.348708166200577e-06,5,2,3
7338,Lao,1.0687763893464371e-05,1.3975656821362803e-05,13,5,8
7339,Lap,4.400843956132392e-06,5.348708166200577e-06,5,2,3
7340,Lapid,2.3052039770217305e-06,3.6233184351681345e-06,3,1,2
7341,Lapse,4.400843956132392e-06,1.8979287041356905e-06,3,2,1
7342,Laptop,8.592123914353715e-06,1.052487735929791e-05,12,6,6
7343,Laquan,4.400843956132392e-06,7.074097897233022e-06,8,3,5
7344,Lara,2.3052039770217305e-06,5.348708166200577e-06,4,1,3
7345,Laredo,6.496483935243052e-06,1.7253897310324457e-07,3,3,0
7346,Large,4.6313643538345614e-05,4.6758061710979285e-05,52,23,29
7347,Largely,2.3052039770217305e-06,8.79948762826546e-06,7,1,6
7348,Larger,8.592123914353715e-06,7.074097897233022e-06,10,6,4
7349,Largest,5.260056347567764e-05,7.781507686956326e-05,77,30,47
7350,Larry,4.6313643538345614e-05,3.2954943862719716e-05,47,26,21
7351,Larson,2.095639979110664e-07,7.074097897233022e-06,4,0,4
7352,Laser,6.496483935243052e-06,5.348708166200577e-06,7,4,3
7353,Lash,1.9070323809907035e-05,1.2250267090330355e-05,18,9,9
7354,Last,0.0002935991610734039,0.000286587234324489,356,167,189
7355,LastDitch,2.3052039770217305e-06,1.052487735929791e-05,9,2,7
7356,LastMinute,2.954852370546031e-05,2.2602605476525032e-05,29,14,15
7357,Lasting,4.400843956132392e-06,8.79948762826546e-06,7,2,5
7358,Latakia,4.400843956132392e-06,1.8979287041356905e-06,3,2,1
7359,Late,5.050492349656699e-05,5.5385010366141504e-05,61,26,35
7360,LateNight,6.496483935243052e-06,5.348708166200577e-06,6,3,3
7361,Later,4.840928351745632e-05,4.50326719799468e-05,51,24,27
7362,Latest,0.00016576512234765329,0.00016580995315221804,188,84,104
7363,Latin,5.4696203454788295e-05,8.989280498679035e-05,88,29,59
7364,Latina,6.496483935243052e-06,8.79948762826546e-06,8,3,5
7365,Latino,8.403516316233764e-05,9.506897417988779e-05,101,43,58
7366,Latinx,2.095639979110664e-07,3.6233184351681345e-06,3,1,2
7367,Latvia,2.5357243747239038e-05,7.074097897233022e-06,18,13,5
7368,Latvian,2.095639979110664e-07,1.7253897310324457e-07,4,2,2
7369,Laud,4.400843956132392e-06,3.6233184351681345e-06,4,2,2
7370,Lauer,4.400843956132392e-06,3.6233184351681345e-06,4,2,2
7371,Laugh,2.116596378901769e-05,8.79948762826546e-06,17,12,5
7372,Laughed,6.496483935243052e-06,5.348708166200577e-06,7,4,3
7373,Laughing,2.095639979110664e-07,1.570104655239525e-05,9,0,9
7374,Launch,0.00011966104280721883,0.0001278513790695043,149,63,86
7375,Launched,1.48790438516857e-05,2.087721574549256e-05,22,8,14
7376,Launcher,4.400843956132392e-06,1.8979287041356905e-06,3,2,1
7377,Launching,1.0687763893464371e-05,3.6233184351681345e-06,8,5,3
7378,Laundering,4.400843956132392e-06,5.348708166200577e-06,5,2,3
7379,Laundry,4.400843956132392e-06,8.79948762826546e-06,7,2,5
7380,Laura,1.9070323809907035e-05,1.742643628342769e-05,22,9,13
7381,Laureate,1.278340387257504e-05,8.79948762826546e-06,11,6,5
7382,Lauren,1.6974683830796368e-05,1.742643628342769e-05,21,10,11
7383,Laurence,8.592123914353715e-06,1.8979287041356905e-06,5,4,1
7384,Laurent,2.095639979110664e-07,3.6233184351681345e-06,3,0,3
7385,Laurie,4.400843956132392e-06,1.8979287041356905e-06,3,2,1
7386,Lavabit,1.0687763893464371e-05,3.6233184351681345e-06,8,6,2
7387,Lavrov,1.278340387257504e-05,1.2250267090330355e-05,13,6,7
7388,Law,0.0005471715985457941,0.0005678257604827774,656,290,366
7389,Lawmaker,0.00031455556086451027,0.0003090173008279106,365,169,196
7390,Lawn,8.592123914353715e-06,1.3975656821362803e-05,12,4,8
7391,Lawrence,8.592123914353715e-06,1.570104655239525e-05,15,6,9
7392,Lawson,8.592123914353715e-06,1.7253897310324457e-07,5,5,0
7393,Lawsuit,0.0001259479627445509,0.00012440059960743937,154,70,84
7394,Lawyer,0.00020139100199253443,0.0002313747629314509,246,104,142
7395,Lay,1.278340387257504e-05,2.777877466962238e-05,24,8,16
7396,Layer,2.3052039770217305e-06,3.6233184351681345e-06,3,1,2
7397,Laying,2.3052039770217305e-06,5.348708166200577e-06,5,1,4
7398,Layoff,4.400843956132392e-06,7.074097897233022e-06,7,2,5
7399,Lazy,8.592123914353715e-06,7.074097897233022e-06,9,4,5
7400,Le,1.48790438516857e-05,2.9504164400654783e-05,32,11,21
7401,LeBron,2.3052039770217305e-06,5.348708166200577e-06,4,1,3
7402,LePage,2.5357243747239038e-05,1.742643628342769e-05,30,16,14
7403,Lead,0.0002097735619089774,0.00016580995315221804,210,108,102
7404,Leader,0.00043610267965292894,0.0003607789927588843,464,224,240
7405,Leadership,6.098312339212028e-05,8.989280498679035e-05,88,34,54
7406,Leading,5.4696203454788295e-05,6.401195902130366e-05,72,32,40
7407,Leaf,5.888748341300963e-05,6.573734875233614e-05,72,34,38
7408,Leaflet,2.095639979110664e-07,8.79948762826546e-06,6,0,6
7409,League,5.050492349656699e-05,5.020884117304414e-05,62,26,36
7410,Leah,2.3052039770217305e-06,5.348708166200577e-06,4,1,3
7411,Leahy,2.3052039770217305e-06,1.052487735929791e-05,8,1,7
7412,Leak,6.936568330856297e-05,6.401195902130366e-05,75,34,41
7413,Leaked,9.451336305789087e-05,7.954046660059569e-05,101,48,53
7414,Leaker,1.0687763893464371e-05,1.052487735929791e-05,13,6,7
7415,Leaking,8.592123914353715e-06,7.074097897233022e-06,8,4,4
7416,Lean,6.496483935243052e-06,5.348708166200577e-06,7,3,4
7417,Leandra,2.095639979110664e-07,7.074097897233022e-06,4,0,4
7418,Leaning,8.592123914353715e-06,5.348708166200577e-06,7,4,3
7419,Leap,4.400843956132392e-06,8.79948762826546e-06,7,2,5
7420,Learn,7.146132328767358e-05,7.263890767646595e-05,85,38,47
7421,Learned,1.9070323809907035e-05,3.985650278684949e-05,35,11,24
7422,Learning,2.116596378901769e-05,3.468033359375216e-05,31,11,20
7423,Lease,8.592123914353715e-06,3.6233184351681345e-06,6,4,2
7424,Leash,2.3052039770217305e-06,1.8979287041356905e-06,3,1,2
7425,Least,7.565260324589493e-05,8.126585633162811e-05,92,37,55
7426,Leathley,2.095639979110664e-07,3.6233184351681345e-06,3,1,2
7427,Leave,0.0001531912824729893,0.00014337988664879628,171,79,92
7428,Leaving,4.212236358012434e-05,5.5385010366141504e-05,60,23,37
7429,Lebanese,2.954852370546031e-05,3.640572332478458e-05,41,19,22
7430,Lebanon,0.00010499156295344414,9.161819471782287e-05,115,52,63
7431,Lebedev,2.095639979110664e-07,3.6233184351681345e-06,3,0,3
7432,Lech,2.3052039770217305e-06,7.074097897233022e-06,6,1,5
7433,Lecture,8.592123914353715e-06,5.348708166200577e-06,8,4,4
7434,Lecturer,4.400843956132392e-06,1.8979287041356905e-06,3,2,1
7435,Led,2.326160376812834e-05,3.640572332478458e-05,35,12,23
7436,Lee,5.6791843433898893e-05,6.056117955923882e-05,74,33,41
7437,Left,9.451336305789087e-05,0.0001036959228350498,117,50,67
7438,LeftWing,4.400843956132392e-06,3.6233184351681345e-06,4,2,2
7439,Leftist,6.496483935243052e-06,1.8979287041356905e-06,4,3,1
7440,Leftover,8.592123914353715e-06,3.6233184351681345e-06,6,4,2
7441,Leftwing,4.400843956132392e-06,1.8979287041356905e-06,3,2,1
7442,Leg,2.116596378901769e-05,1.2250267090330355e-05,21,13,8
7443,Legacy,6.517440335034157e-05,5.711040009717395e-05,68,32,36
7444,Legal,0.00015738256243121094,0.00019859235804183437,205,82,123
7445,Legalising,2.3052039770217305e-06,5.348708166200577e-06,4,1,3
7446,Legality,4.400843956132392e-06,3.6233184351681345e-06,5,2,3
7447,Legalization,4.002672360101368e-05,3.640572332478458e-05,44,20,24
7448,Legalize,2.5357243747239038e-05,1.570104655239525e-05,25,12,13
7449,Legalized,2.3052039770217305e-06,5.348708166200577e-06,5,2,3
7450,Legalizing,2.116596378901769e-05,1.570104655239525e-05,20,11,9
7451,Legally,8.592123914353715e-06,1.8979287041356905e-06,8,7,1
7452,Legend,2.3052039770217305e-06,5.348708166200577e-06,5,1,4
7453,Legendary,8.592123914353715e-06,5.348708166200577e-06,7,4,3
7454,Legion,8.592123914353715e-06,7.074097897233022e-06,9,5,4
7455,Legislation,4.212236358012434e-05,3.640572332478458e-05,45,21,24
7456,Legislative,1.6974683830796368e-05,1.570104655239525e-05,18,8,10
7457,Legislator,2.326160376812834e-05,2.6053384938589907e-05,29,13,16
7458,Legislature,8.592123914353715e-06,3.985650278684949e-05,31,7,24
7459,Legitimacy,6.496483935243052e-06,8.79948762826546e-06,8,3,5
7460,Legitimate,8.592123914353715e-06,1.052487735929791e-05,10,4,6
7461,Lego,1.48790438516857e-05,1.570104655239525e-05,16,7,9
7462,Lehman,8.592123914353715e-06,1.742643628342769e-05,15,5,10
7463,Lei,2.3052039770217305e-06,3.6233184351681345e-06,3,1,2
7464,Leicester,2.3052039770217305e-06,5.348708166200577e-06,5,1,4
7465,Leigh,2.3052039770217305e-06,1.052487735929791e-05,7,1,6
7466,Lemon,2.3052039770217305e-06,7.074097897233022e-06,6,2,4
7467,Lemonade,2.3052039770217305e-06,7.074097897233022e-06,6,2,4
7468,Lena,2.3052039770217305e-06,3.6233184351681345e-06,3,1,2
7469,Lend,6.496483935243052e-06,3.6233184351681345e-06,5,3,2
7470,Lender,2.5357243747239038e-05,1.2250267090330355e-05,20,13,7
7471,Lending,6.496483935243052e-06,1.2250267090330355e-05,11,4,7
7472,Lengthy,2.3052039770217305e-06,1.8979287041356905e-06,4,2,2
7473,Leniency,2.3052039770217305e-06,3.6233184351681345e-06,3,1,2
7474,Lenin,6.496483935243052e-06,1.052487735929791e-05,14,5,9
7475,Leno,2.3052039770217305e-06,5.348708166200577e-06,5,1,4
7476,Lenovo,8.592123914353715e-06,3.6233184351681345e-06,6,4,2
7477,Leo,4.400843956132392e-06,7.074097897233022e-06,6,2,4
7478,Leonard,1.278340387257504e-05,1.052487735929791e-05,12,6,6
7479,Leonardo,8.592123914353715e-06,1.2250267090330355e-05,12,4,8
7480,Leone,3.3739803663681634e-05,2.6053384938589907e-05,34,18,16
7481,Leopard,2.3052039770217305e-06,5.348708166200577e-06,4,1,3
7482,Lerner,2.095639979110664e-07,5.348708166200577e-06,3,0,3
7483,Les,0.00014480872255654665,0.00012440059960743937,157,80,77
7484,Lesbian,1.9070323809907035e-05,5.348708166200577e-06,15,10,5
7485,Lesley,6.496483935243052e-06,1.8979287041356905e-06,4,3,1
7486,Leslie,2.3052039770217305e-06,8.79948762826546e-06,6,1,5
7487,Lesson,6.936568330856297e-05,0.0001036959228350498,107,38,69
7488,Lester,2.095639979110664e-07,5.348708166200577e-06,3,0,3
7489,Let,0.00038790296013338374,0.00033144736733133263,410,197,213
7490,Letdown,6.496483935243052e-06,1.8979287041356905e-06,4,3,1
7491,Lethal,1.278340387257504e-05,1.052487735929791e-05,12,6,6
7492,Letter,0.00011756540282810809,0.00013302754826260141,146,63,83
7493,Letting,2.326160376812834e-05,2.4327995207557487e-05,27,12,15
7494,Leukemia,2.095639979110664e-07,1.052487735929791e-05,6,0,6
7495,Lev,2.3052039770217305e-06,7.074097897233022e-06,5,1,4
7496,Level,3.7931083621902995e-05,6.401195902130366e-05,62,20,42
7497,Leverage,1.278340387257504e-05,7.074097897233022e-06,10,6,4
7498,Levi,6.496483935243052e-06,1.7253897310324457e-07,4,3,1
7499,Levin,4.400843956132392e-06,1.8979287041356905e-06,3,2,1
7500,Levitt,2.095639979110664e-07,7.074097897233022e-06,4,0,4
7501,Levy,2.3052039770217305e-06,8.79948762826546e-06,6,1,5
7502,Lew,2.3052039770217305e-06,7.074097897233022e-06,6,2,4
7503,Lewandowski,1.48790438516857e-05,4.50326719799468e-05,38,9,29
7504,Lewd,4.400843956132392e-06,3.6233184351681345e-06,4,2,2
7505,Lewi,2.326160376812834e-05,1.742643628342769e-05,31,17,14
7506,Lewinsky,1.0687763893464371e-05,7.074097897233022e-06,9,5,4
7507,Lexington,2.3052039770217305e-06,5.348708166200577e-06,4,1,3
7508,Li,2.3052039770217305e-06,1.052487735929791e-05,8,1,7
7509,Liability,6.496483935243052e-06,1.7253897310324457e-07,3,3,0
7510,Liable,2.3052039770217305e-06,1.8979287041356905e-06,3,2,1
7511,Liar,1.9070323809907035e-05,1.052487735929791e-05,19,9,10
7512,Lib,4.400843956132392e-06,5.348708166200577e-06,6,2,4
7513,Libby,2.3052039770217305e-06,1.2250267090330355e-05,8,1,7
7514,Libel,2.3052039770217305e-06,7.074097897233022e-06,5,1,4
7515,Liberal,8.613080314144832e-05,8.299124606266055e-05,101,45,56
7516,Liberalism,2.095639979110664e-07,5.348708166200577e-06,3,0,3
7517,Liberated,4.400843956132392e-06,3.6233184351681345e-06,4,2,2
7518,Liberation,1.278340387257504e-05,1.2250267090330355e-05,13,6,7
7519,Liberia,3.1644163684570994e-05,5.020884117304414e-05,47,16,31
7520,Liberian,1.48790438516857e-05,1.052487735929791e-05,13,7,6
7521,Libertarian,1.6974683830796368e-05,1.9151826014460126e-05,24,9,15
7522,Liberty,4.4218003559234974e-05,4.8483451442011706e-05,52,22,30
7523,Libor,2.7452883726349685e-05,1.9151826014460126e-05,27,13,14
7524,Librarian,2.3052039770217305e-06,3.6233184351681345e-06,3,1,2
7525,Library,2.326160376812834e-05,2.4327995207557487e-05,32,14,18
7526,Libya,0.0002642602013658546,0.00027623489593829424,306,131,175
7527,Libyan,0.00018043460220142793,0.00017616229153841266,204,91,113
7528,License,2.7452883726349685e-05,2.6053384938589907e-05,32,15,17
7529,Lid,2.3052039770217305e-06,3.6233184351681345e-06,3,1,2
7530,Lie,8.403516316233764e-05,0.00011577365095227703,121,46,75
7531,Lieberman,1.48790438516857e-05,2.9504164400654783e-05,27,7,20
7532,Liechtenstein,6.496483935243052e-06,3.6233184351681345e-06,5,3,2
7533,Lied,1.6974683830796368e-05,2.2602605476525032e-05,24,10,14
7534,Lieu,6.496483935243052e-06,8.79948762826546e-06,10,4,6
7535,Lieutenant,6.496483935243052e-06,1.052487735929791e-05,9,3,6
7536,Life,0.00043191139969470744,0.00041081529495882486,500,234,266
7537,LifeSaving,2.095639979110664e-07,1.8979287041356905e-06,4,2,2
7538,Lifeline,4.400843956132392e-06,5.348708166200577e-06,5,2,3
7539,Lifelong,8.592123914353715e-06,5.348708166200577e-06,7,4,3
7540,Lifesaving,2.095639979110664e-07,5.348708166200577e-06,3,0,3
7541,Lifestyle,4.400843956132392e-06,1.8979287041356905e-06,5,3,2
7542,Lifetime,1.48790438516857e-05,1.3975656821362803e-05,16,7,9
7543,Lift,3.583544364279237e-05,1.9151826014460126e-05,30,18,12
7544,Lifted,2.3052039770217305e-06,8.79948762826546e-06,6,1,5
7545,Lifting,2.3052039770217305e-06,1.052487735929791e-05,8,1,7
7546,Light,6.72700433294523e-05,6.056117955923882e-05,77,37,40
7547,LightYear,2.095639979110664e-07,1.8979287041356905e-06,3,2,1
7548,Lighting,6.496483935243052e-06,7.074097897233022e-06,7,3,4
7549,Lightning,6.496483935243052e-06,3.6233184351681345e-06,6,4,2
7550,Lightsaber,4.400843956132392e-06,1.8979287041356905e-06,3,2,1
7551,Like,0.0005073544389426916,0.0005453956939793558,631,274,357
7552,Liked,1.0687763893464371e-05,3.6233184351681345e-06,7,5,2
7553,Likely,8.403516316233764e-05,9.851975364195259e-05,103,43,60
7554,Liken,2.3052039770217305e-06,3.6233184351681345e-06,4,1,3
7555,Likud,2.3052039770217305e-06,1.8979287041356905e-06,3,1,2
7556,Lily,4.400843956132392e-06,5.348708166200577e-06,5,2,3
7557,Lima,8.592123914353715e-06,1.7253897310324457e-07,5,5,0
7558,Limb,4.400843956132392e-06,1.8979287041356905e-06,5,2,3
7559,Limbaugh,2.3052039770217305e-06,1.2250267090330355e-05,8,1,7
7560,Limbo,8.592123914353715e-06,7.074097897233022e-06,9,4,5
7561,Limit,4.6313643538345614e-05,6.401195902130366e-05,63,25,38
7562,Limited,1.0687763893464371e-05,1.3975656821362803e-05,13,5,8
7563,Limiting,2.3052039770217305e-06,7.074097897233022e-06,6,1,5
7564,Limp,2.095639979110664e-07,5.348708166200577e-06,3,0,3
7565,Lin,2.3052039770217305e-06,3.6233184351681345e-06,3,1,2
7566,Lincoln,3.1644163684570994e-05,4.330728224891437e-05,44,18,26
7567,Linda,1.0687763893464371e-05,1.3975656821362803e-05,13,5,8
7568,Lindell,4.400843956132392e-06,3.6233184351681345e-06,6,2,4
7569,Lindsey,5.260056347567764e-05,6.228656929027126e-05,69,30,39
7570,Line,9.660900303700153e-05,9.334358444885519e-05,110,49,61
7571,Linger,2.3052039770217305e-06,3.6233184351681345e-06,3,1,2
7572,Linguist,2.095639979110664e-07,5.348708166200577e-06,4,0,4
7573,Lining,4.400843956132392e-06,5.348708166200577e-06,6,2,4
7574,Link,4.6313643538345614e-05,4.6758061710979285e-05,54,24,30
7575,Linked,2.954852370546031e-05,2.2602605476525032e-05,30,15,15
7576,LinkedIn,2.7452883726349685e-05,1.9151826014460126e-05,24,13,11
7577,Linkedin,4.400843956132392e-06,1.8979287041356905e-06,3,2,1
7578,Linking,1.0687763893464371e-05,7.074097897233022e-06,10,6,4
7579,Linton,2.3052039770217305e-06,7.074097897233022e-06,5,1,4
7580,Linux,4.400843956132392e-06,3.6233184351681345e-06,4,2,2
7581,Lion,2.326160376812834e-05,2.2602605476525032e-05,24,11,13
7582,Lip,6.496483935243052e-06,3.6233184351681345e-06,7,5,2
7583,Lipinski,1.0687763893464371e-05,1.8979287041356905e-06,6,5,1
7584,Liquid,1.0687763893464371e-05,7.074097897233022e-06,9,5,4
7585,Liquidator,4.400843956132392e-06,1.8979287041356905e-06,3,2,1
7586,Liquor,2.3052039770217305e-06,1.8979287041356905e-06,3,2,1
7587,Lisa,3.1644163684570994e-05,2.087721574549256e-05,32,17,15
7588,Lisbon,6.496483935243052e-06,1.052487735929791e-05,10,4,6
7589,List,8.403516316233764e-05,0.00010024514337298497,107,41,66
7590,Listed,2.3052039770217305e-06,5.348708166200577e-06,5,2,3
7591,Listen,3.7931083621902995e-05,4.50326719799468e-05,47,20,27
7592,Listening,8.592123914353715e-06,2.4327995207557487e-05,21,5,16
7593,Listing,2.3052039770217305e-06,7.074097897233022e-06,6,1,5
7594,Liter,6.496483935243052e-06,1.7253897310324457e-07,4,3,1
7595,Literacy,8.592123914353715e-06,7.074097897233022e-06,9,5,4
7596,Literal,6.496483935243052e-06,3.6233184351681345e-06,6,4,2
7597,Literally,3.3739803663681634e-05,2.9504164400654783e-05,38,17,21
7598,Lithium,2.095639979110664e-07,3.6233184351681345e-06,3,0,3
7599,Lithuania,1.9070323809907035e-05,3.468033359375216e-05,33,11,22
7600,Lithuanian,1.48790438516857e-05,1.052487735929791e-05,15,9,6
7601,Litigation,2.3052039770217305e-06,1.8979287041356905e-06,3,2,1
7602,Little,9.03220830996695e-05,9.851975364195259e-05,111,50,61
7603,Litvinenko,1.278340387257504e-05,8.79948762826546e-06,12,6,6
7604,Liu,1.278340387257504e-05,2.087721574549256e-05,18,6,12
7605,Livable,4.400843956132392e-06,5.348708166200577e-06,5,2,3
7606,Live,0.0001552869224521,0.0001382037174556987,175,84,91
7607,Lived,6.496483935243052e-06,3.6233184351681345e-06,6,4,2
7608,Livelihood,2.095639979110664e-07,3.6233184351681345e-06,3,1,2
7609,Lively,2.3052039770217305e-06,3.6233184351681345e-06,4,2,2
7610,Liver,6.496483935243052e-06,1.7253897310324457e-07,3,3,0
7611,Liverpool,2.095639979110664e-07,3.6233184351681345e-06,4,0,4
7612,Living,6.517440335034157e-05,8.126585633162811e-05,87,36,51
7613,Livni,1.0687763893464371e-05,1.742643628342769e-05,15,5,10
7614,Liz,2.326160376812834e-05,2.2602605476525032e-05,24,11,13
7615,Lizard,8.592123914353715e-06,1.7253897310324457e-07,5,5,0
7616,Lizzie,4.400843956132392e-06,1.8979287041356905e-06,3,2,1
7617,Lloyd,2.5357243747239038e-05,1.052487735929791e-05,20,13,7
7618,Lo,6.307876337123095e-05,5.883578982820635e-05,75,36,39
7619,Loan,0.0001154697628489974,8.4716635793693e-05,119,63,56
7620,Lobbied,6.496483935243052e-06,3.6233184351681345e-06,5,3,2
7621,Lobby,2.5357243747239038e-05,2.9504164400654783e-05,36,17,19
7622,Lobbying,1.0687763893464371e-05,2.9504164400654783e-05,25,7,18
7623,Lobbyist,3.7931083621902995e-05,5.711040009717395e-05,57,21,36
7624,Local,9.451336305789087e-05,8.4716635793693e-05,104,48,56
7625,Locally,6.496483935243052e-06,1.7253897310324457e-07,3,3,0
7626,Locate,6.496483935243052e-06,1.7253897310324457e-07,3,3,0
7627,Location,1.278340387257504e-05,1.052487735929791e-05,12,6,6
7628,Lochte,6.496483935243052e-06,1.8979287041356905e-06,4,3,1
7629,Lock,2.5357243747239038e-05,2.6053384938589907e-05,29,13,16
7630,Lockdown,4.400843956132392e-06,1.052487735929791e-05,8,2,6
7631,Locked,1.9070323809907035e-05,1.052487735929791e-05,17,9,8
7632,Lockerbie,1.6974683830796368e-05,2.6053384938589907e-05,23,8,15
7633,Lockheed,1.278340387257504e-05,8.79948762826546e-06,11,6,5
7634,Loeffler,4.400843956132392e-06,3.6233184351681345e-06,4,2,2
7635,Loesch,4.400843956132392e-06,3.6233184351681345e-06,4,2,2
7636,Log,1.48790438516857e-05,1.2250267090330355e-05,17,8,9
7637,Logan,2.3052039770217305e-06,1.052487735929791e-05,8,2,6
7638,Logger,2.095639979110664e-07,5.348708166200577e-06,3,0,3
7639,Logging,2.3052039770217305e-06,3.6233184351681345e-06,3,1,2
7640,Logic,6.496483935243052e-06,5.348708166200577e-06,7,3,4
7641,Logo,2.3052039770217305e-06,1.2250267090330355e-05,10,1,9
7642,Lois,4.400843956132392e-06,7.074097897233022e-06,6,2,4
7643,London,0.00040466807996626886,0.00041599146415192246,475,209,266
7644,Londonbased,8.592123914353715e-06,1.8979287041356905e-06,5,4,1
7645,Londonderry,2.3052039770217305e-06,3.6233184351681345e-06,3,1,2
7646,Londoner,8.592123914353715e-06,8.79948762826546e-06,9,4,5
7647,Lone,1.0687763893464371e-05,1.3975656821362803e-05,16,5,11
7648,Lonelines,4.400843956132392e-06,1.8979287041356905e-06,3,2,1
7649,Lonely,1.48790438516857e-05,1.052487735929791e-05,14,7,7
7650,Long,0.00010708720293255492,0.00012094982014537423,141,60,81
7651,LongAwaited,2.095639979110664e-07,8.79948762826546e-06,5,0,5
7652,LongLost,8.592123914353715e-06,1.7253897310324457e-07,4,4,0
7653,LongRange,4.400843956132392e-06,1.8979287041356905e-06,3,2,1
7654,LongShot,2.3052039770217305e-06,3.6233184351681345e-06,3,1,2
7655,LongTerm,8.592123914353715e-06,8.79948762826546e-06,9,4,5
7656,Longer,5.6791843433898893e-05,7.954046660059569e-05,75,28,47
7657,Longest,1.6974683830796368e-05,7.074097897233022e-06,15,9,6
7658,LongestServing,2.095639979110664e-07,3.6233184351681345e-06,3,0,3
7659,Longtime,1.278340387257504e-05,8.79948762826546e-06,12,6,6
7660,Look,0.0002663558413449654,0.0002520794397038401,301,140,161
7661,Looked,2.095639979110664e-07,7.074097897233022e-06,4,0,4
7662,Looking,5.888748341300963e-05,6.401195902130366e-05,74,32,42
7663,Loom,2.116596378901769e-05,2.6053384938589907e-05,27,11,16
7664,Looming,1.6974683830796368e-05,1.742643628342769e-05,22,10,12
7665,Loop,4.400843956132392e-06,3.6233184351681345e-06,4,2,2
7666,Loophole,1.0687763893464371e-05,1.2250267090330355e-05,13,6,7
7667,Loose,8.592123914353715e-06,1.052487735929791e-05,11,5,6
7668,Loosen,4.400843956132392e-06,3.6233184351681345e-06,7,4,3
7669,Loot,6.496483935243052e-06,1.7253897310324457e-07,3,3,0
7670,Looter,2.3052039770217305e-06,1.8979287041356905e-06,3,1,2
7671,Looting,4.400843956132392e-06,3.6233184351681345e-06,5,2,3
7672,Lopez,4.400843956132392e-06,5.348708166200577e-06,6,2,4
7673,Lord,7.774824322500554e-05,5.020884117304414e-05,71,39,32
7674,Lorenzo,2.095639979110664e-07,5.348708166200577e-06,5,1,4
7675,Loretta,1.9070323809907035e-05,2.2602605476525032e-05,24,10,14
7676,Lori,2.3052039770217305e-06,1.052487735929791e-05,7,1,6
7677,Los,4.4218003559234974e-05,4.1581892517881935e-05,56,29,27
7678,Lose,0.00013642616264010403,0.00014165449691776373,162,72,90
7679,Loser,2.954852370546031e-05,1.9151826014460126e-05,26,14,12
7680,Losing,8.193952318322689e-05,5.711040009717395e-05,86,47,39
7681,Loss,1.0687763893464371e-05,1.3975656821362803e-05,14,5,9
7682,Lost,0.00010708720293255492,0.00012612598933847184,133,54,79
7683,Lot,0.00010708720293255492,7.263890767646595e-05,104,54,50
7684,Lott,8.592123914353715e-06,1.8979287041356905e-06,5,4,1
7685,Lottery,2.7452883726349685e-05,3.640572332478458e-05,40,18,22
7686,Lou,8.592123914353715e-06,1.2250267090330355e-05,11,4,7
7687,Loud,8.592123914353715e-06,1.2250267090330355e-05,11,4,7
7688,Loui,4.212236358012434e-05,6.228656929027126e-05,65,24,41
7689,Louie,6.496483935243052e-06,5.348708166200577e-06,6,3,3
7690,LouisDreyfu,2.3052039770217305e-06,3.6233184351681345e-06,3,1,2
7691,Louise,6.496483935243052e-06,1.2250267090330355e-05,10,3,7
7692,Louisiana,5.260056347567764e-05,4.330728224891437e-05,55,30,25
7693,Louisville,8.592123914353715e-06,3.6233184351681345e-06,8,6,2
7694,Lousy,2.3052039770217305e-06,3.6233184351681345e-06,3,1,2
7695,Louvre,6.496483935243052e-06,8.79948762826546e-06,9,3,6
7696,Lovato,2.095639979110664e-07,1.8979287041356905e-06,3,1,2
7697,Love,0.00017205204228498542,0.00017788768126944505,209,88,121
7698,Loved,1.9070323809907035e-05,7.074097897233022e-06,15,10,5
7699,Lover,8.592123914353715e-06,3.6233184351681345e-06,6,4,2
7700,Loving,1.9070323809907035e-05,2.4327995207557487e-05,25,9,16
7701,Low,7.774824322500554e-05,5.883578982820635e-05,82,41,41
7702,LowEnergy,2.3052039770217305e-06,3.6233184351681345e-06,3,1,2
7703,LowIncome,2.116596378901769e-05,1.052487735929791e-05,17,10,7
7704,LowWage,2.3052039770217305e-06,8.79948762826546e-06,6,1,5
7705,Lower,3.583544364279237e-05,3.122955413168725e-05,38,17,21
7706,Lowered,4.400843956132392e-06,3.6233184351681345e-06,4,2,2
7707,Lowest,1.0687763893464371e-05,1.3975656821362803e-05,13,5,8
7708,Loyal,1.278340387257504e-05,1.052487735929791e-05,13,6,7
7709,Loyalist,4.400843956132392e-06,3.6233184351681345e-06,4,2,2
7710,Loyalty,1.0687763893464371e-05,1.2250267090330355e-05,12,5,7
7711,Lt,1.0687763893464371e-05,2.087721574549256e-05,21,7,14
7712,Ltd,2.3052039770217305e-06,5.348708166200577e-06,6,1,5
7713,Luca,8.592123914353715e-06,8.79948762826546e-06,10,4,6
7714,Luck,2.095639979110664e-07,5.348708166200577e-06,3,0,3
7715,Lucky,1.278340387257504e-05,7.074097897233022e-06,11,7,4
7716,Lucrative,2.3052039770217305e-06,5.348708166200577e-06,4,1,3
7717,Lucy,4.400843956132392e-06,3.6233184351681345e-06,4,2,2
7718,Lufthansa,4.400843956132392e-06,3.6233184351681345e-06,4,2,2
7719,Lugansk,2.095639979110664e-07,7.074097897233022e-06,4,0,4
7720,Luggage,6.496483935243052e-06,3.6233184351681345e-06,5,3,2
7721,Luhansk,2.095639979110664e-07,5.348708166200577e-06,3,0,3
7722,Lui,4.400843956132392e-06,2.087721574549256e-05,15,2,13
7723,Luka,8.592123914353715e-06,1.8979287041356905e-06,5,4,1
7724,Lukashenko,2.3052039770217305e-06,3.6233184351681345e-06,5,3,2
7725,Luke,8.592123914353715e-06,5.348708166200577e-06,8,5,3
7726,Lula,6.496483935243052e-06,2.4327995207557487e-05,17,3,14
7727,LulzSec,1.6974683830796368e-05,7.074097897233022e-06,13,9,4
7728,Lulzsec,4.400843956132392e-06,1.8979287041356905e-06,3,2,1
7729,Lumber,2.3052039770217305e-06,3.6233184351681345e-06,3,1,2
7730,Lunar,6.496483935243052e-06,1.8979287041356905e-06,6,5,1
7731,Lunch,2.5357243747239038e-05,2.4327995207557487e-05,29,15,14
7732,Lung,6.496483935243052e-06,1.052487735929791e-05,9,3,6
7733,Lured,4.400843956132392e-06,1.8979287041356905e-06,3,2,1
7734,Luther,1.0687763893464371e-05,8.79948762826546e-06,15,6,9
7735,Lutheran,2.095639979110664e-07,5.348708166200577e-06,3,0,3
7736,Luxembourg,8.592123914353715e-06,2.2602605476525032e-05,21,4,17
7737,Luxor,8.592123914353715e-06,1.8979287041356905e-06,7,4,3
7738,Luxury,1.278340387257504e-05,1.570104655239525e-05,16,6,10
7739,Lyft,1.48790438516857e-05,2.9504164400654783e-05,26,9,17
7740,Lyin,4.400843956132392e-06,1.8979287041356905e-06,3,2,1
7741,Lying,3.3739803663681634e-05,2.2602605476525032e-05,32,18,14
7742,Lymphoma,2.3052039770217305e-06,3.6233184351681345e-06,3,1,2
7743,Lynch,2.5357243747239038e-05,3.640572332478458e-05,34,12,22
7744,Lynching,2.095639979110664e-07,5.348708166200577e-06,3,0,3
7745,Lynn,2.095639979110664e-07,7.074097897233022e-06,5,1,4
7746,Lyon,6.496483935243052e-06,1.7253897310324457e-07,3,3,0
7747,Lyric,2.3052039770217305e-06,5.348708166200577e-06,5,2,3
7748,MAG,2.3052039770217305e-06,1.8979287041356905e-06,3,2,1
7749,MAGA,1.0687763893464371e-05,1.2250267090330355e-05,12,5,7
7750,MAGIC,8.592123914353715e-06,1.7253897310324457e-07,4,4,0
7751,MAKE,2.3052039770217305e-06,1.8979287041356905e-06,3,2,1
7752,MANCHESTER,6.496483935243052e-06,1.7253897310324457e-07,3,3,0
7753,MD,2.3052039770217305e-06,7.074097897233022e-06,6,1,5
7754,MDG,2.3052039770217305e-06,7.074097897233022e-06,5,1,4
7755,MDMA,4.400843956132392e-06,5.348708166200577e-06,5,2,3
7756,ME,0.005274935391419449,0.005212574916422115,6142,2763,3379
7757,MEP,1.278340387257504e-05,7.074097897233022e-06,10,6,4
7758,MER,1.0687763893464371e-05,1.7253897310324457e-07,5,5,0
7759,MEXICO,8.592123914353715e-06,7.074097897233022e-06,8,4,4
7760,MH,4.400843956132392e-06,1.8979287041356905e-06,3,2,1
7761,MH17,4.212236358012434e-05,2.6053384938589907e-05,38,20,18
7762,MH370,4.4218003559234974e-05,3.640572332478458e-05,44,23,21
7763,MI5,4.002672360101368e-05,3.2954943862719716e-05,40,19,21
7764,MI6,3.7931083621902995e-05,2.9504164400654783e-05,39,20,19
7765,MIA,2.095639979110664e-07,8.79948762826546e-06,7,1,6
7766,MILF,2.3052039770217305e-06,8.79948762826546e-06,6,1,5
7767,MILLION,4.400843956132392e-06,1.8979287041356905e-06,3,2,1
7768,MIT,1.48790438516857e-05,1.570104655239525e-05,18,8,10
7769,MLB,2.095639979110664e-07,5.348708166200577e-06,3,0,3
7770,MLK,2.3052039770217305e-06,7.074097897233022e-06,8,2,6
7771,MO,6.496483935243052e-06,3.6233184351681345e-06,5,3,2
7772,MOINE,4.400843956132392e-06,1.7253897310324457e-07,3,3,0
7773,MP,0.00021396484186719832,0.0001968669683108019,228,108,120
7774,MPAA,4.400843956132392e-06,8.79948762826546e-06,8,3,5
7775,MPH,2.095639979110664e-07,7.074097897233022e-06,4,0,4
7776,MS13,2.3052039770217305e-06,3.6233184351681345e-06,4,1,3
7777,MSF,4.400843956132392e-06,7.074097897233022e-06,6,2,4
7778,MSM,2.3052039770217305e-06,5.348708166200577e-06,4,1,3
7779,MSNBC,4.212236358012434e-05,3.640572332478458e-05,45,23,22
7780,MSU,2.3052039770217305e-06,3.6233184351681345e-06,4,2,2
7781,MT,2.3052039770217305e-06,3.6233184351681345e-06,3,1,2
7782,MTV,2.3052039770217305e-06,5.348708166200577e-06,4,1,3
7783,MUST,8.592123914353715e-06,3.6233184351681345e-06,7,5,2
7784,MW,1.48790438516857e-05,1.8979287041356905e-06,8,7,1
7785,Maasai,6.496483935243052e-06,5.348708166200577e-06,6,3,3
7786,Mabhouh,2.095639979110664e-07,3.6233184351681345e-06,3,0,3
7787,Mac,1.48790438516857e-05,1.2250267090330355e-05,15,8,7
7788,MacArthur,2.3052039770217305e-06,3.6233184351681345e-06,4,1,3
7789,MacBook,2.3052039770217305e-06,5.348708166200577e-06,4,1,3
7790,Macdonald,2.095639979110664e-07,3.6233184351681345e-06,3,1,2
7791,Macedonia,1.48790438516857e-05,1.570104655239525e-05,19,7,12
7792,Macedonian,4.400843956132392e-06,1.8979287041356905e-06,3,2,1
7793,Machine,4.212236358012434e-05,3.2954943862719716e-05,44,22,22
7794,Macron,1.6974683830796368e-05,8.79948762826546e-06,14,8,6
7795,Macy,1.0687763893464371e-05,3.6233184351681345e-06,9,6,3
7796,Mad,3.1644163684570994e-05,2.2602605476525032e-05,30,16,14
7797,Madagascar,1.48790438516857e-05,1.052487735929791e-05,17,10,7
7798,Madam,2.095639979110664e-07,1.8979287041356905e-06,3,0,3
7799,Madame,2.095639979110664e-07,3.6233184351681345e-06,3,0,3
7800,Maddow,8.592123914353715e-06,5.348708166200577e-06,7,4,3
7801,Made,0.00015947820241032126,0.0001554576147660233,186,83,103
7802,Madeleine,1.0687763893464371e-05,5.348708166200577e-06,8,5,3
7803,Madison,4.002672360101368e-05,8.79948762826546e-06,28,21,7
7804,Madnes,1.9070323809907035e-05,2.087721574549256e-05,24,11,13
7805,Madoff,8.592123914353715e-06,1.2250267090330355e-05,13,4,9
7806,Madonna,2.3052039770217305e-06,7.074097897233022e-06,5,1,4
7807,Madrid,4.212236358012434e-05,2.9504164400654783e-05,40,20,20
7808,Maduro,1.6974683830796368e-05,1.052487735929791e-05,16,10,6
7809,Mae,1.278340387257504e-05,7.074097897233022e-06,10,6,4
7810,Mafia,2.5357243747239038e-05,2.777877466962238e-05,33,14,19
7811,Magazine,3.1644163684570994e-05,2.6053384938589907e-05,31,16,15
7812,Magdalene,2.3052039770217305e-06,1.8979287041356905e-06,3,1,2
7813,Maggie,8.592123914353715e-06,3.6233184351681345e-06,8,5,3
7814,Magic,2.326160376812834e-05,1.2250267090330355e-05,20,11,9
7815,Magical,4.400843956132392e-06,1.3975656821362803e-05,10,2,8
7816,Magistrate,2.3052039770217305e-06,1.8979287041356905e-06,3,1,2
7817,Magna,2.095639979110664e-07,3.6233184351681345e-06,3,1,2
7818,Magnetic,4.400843956132392e-06,1.8979287041356905e-06,3,2,1
7819,Magnificent,2.3052039770217305e-06,1.8979287041356905e-06,3,2,1
7820,Magnitude,2.326160376812834e-05,2.6053384938589907e-05,29,13,16
7821,Magnotta,8.592123914353715e-06,1.8979287041356905e-06,5,4,1
7822,Maguire,8.592123914353715e-06,1.8979287041356905e-06,5,4,1
7823,Mahal,2.095639979110664e-07,3.6233184351681345e-06,3,1,2
7824,Mahdi,6.496483935243052e-06,1.7253897310324457e-07,3,3,0
7825,Maher,6.496483935243052e-06,8.79948762826546e-06,8,3,5
7826,Mahmoud,3.7931083621902995e-05,5.020884117304414e-05,53,19,34
7827,Maid,6.496483935243052e-06,5.348708166200577e-06,8,4,4
7828,Maidan,4.400843956132392e-06,1.8979287041356905e-06,3,2,1
7829,Maiduguri,2.095639979110664e-07,5.348708166200577e-06,3,0,3
7830,Mail,3.7931083621902995e-05,4.330728224891437e-05,46,18,28
7831,MailIn,2.3052039770217305e-06,3.6233184351681345e-06,3,1,2
7832,Mailer,2.3052039770217305e-06,5.348708166200577e-06,4,1,3
7833,Mailman,4.400843956132392e-06,1.8979287041356905e-06,3,2,1
7834,Main,2.954852370546031e-05,2.777877466962238e-05,31,15,16
7835,Maine,5.888748341300963e-05,4.1581892517881935e-05,63,33,30
7836,Mainer,2.3052039770217305e-06,5.348708166200577e-06,4,1,3
7837,Mainland,8.592123914353715e-06,5.348708166200577e-06,8,5,3
7838,Mainly,2.3052039770217305e-06,3.6233184351681345e-06,3,1,2
7839,Mainstream,4.400843956132392e-06,2.087721574549256e-05,17,4,13
7840,Maintain,2.3052039770217305e-06,8.79948762826546e-06,6,1,5
7841,Major,0.0002055822819507562,0.00016063378395912072,220,117,103
7842,Majority,9.24177230787802e-05,7.608968713853079e-05,98,48,50
7843,Make,0.0005555541584622364,0.0006264890113378807,705,300,405
7844,MakeAWish,4.400843956132392e-06,3.6233184351681345e-06,4,2,2
7845,Makeover,6.496483935243052e-06,3.6233184351681345e-06,5,3,2
7846,Maker,2.116596378901769e-05,2.777877466962238e-05,28,11,17
7847,Makeup,2.3052039770217305e-06,3.6233184351681345e-06,3,1,2
7848,Making,0.00016576512234765329,0.00017788768126944505,201,86,115
7849,Malacca,4.400843956132392e-06,1.8979287041356905e-06,3,2,1
7850,Malala,3.3739803663681634e-05,3.2954943862719716e-05,41,19,22
7851,Malalai,2.095639979110664e-07,3.6233184351681345e-06,3,0,3
7852,Malaria,1.6974683830796368e-05,1.052487735929791e-05,15,8,7
7853,Malawi,1.48790438516857e-05,2.4327995207557487e-05,28,8,20
7854,Malawian,2.3052039770217305e-06,1.8979287041356905e-06,3,2,1
7855,Malaysia,7.565260324589493e-05,5.883578982820635e-05,80,39,41
7856,Malaysian,5.260056347567764e-05,6.746273848336857e-05,69,27,42
7857,Malcolm,6.496483935243052e-06,3.6233184351681345e-06,5,3,2
7858,Maldive,1.0687763893464371e-05,1.742643628342769e-05,15,5,10
7859,Maldivian,2.3052039770217305e-06,3.6233184351681345e-06,3,1,2
7860,Male,1.9070323809907035e-05,2.087721574549256e-05,24,10,14
7861,Mali,5.050492349656699e-05,8.4716635793693e-05,90,35,55
7862,Malia,8.592123914353715e-06,5.348708166200577e-06,8,4,4
7863,Malian,1.0687763893464371e-05,7.074097897233022e-06,9,5,4
7864,Malik,4.400843956132392e-06,1.8979287041356905e-06,5,2,3
7865,Maliki,2.095639979110664e-07,5.348708166200577e-06,3,0,3
7866,Mall,2.116596378901769e-05,1.3975656821362803e-05,21,12,9
7867,Malley,4.400843956132392e-06,3.6233184351681345e-06,4,2,2
7868,Malloy,2.3052039770217305e-06,1.052487735929791e-05,7,1,6
7869,Malnutrition,2.3052039770217305e-06,3.6233184351681345e-06,3,1,2
7870,Maloney,4.400843956132392e-06,1.8979287041356905e-06,3,2,1
7871,Malta,8.592123914353715e-06,1.2250267090330355e-05,12,5,7
7872,Maltese,4.400843956132392e-06,5.348708166200577e-06,5,2,3
7873,Malware,1.278340387257504e-05,7.074097897233022e-06,10,6,4
7874,Mama,2.3052039770217305e-06,5.348708166200577e-06,5,2,3
7875,Mammal,2.3052039770217305e-06,1.7253897310324457e-07,3,3,0
7876,Mammoth,6.496483935243052e-06,1.8979287041356905e-06,6,4,2
7877,Man,0.0006791969172297656,0.0006385667394551078,782,363,419
7878,Manafort,4.212236358012434e-05,6.918812821440096e-05,83,34,49
7879,Manage,1.48790438516857e-05,1.2250267090330355e-05,14,7,7
7880,Managed,4.400843956132392e-06,1.8979287041356905e-06,3,2,1
7881,Management,2.954852370546031e-05,3.985650278684949e-05,42,17,25
7882,Manager,6.72700433294523e-05,3.8131113055817005e-05,61,35,26
7883,Managing,8.592123914353715e-06,1.2250267090330355e-05,13,5,8
7884,Manama,4.400843956132392e-06,1.8979287041356905e-06,3,2,1
7885,Manchester,1.6974683830796368e-05,1.570104655239525e-05,19,9,10
7886,Manchin,1.0687763893464371e-05,2.2602605476525032e-05,21,7,14
7887,Mandarin,4.400843956132392e-06,1.8979287041356905e-06,3,2,1
7888,Mandate,3.583544364279237e-05,3.122955413168725e-05,41,19,22
7889,Mandatory,1.48790438516857e-05,8.79948762826546e-06,13,7,6
7890,Mandela,1.48790438516857e-05,3.122955413168725e-05,27,9,18
7891,Manhattan,2.5357243747239038e-05,3.8131113055817005e-05,36,14,22
7892,Manhunt,2.3052039770217305e-06,5.348708166200577e-06,4,1,3
7893,Manic,2.3052039770217305e-06,3.6233184351681345e-06,3,1,2
7894,Manigault,4.400843956132392e-06,3.6233184351681345e-06,6,4,2
7895,Manila,8.592123914353715e-06,5.348708166200577e-06,7,4,3
7896,Manipulated,6.496483935243052e-06,1.8979287041356905e-06,4,3,1
7897,Manipulating,4.400843956132392e-06,1.8979287041356905e-06,3,2,1
7898,Manipulation,4.400843956132392e-06,1.2250267090330355e-05,10,2,8
7899,Manitoba,8.592123914353715e-06,1.7253897310324457e-07,4,4,0
7900,Mankind,8.592123914353715e-06,1.8979287041356905e-06,5,4,1
7901,Manmade,2.3052039770217305e-06,3.6233184351681345e-06,4,2,2
7902,Manmohan,2.3052039770217305e-06,3.6233184351681345e-06,3,1,2
7903,Mann,4.400843956132392e-06,3.6233184351681345e-06,4,2,2
7904,Manned,1.0687763893464371e-05,1.8979287041356905e-06,6,5,1
7905,Manner,2.095639979110664e-07,1.7253897310324457e-07,3,1,2
7906,Manning,3.583544364279237e-05,5.020884117304414e-05,59,18,41
7907,Mansion,6.496483935243052e-06,1.7253897310324457e-07,3,3,0
7908,Manslaughter,4.400843956132392e-06,8.79948762826546e-06,7,2,5
7909,Manson,2.3052039770217305e-06,8.79948762826546e-06,6,1,5
7910,Mansour,2.095639979110664e-07,5.348708166200577e-06,3,0,3
7911,Manuel,1.6974683830796368e-05,1.2250267090330355e-05,19,10,9
7912,Manufacturer,1.0687763893464371e-05,1.8979287041356905e-06,9,6,3
7913,Manufacturing,4.400843956132392e-06,1.3975656821362803e-05,16,5,11
7914,Manuscript,6.496483935243052e-06,1.7253897310324457e-07,4,3,1
7915,Many,0.000348085800530281,0.0002900380137865542,365,180,185
7916,Mao,8.592123914353715e-06,7.074097897233022e-06,9,5,4
7917,Maoist,1.6974683830796368e-05,1.3975656821362803e-05,17,9,8
7918,Map,5.6791843433898893e-05,6.573734875233614e-05,80,37,43
7919,Maple,2.3052039770217305e-06,3.6233184351681345e-06,3,1,2
7920,Mapping,4.400843956132392e-06,7.074097897233022e-06,6,2,4
7921,Mar,0.00018462588215964923,0.00010024514337298497,158,95,63
7922,MarALago,6.496483935243052e-06,1.742643628342769e-05,18,4,14
7923,MaraLago,1.0687763893464371e-05,1.570104655239525e-05,17,6,11
7924,Marange,2.3052039770217305e-06,1.8979287041356905e-06,3,2,1
7925,Marathon,1.278340387257504e-05,2.9504164400654783e-05,29,7,22
7926,Marburg,4.400843956132392e-06,1.8979287041356905e-06,3,2,1
7927,Marc,1.48790438516857e-05,1.052487735929791e-05,13,7,6
7928,March,0.00021396484186719832,0.00022102242454525643,252,108,144
7929,Marcher,4.400843956132392e-06,5.348708166200577e-06,5,2,3
7930,Marching,1.0687763893464371e-05,3.6233184351681345e-06,7,5,2
7931,Marco,0.0002160604818463093,0.00018306385046254245,244,119,125
7932,Mardi,4.400843956132392e-06,3.6233184351681345e-06,4,2,2
7933,Margaret,1.278340387257504e-05,1.9151826014460126e-05,19,6,13
7934,Margin,4.400843956132392e-06,3.6233184351681345e-06,4,2,2
7935,Maria,1.6974683830796368e-05,2.777877466962238e-05,30,10,20
7936,Mariana,4.400843956132392e-06,3.6233184351681345e-06,6,3,3
7937,Marie,1.6974683830796368e-05,8.79948762826546e-06,13,8,5
7938,Marijuana,0.0001783389622223174,0.0001847892401935746,220,94,126
7939,Marilyn,2.095639979110664e-07,5.348708166200577e-06,4,1,3
7940,Marina,4.400843956132392e-06,1.7253897310324457e-07,3,2,1
7941,Marine,6.936568330856297e-05,7.091351794543343e-05,80,35,45
7942,Mario,2.326160376812834e-05,1.052487735929791e-05,18,11,7
7943,Marion,4.400843956132392e-06,3.6233184351681345e-06,4,2,2
7944,Marissa,1.278340387257504e-05,1.8979287041356905e-06,7,6,1
7945,Maritime,6.496483935243052e-06,8.79948762826546e-06,9,3,6
7946,Mariupol,6.496483935243052e-06,7.074097897233022e-06,8,3,5
7947,Marjorie,1.9070323809907035e-05,2.087721574549256e-05,22,9,13
7948,Marjory,6.496483935243052e-06,7.074097897233022e-06,8,3,5
7949,Mark,0.0001825302421805385,0.00018133846073150993,207,93,114
7950,Marked,6.496483935243052e-06,3.6233184351681345e-06,5,3,2
7951,Market,0.00010918284291166549,0.00011404826122124471,121,54,67
7952,Marketer,8.592123914353715e-06,5.348708166200577e-06,9,4,5
7953,Marketing,5.6791843433898893e-05,9.506897417988779e-05,83,28,55
7954,Marketplace,4.400843956132392e-06,1.7253897310324457e-07,3,2,1
7955,Marking,2.3052039770217305e-06,7.074097897233022e-06,7,1,6
7956,Markle,8.592123914353715e-06,8.79948762826546e-06,9,4,5
7957,Marmara,6.496483935243052e-06,1.7253897310324457e-07,4,3,1
7958,Marqui,6.496483935243052e-06,5.348708166200577e-06,6,3,3
7959,Marriage,0.00012385232276544028,0.0001382037174556987,152,68,84
7960,Married,1.0687763893464371e-05,5.348708166200577e-06,10,6,4
7961,Marriott,8.592123914353715e-06,3.6233184351681345e-06,6,4,2
7962,Marrow,2.095639979110664e-07,5.348708166200577e-06,3,0,3
7963,Marry,2.3052039770217305e-06,5.348708166200577e-06,6,2,4
7964,Marrying,2.095639979110664e-07,8.79948762826546e-06,5,0,5
7965,Marseille,8.592123914353715e-06,7.074097897233022e-06,8,4,4
7966,Marsha,4.400843956132392e-06,1.8979287041356905e-06,3,2,1
7967,Marshal,8.592123914353715e-06,5.348708166200577e-06,8,5,3
7968,Marshall,2.7452883726349685e-05,7.074097897233022e-06,18,13,5
7969,Martha,6.496483935243052e-06,5.348708166200577e-06,6,3,3
7970,Martian,1.48790438516857e-05,3.6233184351681345e-06,10,8,2
7971,Martin,8.822644312055891e-05,8.644202552472544e-05,107,53,54
7972,Martinez,6.496483935243052e-06,7.074097897233022e-06,7,3,4
7973,Marty,2.3052039770217305e-06,3.6233184351681345e-06,3,1,2
7974,Martyr,2.095639979110664e-07,1.052487735929791e-05,7,1,6
7975,Marx,2.3052039770217305e-06,1.7253897310324457e-07,3,1,2
7976,Marxist,4.400843956132392e-06,3.6233184351681345e-06,4,2,2
7977,Mary,2.7452883726349685e-05,3.640572332478458e-05,39,14,25
7978,Maryland,6.098312339212028e-05,7.436429740749831e-05,80,34,46
7979,Mas,0.00010918284291166549,0.0002244732040073209,203,61,142
7980,Mascot,6.496483935243052e-06,5.348708166200577e-06,6,3,3
7981,Mashup,2.3052039770217305e-06,5.348708166200577e-06,4,1,3
7982,Mask,3.3739803663681634e-05,4.8483451442011706e-05,50,19,31
7983,Masked,1.48790438516857e-05,5.348708166200577e-06,10,7,3
7984,Mass,8.592123914353715e-06,1.7253897310324457e-07,4,4,0
7985,Massachusett,4.6313643538345614e-05,6.573734875233614e-05,70,28,42
7986,Massacre,8.822644312055891e-05,9.679436391092026e-05,108,46,62
7987,Masse,2.3052039770217305e-06,1.8979287041356905e-06,3,2,1
7988,Massie,4.400843956132392e-06,5.348708166200577e-06,5,2,3
7989,Massive,0.0001259479627445509,0.00014337988664879628,159,70,89
7990,Massively,2.3052039770217305e-06,3.6233184351681345e-06,3,1,2
7991,Master,2.5357243747239038e-05,1.2250267090330355e-05,22,13,9
7992,MasterCard,8.592123914353715e-06,1.052487735929791e-05,12,6,6
7993,Mastercard,2.3052039770217305e-06,8.79948762826546e-06,9,3,6
7994,Mastermind,2.3052039770217305e-06,7.074097897233022e-06,5,1,4
7995,Masterpiece,2.3052039770217305e-06,3.6233184351681345e-06,3,1,2
7996,Masto,2.3052039770217305e-06,3.6233184351681345e-06,3,1,2
7997,Match,1.6974683830796368e-05,8.79948762826546e-06,14,8,6
7998,Mate,1.6974683830796368e-05,1.742643628342769e-05,19,9,10
7999,Mater,4.400843956132392e-06,1.8979287041356905e-06,3,2,1
8000,Material,8.592123914353715e-06,1.9151826014460126e-05,16,5,11
8001,Maternal,4.400843956132392e-06,1.2250267090330355e-05,9,2,7
8002,Maternity,2.326160376812834e-05,1.052487735929791e-05,18,12,6
8003,Math,2.116596378901769e-05,7.074097897233022e-06,15,10,5
8004,Matisse,2.3052039770217305e-06,3.6233184351681345e-06,4,1,3
8005,Matt,4.002672360101368e-05,2.6053384938589907e-05,38,20,18
8006,Matter,0.0001552869224521,0.0001485560558418934,177,81,96
8007,Matthew,2.954852370546031e-05,2.777877466962238e-05,37,17,20
8008,Matti,8.592123914353715e-06,3.122955413168725e-05,25,5,20
8009,Mattres,6.496483935243052e-06,1.8979287041356905e-06,4,3,1
8010,Maui,1.48790438516857e-05,1.8979287041356905e-06,9,8,1
8011,Maurice,2.095639979110664e-07,3.6233184351681345e-06,3,0,3
8012,Mauritania,6.496483935243052e-06,8.79948762826546e-06,8,3,5
8013,Maverick,6.496483935243052e-06,7.074097897233022e-06,7,3,4
8014,Mavi,4.400843956132392e-06,1.7253897310324457e-07,3,2,1
8015,Max,1.48790438516857e-05,1.2250267090330355e-05,15,7,8
8016,Maxine,4.400843956132392e-06,1.7253897310324457e-07,3,2,1
8017,May,0.0006121364378982243,0.0006230382318758159,723,320,403
8018,Maya,2.3052039770217305e-06,8.79948762826546e-06,7,1,6
8019,Mayan,1.9070323809907035e-05,1.3975656821362803e-05,17,9,8
8020,Maybe,0.00010918284291166549,8.989280498679035e-05,117,59,58
8021,Mayer,1.278340387257504e-05,1.8979287041356905e-06,7,6,1
8022,Mayhem,4.400843956132392e-06,1.7253897310324457e-07,3,2,1
8023,Mayo,6.496483935243052e-06,1.8979287041356905e-06,4,3,1
8024,Mayor,0.00016786076232676425,0.0002382763218555804,243,95,148
8025,Mayoral,6.496483935243052e-06,1.2250267090330355e-05,12,4,8
8026,Mazie,4.400843956132392e-06,7.074097897233022e-06,6,2,4
8027,Mbp,4.400843956132392e-06,1.8979287041356905e-06,3,2,1
8028,McAfee,4.400843956132392e-06,1.7253897310324457e-07,4,3,1
8029,McAuliffe,1.278340387257504e-05,1.9151826014460126e-05,18,6,12
8030,McCabe,8.592123914353715e-06,7.074097897233022e-06,8,4,4
8031,McCain,0.00014690436253565753,0.00014337988664879628,171,82,89
8032,McCarthy,3.1644163684570994e-05,3.2954943862719716e-05,38,15,23
8033,McCarthyism,8.592123914353715e-06,5.348708166200577e-06,8,4,4
8034,McCaskill,1.6974683830796368e-05,7.074097897233022e-06,12,8,4
8035,McChrystal,8.592123914353715e-06,1.8979287041356905e-06,5,4,1
8036,McClatchy,2.3052039770217305e-06,3.6233184351681345e-06,3,1,2
8037,McClendon,2.095639979110664e-07,7.074097897233022e-06,4,0,4
8038,McConaughey,6.496483935243052e-06,1.7253897310324457e-07,3,3,0
8039,McConnell,0.00019510408205520246,0.00016926073261428268,212,98,114
8040,McCormick,2.095639979110664e-07,5.348708166200577e-06,3,0,3
8041,McCoy,2.3052039770217305e-06,3.6233184351681345e-06,3,1,2
8042,McCrory,1.48790438516857e-05,2.2602605476525032e-05,20,7,13
8043,McDaniel,4.400843956132392e-06,7.074097897233022e-06,6,2,4
8044,McDonald,9.870464301611217e-05,8.299124606266055e-05,111,53,58
8045,McDonnell,1.6974683830796368e-05,1.8979287041356905e-06,13,9,4
8046,McDougal,6.496483935243052e-06,1.8979287041356905e-06,4,3,1
8047,McEnany,4.400843956132392e-06,3.6233184351681345e-06,5,2,3
8048,McFarland,2.3052039770217305e-06,3.6233184351681345e-06,3,1,2
8049,McGahn,2.3052039770217305e-06,5.348708166200577e-06,4,1,3
8050,McGinty,4.400843956132392e-06,3.6233184351681345e-06,5,2,3
8051,McGrath,4.400843956132392e-06,5.348708166200577e-06,5,2,3
8052,McKinney,1.0687763893464371e-05,7.074097897233022e-06,9,5,4
8053,McKinnon,4.400843956132392e-06,1.052487735929791e-05,8,2,6
8054,McKinsey,6.496483935243052e-06,3.6233184351681345e-06,5,3,2
8055,McLaren,4.400843956132392e-06,1.8979287041356905e-06,3,2,1
8056,McLaughlin,4.400843956132392e-06,3.6233184351681345e-06,4,2,2
8057,McMansion,2.3052039770217305e-06,3.6233184351681345e-06,3,1,2
8058,McMaster,8.592123914353715e-06,3.6233184351681345e-06,7,4,3
8059,McMullin,4.400843956132392e-06,3.6233184351681345e-06,5,3,2
8060,McMurray,8.592123914353715e-06,5.348708166200577e-06,7,4,3
8061,McSally,4.400843956132392e-06,1.8979287041356905e-06,3,2,1
8062,Mckesson,2.3052039770217305e-06,5.348708166200577e-06,4,1,3
8063,Mdecin,2.3052039770217305e-06,3.6233184351681345e-06,3,1,2
8064,Me,0.00018462588215964923,0.0002141208656211263,237,99,138
8065,MeToo,1.0687763893464371e-05,1.570104655239525e-05,14,5,9
8066,Meadow,8.592123914353715e-06,5.348708166200577e-06,7,4,3
8067,Meal,2.326160376812834e-05,2.2602605476525032e-05,27,13,14
8068,Mean,0.00013223488268188294,0.00011922443041434203,145,67,78
8069,Meaning,1.48790438516857e-05,2.2602605476525032e-05,21,7,14
8070,Meaningful,1.0687763893464371e-05,3.6233184351681345e-06,7,5,2
8071,Meaningles,6.496483935243052e-06,3.6233184351681345e-06,5,3,2
8072,Meant,1.278340387257504e-05,7.074097897233022e-06,10,6,4
8073,Meanwhile,3.583544364279237e-05,4.50326719799468e-05,52,21,31
8074,Measles,6.496483935243052e-06,5.348708166200577e-06,8,5,3
8075,Measure,3.583544364279237e-05,5.5385010366141504e-05,56,20,36
8076,Measured,2.3052039770217305e-06,3.6233184351681345e-06,3,1,2
8077,Measuring,4.400843956132392e-06,1.8979287041356905e-06,4,3,1
8078,Meat,1.6974683830796368e-05,7.074097897233022e-06,16,11,5
8079,Mecca,1.6974683830796368e-05,2.087721574549256e-05,22,9,13
8080,Med,2.3052039770217305e-06,1.8979287041356905e-06,3,2,1
8081,Medal,2.116596378901769e-05,1.9151826014460126e-05,24,12,12
8082,Meddle,4.400843956132392e-06,1.8979287041356905e-06,3,2,1
8083,Meddling,1.9070323809907035e-05,1.9151826014460126e-05,23,9,14
8084,Media,0.00021396484186719832,0.00022102242454525643,261,112,149
8085,Median,4.400843956132392e-06,3.6233184351681345e-06,5,2,3
8086,Medic,2.3052039770217305e-06,1.8979287041356905e-06,3,2,1
8087,Medicaid,6.936568330856297e-05,0.00011059748175917965,110,36,74
8088,Medical,7.984388320411623e-05,0.00010542131256608228,111,44,67
8089,Medicare,3.583544364279237e-05,6.746273848336857e-05,64,21,43
8090,Medication,4.400843956132392e-06,3.6233184351681345e-06,4,2,2
8091,Medicine,2.954852370546031e-05,3.122955413168725e-05,37,16,21
8092,Medieval,2.3052039770217305e-06,1.052487735929791e-05,8,1,7
8093,Medina,1.0687763893464371e-05,3.6233184351681345e-06,8,5,3
8094,Meditation,8.592123914353715e-06,1.052487735929791e-05,10,4,6
8095,Mediterranean,3.3739803663681634e-05,3.8131113055817005e-05,38,16,22
8096,Medvedev,2.954852370546031e-05,4.1581892517881935e-05,51,19,32
8097,Meehan,4.400843956132392e-06,1.7253897310324457e-07,4,4,0
8098,Meet,0.00015947820241032126,0.00016580995315221804,199,94,105
8099,Meeting,0.0001259479627445509,0.0001520068353039585,165,64,101
8100,Mega,1.6974683830796368e-05,1.9151826014460126e-05,23,9,14
8101,MegaDonor,6.496483935243052e-06,3.6233184351681345e-06,5,3,2
8102,MegaUpload,2.3052039770217305e-06,3.6233184351681345e-06,5,3,2
8103,Megachurch,2.095639979110664e-07,5.348708166200577e-06,3,0,3
8104,Megadonor,4.400843956132392e-06,8.79948762826546e-06,7,2,5
8105,Megan,2.095639979110664e-07,1.2250267090330355e-05,7,0,7
8106,Megaupload,2.326160376812834e-05,1.2250267090330355e-05,20,11,9
8107,Meghan,1.278340387257504e-05,1.9151826014460126e-05,19,8,11
8108,Megyn,2.5357243747239038e-05,2.4327995207557487e-05,29,14,15
8109,Meh,2.3052039770217305e-06,3.6233184351681345e-06,3,1,2
8110,Mehdi,6.496483935243052e-06,5.348708166200577e-06,7,3,4
8111,Mehmet,4.400843956132392e-06,3.6233184351681345e-06,4,2,2
8112,Mein,1.278340387257504e-05,1.570104655239525e-05,17,7,10
8113,Meir,4.400843956132392e-06,1.7253897310324457e-07,3,2,1
8114,Mel,4.400843956132392e-06,3.6233184351681345e-06,4,2,2
8115,Melania,4.4218003559234974e-05,5.883578982820635e-05,58,23,35
8116,Melbourne,1.48790438516857e-05,2.9504164400654783e-05,30,8,22
8117,Melinda,1.278340387257504e-05,8.79948762826546e-06,11,6,5
8118,Melt,4.400843956132392e-06,8.79948762826546e-06,8,3,5
8119,Meltdown,2.5357243747239038e-05,1.2250267090330355e-05,20,13,7
8120,Melting,8.592123914353715e-06,7.074097897233022e-06,8,4,4
8121,Member,0.00013013924270277222,0.00016926073261428268,183,71,112
8122,Membership,4.400843956132392e-06,1.3975656821362803e-05,11,2,9
8123,Meme,1.48790438516857e-05,1.570104655239525e-05,17,7,10
8124,Memo,9.870464301611217e-05,3.122955413168725e-05,71,52,19
8125,Memoir,4.400843956132392e-06,8.79948762826546e-06,8,2,6
8126,Memorable,8.592123914353715e-06,3.6233184351681345e-06,7,5,2
8127,Memorial,4.212236358012434e-05,3.8131113055817005e-05,45,22,23
8128,Memory,2.7452883726349685e-05,2.777877466962238e-05,33,14,19
8129,Memphi,2.3052039770217305e-06,8.79948762826546e-06,9,1,8
8130,Men,1.278340387257504e-05,1.8979287041356905e-06,7,6,1
8131,Menacing,2.095639979110664e-07,5.348708166200577e-06,3,0,3
8132,Mendez,2.095639979110664e-07,5.348708166200577e-06,3,0,3
8133,Menendez,1.278340387257504e-05,3.6233184351681345e-06,9,6,3
8134,Mental,4.840928351745632e-05,5.3659620635109e-05,62,28,34
8135,Mentality,4.400843956132392e-06,3.6233184351681345e-06,4,2,2
8136,Mentally,1.6974683830796368e-05,1.570104655239525e-05,18,9,9
8137,Mention,1.278340387257504e-05,1.742643628342769e-05,18,6,12
8138,Mentioned,6.496483935243052e-06,1.8979287041356905e-06,4,3,1
8139,Mentioning,2.095639979110664e-07,7.074097897233022e-06,4,0,4
8140,Mentor,4.400843956132392e-06,7.074097897233022e-06,6,2,4
8141,Mentoring,2.3052039770217305e-06,5.348708166200577e-06,4,1,3
8142,Menu,6.496483935243052e-06,7.074097897233022e-06,7,3,4
8143,Merah,4.400843956132392e-06,1.8979287041356905e-06,4,3,1
8144,Merapi,2.3052039770217305e-06,3.6233184351681345e-06,3,1,2
8145,Mercede,8.592123914353715e-06,3.6233184351681345e-06,7,4,3
8146,Mercenary,6.496483935243052e-06,5.348708166200577e-06,8,3,5
8147,Mercer,4.400843956132392e-06,7.074097897233022e-06,7,2,5
8148,Merch,2.3052039770217305e-06,3.6233184351681345e-06,3,1,2
8149,Merchant,1.0687763893464371e-05,5.348708166200577e-06,9,5,4
8150,Mercilessly,8.592123914353715e-06,3.6233184351681345e-06,6,4,2
8151,Merck,4.400843956132392e-06,1.052487735929791e-05,8,2,6
8152,Mercury,6.496483935243052e-06,1.3975656821362803e-05,13,4,9
8153,Mercy,8.592123914353715e-06,5.348708166200577e-06,8,5,3
8154,Mere,6.496483935243052e-06,3.6233184351681345e-06,5,3,2
8155,Meredith,2.3052039770217305e-06,7.074097897233022e-06,5,1,4
8156,Merely,1.0687763893464371e-05,3.6233184351681345e-06,7,5,2
8157,Merge,8.592123914353715e-06,3.6233184351681345e-06,6,4,2
8158,Merger,1.48790438516857e-05,5.348708166200577e-06,16,9,7
8159,Merkel,0.00016576512234765329,0.00011922443041434203,166,87,79
8160,Merkley,2.095639979110664e-07,1.2250267090330355e-05,7,0,7
8161,MerriamWebster,2.3052039770217305e-06,3.6233184351681345e-06,3,1,2
8162,Merrick,4.002672360101368e-05,5.5385010366141504e-05,57,21,36
8163,Merrill,2.3052039770217305e-06,5.348708166200577e-06,4,1,3
8164,Merry,2.3052039770217305e-06,3.6233184351681345e-06,5,1,4
8165,Mes,3.1644163684570994e-05,3.640572332478458e-05,40,16,24
8166,Mesmerizing,8.592123914353715e-06,1.7253897310324457e-07,4,4,0
8167,Mesopotamia,2.3052039770217305e-06,3.6233184351681345e-06,4,1,3
8168,Message,0.00010080028299522283,9.161819471782287e-05,113,54,59
8169,Messaging,6.496483935243052e-06,8.79948762826546e-06,8,3,5
8170,Messenger,6.496483935243052e-06,8.79948762826546e-06,12,6,6
8171,Messiah,6.496483935243052e-06,1.7253897310324457e-07,3,3,0
8172,Messy,8.592123914353715e-06,8.79948762826546e-06,10,5,5
8173,Met,5.260056347567764e-05,6.228656929027126e-05,65,26,39
8174,Metadatum,2.3052039770217305e-06,7.074097897233022e-06,5,1,4
8175,Metal,1.278340387257504e-05,2.087721574549256e-05,21,6,15
8176,Metaphor,4.400843956132392e-06,7.074097897233022e-06,6,2,4
8177,Meteor,8.592123914353715e-06,7.074097897233022e-06,8,4,4
8178,Meteorite,1.278340387257504e-05,8.79948762826546e-06,11,6,5
8179,Meteorological,6.496483935243052e-06,8.79948762826546e-06,8,3,5
8180,Meteorologist,2.3052039770217305e-06,5.348708166200577e-06,4,1,3
8181,Meteorology,4.400843956132392e-06,1.8979287041356905e-06,3,2,1
8182,Meter,8.592123914353715e-06,1.7253897310324457e-07,4,4,0
8183,Meth,1.278340387257504e-05,1.8979287041356905e-06,7,6,1
8184,Methane,1.9070323809907035e-05,7.074097897233022e-06,13,9,4
8185,Method,1.278340387257504e-05,1.3975656821362803e-05,14,6,8
8186,Metric,2.3052039770217305e-06,3.6233184351681345e-06,3,1,2
8187,Metro,4.400843956132392e-06,5.348708166200577e-06,6,2,4
8188,Metropolitan,1.9070323809907035e-05,1.9151826014460126e-05,21,9,12
8189,Mexican,0.0003501814405093918,0.0003262711981382355,395,188,207
8190,MexicanAmerican,4.400843956132392e-06,3.6233184351681345e-06,5,3,2
8191,Mexico,0.0006372841176475525,0.0005816288783310371,722,335,387
8192,Meyer,6.496483935243052e-06,1.052487735929791e-05,9,3,6
8193,Mia,4.400843956132392e-06,3.6233184351681345e-06,4,2,2
8194,Miami,4.212236358012434e-05,3.640572332478458e-05,45,22,23
8195,MiamiDade,6.496483935243052e-06,1.7253897310324457e-07,3,3,0
8196,Mic,6.496483935243052e-06,1.8979287041356905e-06,4,3,1
8197,Micah,2.3052039770217305e-06,3.6233184351681345e-06,3,1,2
8198,Mich,2.3052039770217305e-06,1.8979287041356905e-06,3,2,1
8199,Michael,0.0002265386817418625,0.0003193696392141053,315,119,196
8200,Michel,4.400843956132392e-06,1.2250267090330355e-05,9,2,7
8201,Michelangelo,2.3052039770217305e-06,5.348708166200577e-06,5,2,3
8202,Michele,1.48790438516857e-05,8.79948762826546e-06,15,8,7
8203,Michelle,6.936568330856297e-05,7.954046660059569e-05,81,35,46
8204,Michigan,9.24177230787802e-05,0.0001589083942280881,152,50,102
8205,Michoacan,4.400843956132392e-06,5.348708166200577e-06,5,2,3
8206,Mick,1.278340387257504e-05,2.2602605476525032e-05,20,7,13
8207,Mickey,2.3052039770217305e-06,3.6233184351681345e-06,4,2,2
8208,Microphone,4.400843956132392e-06,3.6233184351681345e-06,4,2,2
8209,Microscope,2.3052039770217305e-06,5.348708166200577e-06,4,1,3
8210,Microsoft,9.03220830996695e-05,0.0001019705331040174,110,45,65
8211,MidMarch,4.400843956132392e-06,1.8979287041356905e-06,3,2,1
8212,MidTerm,2.3052039770217305e-06,3.6233184351681345e-06,3,1,2
8213,Middle,0.00023701688163741595,0.0002296493732004186,287,131,156
8214,MiddleClas,8.592123914353715e-06,1.570104655239525e-05,14,5,9
8215,Mideast,3.7931083621902995e-05,2.087721574549256e-05,33,18,15
8216,Midnight,2.3052039770217305e-06,8.79948762826546e-06,7,1,6
8217,Midst,2.095639979110664e-07,5.348708166200577e-06,3,0,3
8218,Midterm,2.116596378901769e-05,9.506897417988779e-05,68,11,57
8219,Midwest,4.400843956132392e-06,1.052487735929791e-05,11,3,8
8220,Might,0.0001385218026192147,0.00013302754826260141,158,74,84
8221,Mighty,2.3052039770217305e-06,5.348708166200577e-06,5,1,4
8222,Migrant,4.840928351745632e-05,6.573734875233614e-05,69,25,44
8223,Migration,6.496483935243052e-06,1.052487735929791e-05,9,3,6
8224,Miguel,8.592123914353715e-06,1.7253897310324457e-07,4,4,0
8225,Mika,8.592123914353715e-06,3.6233184351681345e-06,6,4,2
8226,Mike,0.00020767792192986646,0.00027968567540035923,282,105,177
8227,Mikhail,1.278340387257504e-05,1.3975656821362803e-05,16,7,9
8228,Milan,1.6974683830796368e-05,7.074097897233022e-06,13,8,5
8229,Mile,3.583544364279237e-05,3.2954943862719716e-05,38,18,20
8230,Milestone,1.6974683830796368e-05,8.79948762826546e-06,13,8,5
8231,Milgram,4.400843956132392e-06,3.6233184351681345e-06,4,2,2
8232,Miliband,1.9070323809907035e-05,1.8979287041356905e-06,12,9,3
8233,Militant,4.840928351745632e-05,2.087721574549256e-05,46,26,20
8234,Militarization,6.496483935243052e-06,3.6233184351681345e-06,5,3,2
8235,Military,0.00024959072151208,0.00026243177809003493,305,130,175
8236,Militia,1.6974683830796368e-05,1.742643628342769e-05,23,9,14
8237,Militiaman,4.400843956132392e-06,3.6233184351681345e-06,4,2,2
8238,Milk,1.48790438516857e-05,2.777877466962238e-05,24,7,17
8239,Milky,2.116596378901769e-05,1.2250267090330355e-05,17,10,7
8240,Mill,1.0687763893464371e-05,7.074097897233022e-06,9,5,4
8241,Millennial,6.307876337123095e-05,7.781507686956326e-05,86,39,47
8242,Millennium,2.3052039770217305e-06,5.348708166200577e-06,4,1,3
8243,Miller,2.5357243747239038e-05,1.3975656821362803e-05,23,13,10
8244,Million,0.0005576497984413471,0.0005126132890897391,644,300,344
8245,MillionDollar,6.496483935243052e-06,1.8979287041356905e-06,6,4,2
8246,Millionaire,1.48790438516857e-05,3.468033359375216e-05,30,9,21
8247,Milo,6.496483935243052e-06,7.074097897233022e-06,7,3,4
8248,Milton,4.400843956132392e-06,1.8979287041356905e-06,4,2,2
8249,Milwaukee,1.48790438516857e-05,8.79948762826546e-06,14,8,6
8250,Mimi,4.400843956132392e-06,1.8979287041356905e-06,3,2,1
8251,Min,6.496483935243052e-06,1.8979287041356905e-06,4,3,1
8252,Mina,4.400843956132392e-06,3.6233184351681345e-06,4,2,2
8253,Mind,5.050492349656699e-05,5.020884117304414e-05,58,27,31
8254,Mindful,2.3052039770217305e-06,7.074097897233022e-06,5,1,4
8255,Mindfulnes,6.496483935243052e-06,7.074097897233022e-06,8,3,5
8256,Mindset,2.095639979110664e-07,3.6233184351681345e-06,5,1,4
8257,Mine,2.7452883726349685e-05,2.087721574549256e-05,31,17,14
8258,Minecraft,6.496483935243052e-06,1.7253897310324457e-07,3,3,0
8259,Miner,1.6974683830796368e-05,1.742643628342769e-05,20,8,12
8260,Mineral,2.3052039770217305e-06,1.3975656821362803e-05,10,1,9
8261,Ming,2.095639979110664e-07,5.348708166200577e-06,3,0,3
8262,Mini,2.095639979110664e-07,7.074097897233022e-06,4,0,4
8263,Minimum,5.4696203454788295e-05,7.436429740749831e-05,83,30,53
8264,Mining,2.7452883726349685e-05,2.6053384938589907e-05,30,15,15
8265,Minister,0.0005995625980235608,0.0005005355609725121,641,309,332
8266,Ministry,7.355696326678427e-05,9.161819471782287e-05,95,39,56
8267,Minneapoli,1.48790438516857e-05,1.9151826014460126e-05,21,8,13
8268,Minnesota,4.4218003559234974e-05,5.5385010366141504e-05,59,25,34
8269,Minor,1.9070323809907035e-05,1.052487735929791e-05,18,9,9
8270,Minority,5.6791843433898893e-05,6.918812821440096e-05,76,32,44
8271,Minsk,2.3052039770217305e-06,3.6233184351681345e-06,4,2,2
8272,Mint,6.496483935243052e-06,1.2250267090330355e-05,11,4,7
8273,Minute,4.4218003559234974e-05,5.5385010366141504e-05,63,26,37
8274,Mir,4.400843956132392e-06,1.8979287041356905e-06,3,2,1
8275,Miracle,1.48790438516857e-05,2.087721574549256e-05,20,8,12
8276,Miranda,3.3739803663681634e-05,1.3975656821362803e-05,26,16,10
8277,Mirror,1.48790438516857e-05,7.074097897233022e-06,11,7,4
8278,Mis,3.7931083621902995e-05,7.091351794543343e-05,62,19,43
8279,Misconception,2.3052039770217305e-06,1.8979287041356905e-06,3,1,2
8280,Misconduct,4.840928351745632e-05,5.3659620635109e-05,58,25,33
8281,Misdeed,4.400843956132392e-06,1.7253897310324457e-07,3,3,0
8282,Misdemeanor,2.3052039770217305e-06,5.348708166200577e-06,4,1,3
8283,Miserable,1.278340387257504e-05,5.348708166200577e-06,10,7,3
8284,Miserably,4.400843956132392e-06,1.7253897310324457e-07,3,2,1
8285,Misery,2.3052039770217305e-06,8.79948762826546e-06,6,1,5
8286,Misfire,2.3052039770217305e-06,3.6233184351681345e-06,3,1,2
8287,Misguided,4.400843956132392e-06,5.348708166200577e-06,5,2,3
8288,Mishandling,2.3052039770217305e-06,3.6233184351681345e-06,3,1,2
8289,Mishap,4.400843956132392e-06,1.8979287041356905e-06,3,2,1
8290,Misinformation,8.592123914353715e-06,8.79948762826546e-06,11,6,5
8291,Mislead,4.400843956132392e-06,8.79948762826546e-06,7,2,5
8292,Misleading,2.116596378901769e-05,1.570104655239525e-05,20,11,9
8293,Misled,2.3052039770217305e-06,3.6233184351681345e-06,5,1,4
8294,Misogynist,2.3052039770217305e-06,1.8979287041356905e-06,3,1,2
8295,Misogyny,1.48790438516857e-05,5.348708166200577e-06,10,7,3
8296,Misplaced,2.3052039770217305e-06,3.6233184351681345e-06,3,1,2
8297,Misrata,8.592123914353715e-06,7.074097897233022e-06,8,4,4
8298,Miss,1.0687763893464371e-05,7.074097897233022e-06,10,6,4
8299,Missed,3.1644163684570994e-05,2.2602605476525032e-05,29,15,14
8300,Missile,6.72700433294523e-05,6.056117955923882e-05,72,32,40
8301,Missing,6.72700433294523e-05,0.0001036959228350498,103,35,68
8302,Mission,6.098312339212028e-05,5.711040009717395e-05,69,32,37
8303,Mississippi,4.212236358012434e-05,6.918812821440096e-05,67,26,41
8304,Missouri,8.193952318322689e-05,8.816741525575797e-05,101,47,54
8305,Misspelling,2.3052039770217305e-06,1.8979287041356905e-06,3,1,2
8306,Mistake,5.260056347567764e-05,7.263890767646595e-05,70,26,44
8307,Mistaken,6.496483935243052e-06,1.7253897310324457e-07,5,4,1
8308,Mistakenly,6.496483935243052e-06,5.348708166200577e-06,8,4,4
8309,Mistral,1.0687763893464371e-05,5.348708166200577e-06,8,5,3
8310,Mistrial,4.400843956132392e-06,3.6233184351681345e-06,4,2,2
8311,Misunderstanding,2.3052039770217305e-06,3.6233184351681345e-06,3,1,2
8312,Misurata,2.095639979110664e-07,5.348708166200577e-06,3,0,3
8313,Misuse,1.278340387257504e-05,3.6233184351681345e-06,9,7,2
8314,Mitch,0.00015109564249387862,0.00013302754826260141,165,76,89
8315,Mitchell,1.278340387257504e-05,1.3975656821362803e-05,14,6,8
8316,Mitsubishi,2.095639979110664e-07,8.79948762826546e-06,5,0,5
8317,Mitt,9.451336305789087e-05,8.4716635793693e-05,105,47,58
8318,Mix,4.400843956132392e-06,7.074097897233022e-06,7,3,4
8319,Mixed,6.496483935243052e-06,1.3975656821362803e-05,12,3,9
8320,Mizzou,4.400843956132392e-06,1.8979287041356905e-06,3,2,1
8321,Mladic,4.400843956132392e-06,1.8979287041356905e-06,8,3,5
8322,Mnuchin,1.278340387257504e-05,2.777877466962238e-05,26,10,16
8323,Mo,2.116596378901769e-05,8.79948762826546e-06,16,10,6
8324,MoD,6.496483935243052e-06,8.79948762826546e-06,9,4,5
8325,Moammar,8.592123914353715e-06,8.79948762826546e-06,11,4,7
8326,Mob,1.6974683830796368e-05,2.2602605476525032e-05,24,10,14
8327,Mobil,4.002672360101368e-05,1.742643628342769e-05,34,21,13
8328,Mobile,2.116596378901769e-05,3.8131113055817005e-05,40,14,26
8329,Mobilize,4.400843956132392e-06,3.6233184351681345e-06,4,2,2
8330,Mock,3.3739803663681634e-05,5.020884117304414e-05,50,17,33
8331,Mocked,2.5357243747239038e-05,1.570104655239525e-05,23,12,11
8332,Mockery,4.400843956132392e-06,3.6233184351681345e-06,4,2,2
8333,Mocking,8.592123914353715e-06,8.79948762826546e-06,9,4,5
8334,Mode,4.400843956132392e-06,7.074097897233022e-06,7,3,4
8335,Model,9.24177230787802e-05,5.1934230904076595e-05,82,49,33
8336,Moderate,2.954852370546031e-05,2.087721574549256e-05,28,15,13
8337,Moderator,6.496483935243052e-06,3.6233184351681345e-06,6,4,2
8338,Modern,4.002672360101368e-05,3.8131113055817005e-05,48,21,27
8339,Modest,2.3052039770217305e-06,1.2250267090330355e-05,8,1,7
8340,Modi,1.0687763893464371e-05,1.9151826014460126e-05,19,6,13
8341,Modified,8.592123914353715e-06,3.6233184351681345e-06,7,4,3
8342,Mogadishu,1.9070323809907035e-05,1.2250267090330355e-05,16,9,7
8343,Mogul,4.400843956132392e-06,3.6233184351681345e-06,7,3,4
8344,Mohamed,3.583544364279237e-05,5.020884117304414e-05,48,19,29
8345,Mohammad,3.1644163684570994e-05,5.348708166200577e-06,18,15,3
8346,Mohammed,4.6313643538345614e-05,4.6758061710979285e-05,56,23,33
8347,Moine,2.3052039770217305e-06,3.6233184351681345e-06,4,2,2
8348,Moldova,4.400843956132392e-06,3.6233184351681345e-06,4,2,2
8349,Moldovan,2.3052039770217305e-06,8.79948762826546e-06,6,1,5
8350,Moldovum,1.278340387257504e-05,1.052487735929791e-05,17,10,7
8351,Molecule,2.095639979110664e-07,5.348708166200577e-06,3,0,3
8352,Molester,2.095639979110664e-07,5.348708166200577e-06,3,0,3
8353,Molotov,1.0687763893464371e-05,8.79948762826546e-06,10,5,5
8354,Mom,0.00010918284291166549,9.851975364195259e-05,121,56,65
8355,Moment,0.00010289592297433347,9.851975364195259e-05,121,56,65
8356,Momentum,1.9070323809907035e-05,1.742643628342769e-05,21,9,12
8357,Mona,8.592123914353715e-06,5.348708166200577e-06,7,4,3
8358,Monaco,2.095639979110664e-07,3.6233184351681345e-06,3,1,2
8359,Monarch,8.592123914353715e-06,1.8979287041356905e-06,5,4,1
8360,Monarchy,4.400843956132392e-06,1.8979287041356905e-06,3,2,1
8361,Monbiot,2.3052039770217305e-06,3.6233184351681345e-06,3,1,2
8362,Monckton,4.400843956132392e-06,1.8979287041356905e-06,3,2,1
8363,Monday,0.0005031631589844702,0.0004349707511932791,539,264,275
8364,Monde,4.400843956132392e-06,1.8979287041356905e-06,6,4,2
8365,Monet,2.095639979110664e-07,5.348708166200577e-06,3,0,3
8366,Monetary,1.6974683830796368e-05,1.742643628342769e-05,20,9,11
8367,Money,0.0004025724399871583,0.00037630750033817615,448,208,240
8368,Mongering,2.095639979110664e-07,5.348708166200577e-06,3,0,3
8369,Mongolia,1.0687763893464371e-05,2.6053384938589907e-05,23,5,18
8370,Mongolian,2.3052039770217305e-06,3.6233184351681345e-06,3,1,2
8371,Monica,1.278340387257504e-05,1.2250267090330355e-05,13,6,7
8372,Monitor,1.0687763893464371e-05,1.052487735929791e-05,11,5,6
8373,Monitored,4.400843956132392e-06,3.6233184351681345e-06,4,2,2
8374,Monitoring,8.592123914353715e-06,8.79948762826546e-06,10,5,5
8375,Monk,6.496483935243052e-06,8.79948762826546e-06,10,4,6
8376,Monkey,1.278340387257504e-05,1.3975656821362803e-05,14,6,8
8377,Monkeypox,4.400843956132392e-06,1.8979287041356905e-06,3,2,1
8378,Monopoly,1.278340387257504e-05,1.9151826014460126e-05,19,7,12
8379,Monsanto,6.307876337123095e-05,6.401195902130366e-05,75,31,44
8380,Monster,3.1644163684570994e-05,2.2602605476525032e-05,30,15,15
8381,Montana,3.3739803663681634e-05,5.1934230904076595e-05,51,20,31
8382,Montazeri,4.400843956132392e-06,7.074097897233022e-06,6,2,4
8383,Monte,8.592123914353715e-06,1.7253897310324457e-07,4,4,0
8384,Montenegro,4.400843956132392e-06,3.6233184351681345e-06,6,3,3
8385,Monterrey,6.496483935243052e-06,7.074097897233022e-06,8,3,5
8386,Montgomery,6.496483935243052e-06,1.8979287041356905e-06,4,3,1
8387,Month,0.00014480872255654665,0.00016580995315221804,200,87,113
8388,Monthly,4.400843956132392e-06,5.348708166200577e-06,6,3,3
8389,Monti,2.3052039770217305e-06,3.6233184351681345e-06,3,1,2
8390,Montreal,3.583544364279237e-05,3.640572332478458e-05,43,19,24
8391,Monty,6.496483935243052e-06,1.8979287041356905e-06,5,3,2
8392,Monument,3.7931083621902995e-05,2.9504164400654783e-05,42,23,19
8393,Mooch,2.3052039770217305e-06,8.79948762826546e-06,10,1,9
8394,Mood,6.496483935243052e-06,3.6233184351681345e-06,5,3,2
8395,Moody,1.278340387257504e-05,1.742643628342769e-05,16,6,10
8396,Moon,6.307876337123095e-05,6.228656929027126e-05,74,34,40
8397,Moonshot,6.496483935243052e-06,1.7253897310324457e-07,3,3,0
8398,Moore,0.00013642616264010403,0.00018996540938667205,205,86,119
8399,Mora,2.3052039770217305e-06,5.348708166200577e-06,4,1,3
8400,Moral,2.954852370546031e-05,3.468033359375216e-05,39,15,24
8401,Morale,2.116596378901769e-05,3.2954943862719716e-05,30,11,19
8402,Morality,6.496483935243052e-06,3.6233184351681345e-06,5,3,2
8403,Morally,2.095639979110664e-07,1.052487735929791e-05,6,0,6
8404,Moran,4.400843956132392e-06,1.8979287041356905e-06,4,2,2
8405,Moratorium,1.0687763893464371e-05,7.074097897233022e-06,11,6,5
8406,Mordechai,6.496483935243052e-06,3.6233184351681345e-06,6,3,3
8407,More,2.3052039770217305e-06,7.074097897233022e-06,5,1,4
8408,Moreover,4.400843956132392e-06,5.348708166200577e-06,5,2,3
8409,Morgan,4.840928351745632e-05,3.640572332478458e-05,52,28,24
8410,Morgue,2.095639979110664e-07,5.348708166200577e-06,3,0,3
8411,Mormon,1.48790438516857e-05,1.570104655239525e-05,19,7,12
8412,Morning,0.0005492672385249046,0.000573001929675875,665,292,373
8413,Moroccan,1.6974683830796368e-05,2.2602605476525032e-05,22,8,14
8414,Morocco,4.4218003559234974e-05,3.122955413168725e-05,46,24,22
8415,Moron,2.3052039770217305e-06,5.348708166200577e-06,5,2,3
8416,Morphed,4.400843956132392e-06,1.8979287041356905e-06,3,2,1
8417,Morri,1.278340387257504e-05,2.2602605476525032e-05,19,6,13
8418,Morrison,2.095639979110664e-07,7.074097897233022e-06,4,0,4
8419,Morsi,3.583544364279237e-05,3.468033359375216e-05,40,18,22
8420,Mortal,2.3052039770217305e-06,1.8979287041356905e-06,3,2,1
8421,Mortality,4.400843956132392e-06,1.8979287041356905e-06,4,3,1
8422,Mortar,2.3052039770217305e-06,7.074097897233022e-06,6,2,4
8423,Mortgage,5.050492349656699e-05,4.1581892517881935e-05,54,29,25
8424,Mos,4.400843956132392e-06,3.6233184351681345e-06,4,2,2
8425,Moscow,0.00024539944155385846,0.0002538048294348729,291,126,165
8426,Moser,6.496483935243052e-06,3.6233184351681345e-06,5,3,2
8427,Moshe,1.0687763893464371e-05,1.8979287041356905e-06,6,5,1
8428,Mosque,6.307876337123095e-05,3.2954943862719716e-05,56,32,24
8429,Mosquito,1.278340387257504e-05,1.052487735929791e-05,12,6,6
8430,Mossack,8.592123914353715e-06,5.348708166200577e-06,7,4,3
8431,Mossad,5.6791843433898893e-05,4.330728224891437e-05,55,27,28
8432,Most,4.400843956132392e-06,3.6233184351681345e-06,7,2,5
8433,Mostly,1.9070323809907035e-05,2.2602605476525032e-05,24,9,15
8434,Mosul,5.260056347567764e-05,4.50326719799468e-05,56,25,31
8435,Motel,2.3052039770217305e-06,1.8979287041356905e-06,3,1,2
8436,Mother,0.00011756540282810809,0.0001364783277246665,148,58,90
8437,Motherhood,6.496483935243052e-06,5.348708166200577e-06,7,3,4
8438,Motion,8.592123914353715e-06,1.7253897310324457e-07,4,4,0
8439,Motivate,6.496483935243052e-06,1.8979287041356905e-06,5,3,2
8440,Motivated,8.592123914353715e-06,5.348708166200577e-06,8,4,4
8441,Motivating,2.095639979110664e-07,5.348708166200577e-06,3,0,3
8442,Motive,2.3052039770217305e-06,5.348708166200577e-06,4,1,3
8443,Motor,2.116596378901769e-05,2.4327995207557487e-05,25,11,14
8444,Motorcade,2.095639979110664e-07,3.6233184351681345e-06,4,1,3
8445,Motorcycle,1.0687763893464371e-05,5.348708166200577e-06,10,6,4
8446,Motorist,2.3052039770217305e-06,3.6233184351681345e-06,4,1,3
8447,Motorola,6.496483935243052e-06,1.7253897310324457e-07,3,3,0
8448,Mount,5.260056347567764e-05,3.985650278684949e-05,50,25,25
8449,Mountain,3.7931083621902995e-05,2.9504164400654783e-05,41,24,17
8450,Mounting,8.592123914353715e-06,5.348708166200577e-06,8,5,3
8451,Mourn,6.496483935243052e-06,1.3975656821362803e-05,11,3,8
8452,Mourner,2.3052039770217305e-06,3.6233184351681345e-06,3,1,2
8453,Mourning,4.400843956132392e-06,5.348708166200577e-06,6,2,4
8454,Mousavi,1.0687763893464371e-05,1.052487735929791e-05,12,5,7
8455,Mouse,2.3052039770217305e-06,1.052487735929791e-05,8,2,6
8456,Moussa,4.400843956132392e-06,1.7253897310324457e-07,3,2,1
8457,Moussavi,6.496483935243052e-06,1.7253897310324457e-07,4,3,1
8458,Mouth,1.48790438516857e-05,8.79948762826546e-06,13,8,5
8459,Move,0.0001741476822640959,0.0002020431375038992,232,97,135
8460,MoveOn,4.400843956132392e-06,1.8979287041356905e-06,3,2,1
8461,Moved,1.48790438516857e-05,7.074097897233022e-06,13,7,6
8462,Movement,7.774824322500554e-05,9.334358444885519e-05,100,41,59
8463,Movie,3.1644163684570994e-05,2.6053384938589907e-05,32,17,15
8464,Moving,4.4218003559234974e-05,6.401195902130366e-05,65,23,42
8465,Mow,2.095639979110664e-07,1.052487735929791e-05,6,0,6
8466,Mozambique,2.326160376812834e-05,1.9151826014460126e-05,25,13,12
8467,Mozart,2.095639979110664e-07,5.348708166200577e-06,3,0,3
8468,Mozilla,2.3052039770217305e-06,3.6233184351681345e-06,3,1,2
8469,Mr,0.00012385232276544028,0.0001295767688005365,146,64,82
8470,Mt,1.278340387257504e-05,2.2602605476525032e-05,20,7,13
8471,Muammar,3.7931083621902995e-05,3.2954943862719716e-05,41,22,19
8472,Mubarak,7.146132328767358e-05,0.00012094982014537423,117,35,82
8473,Much,0.0002055822819507562,0.00016926073261428268,211,106,105
8474,MuchNeeded,6.496483935243052e-06,3.6233184351681345e-06,5,3,2
8475,Mud,2.3052039770217305e-06,7.074097897233022e-06,5,1,4
8476,Mudslide,2.095639979110664e-07,3.6233184351681345e-06,3,1,2
8477,Mueller,0.00014480872255654665,0.00016408456342118544,185,78,107
8478,Mufti,8.592123914353715e-06,5.348708166200577e-06,8,4,4
8479,Mugabe,4.212236358012434e-05,5.1934230904076595e-05,62,22,40
8480,Mugshot,4.400843956132392e-06,1.8979287041356905e-06,3,2,1
8481,Muhammad,3.7931083621902995e-05,3.122955413168725e-05,39,19,20
8482,Muhammed,2.3052039770217305e-06,3.6233184351681345e-06,3,1,2
8483,Mujica,8.592123914353715e-06,5.348708166200577e-06,8,4,4
8484,Mulcair,2.3052039770217305e-06,5.348708166200577e-06,4,1,3
8485,Mull,6.496483935243052e-06,7.074097897233022e-06,10,4,6
8486,Mullah,1.0687763893464371e-05,5.348708166200577e-06,9,5,4
8487,Mullen,6.496483935243052e-06,5.348708166200577e-06,6,3,3
8488,Mulling,2.3052039770217305e-06,1.8979287041356905e-06,3,1,2
8489,MultiMillion,6.496483935243052e-06,1.7253897310324457e-07,3,3,0
8490,Multinational,6.496483935243052e-06,3.6233184351681345e-06,5,3,2
8491,Multiple,3.1644163684570994e-05,2.6053384938589907e-05,32,15,17
8492,Mulvaney,1.0687763893464371e-05,2.9504164400654783e-05,23,6,17
8493,Mum,8.592123914353715e-06,1.8979287041356905e-06,5,4,1
8494,Mumbai,5.888748341300963e-05,0.0001036959228350498,95,31,64
8495,Mummy,2.095639979110664e-07,8.79948762826546e-06,5,0,5
8496,Munich,8.592123914353715e-06,1.052487735929791e-05,10,4,6
8497,Municipal,2.095639979110664e-07,7.074097897233022e-06,4,0,4
8498,Mural,1.0687763893464371e-05,1.7253897310324457e-07,6,5,1
8499,Murder,6.098312339212028e-05,8.989280498679035e-05,89,32,57
8500,Murdered,2.116596378901769e-05,1.742643628342769e-05,21,10,11
8501,Murderer,8.592123914353715e-06,5.348708166200577e-06,8,5,3
8502,Murdering,4.400843956132392e-06,1.8979287041356905e-06,3,2,1
8503,Murdoch,0.00018672152213876006,0.00015028144557292604,199,105,94
8504,Muriel,6.496483935243052e-06,1.7253897310324457e-07,3,3,0
8505,Murkowski,1.9070323809907035e-05,1.2250267090330355e-05,18,9,9
8506,Murky,2.095639979110664e-07,8.79948762826546e-06,5,0,5
8507,Murphy,2.326160376812834e-05,2.9504164400654783e-05,33,15,18
8508,Murray,2.116596378901769e-05,1.3975656821362803e-05,18,10,8
8509,Mursi,2.3052039770217305e-06,7.074097897233022e-06,5,1,4
8510,Muscular,2.3052039770217305e-06,1.8979287041356905e-06,3,2,1
8511,Museum,5.260056347567764e-05,4.6758061710979285e-05,55,27,28
8512,Museveni,4.400843956132392e-06,8.79948762826546e-06,7,2,5
8513,Musharraf,4.400843956132392e-06,5.348708166200577e-06,7,3,4
8514,Music,3.583544364279237e-05,4.8483451442011706e-05,50,19,31
8515,Musical,2.095639979110664e-07,1.052487735929791e-05,7,1,6
8516,Musician,4.400843956132392e-06,8.79948762826546e-06,8,3,5
8517,Musk,6.936568330856297e-05,8.126585633162811e-05,88,34,54
8518,Muslim,0.0009893516341381435,0.0008801213017996504,1089,507,582
8519,MuslimAmerican,4.400843956132392e-06,8.79948762826546e-06,7,2,5
8520,Muslimmajority,1.0687763893464371e-05,1.3975656821362803e-05,14,6,8
8521,Mussolini,4.400843956132392e-06,8.79948762826546e-06,9,3,6
8522,Must,0.00012175668278632962,0.0001589083942280881,179,71,108
8523,MustPas,2.3052039770217305e-06,1.8979287041356905e-06,3,2,1
8524,Mutation,6.496483935243052e-06,1.7253897310324457e-07,3,3,0
8525,Mutilated,4.400843956132392e-06,3.6233184351681345e-06,4,2,2
8526,Mutilation,1.48790438516857e-05,1.052487735929791e-05,18,10,8
8527,Mutiny,4.400843956132392e-06,3.6233184351681345e-06,4,2,2
8528,Mutual,4.400843956132392e-06,3.6233184351681345e-06,5,2,3
8529,My,2.116596378901769e-05,8.79948762826546e-06,17,11,6
8530,MyPillow,4.400843956132392e-06,3.6233184351681345e-06,5,2,3
8531,Myanmar,6.098312339212028e-05,3.468033359375216e-05,56,32,24
8532,Myer,2.3052039770217305e-06,7.074097897233022e-06,5,1,4
8533,Mylan,2.3052039770217305e-06,7.074097897233022e-06,5,1,4
8534,Mysteriou,4.840928351745632e-05,3.640572332478458e-05,48,25,23
8535,Mysteriously,6.496483935243052e-06,3.6233184351681345e-06,5,3,2
8536,Mystery,5.260056347567764e-05,4.6758061710979285e-05,62,29,33
8537,Myth,3.583544364279237e-05,3.8131113055817005e-05,44,20,24
8538,Mythical,2.3052039770217305e-06,3.6233184351681345e-06,3,1,2
8539,Mythology,4.400843956132392e-06,1.7253897310324457e-07,3,3,0
8540,NAACP,8.592123914353715e-06,2.2602605476525032e-05,18,4,14
8541,NAFTA,1.48790438516857e-05,1.9151826014460126e-05,22,9,13
8542,NARAL,4.400843956132392e-06,3.6233184351681345e-06,6,3,3
8543,NASA,0.0001762433222432067,0.00017961307100047735,204,91,113
8544,NASCAR,4.400843956132392e-06,3.6233184351681345e-06,6,2,4
8545,NATO,0.00025797328142852257,0.00026760794728313193,300,131,169
8546,NBA,1.48790438516857e-05,1.742643628342769e-05,20,9,11
8547,NBC,4.212236358012434e-05,5.3659620635109e-05,58,24,34
8548,NC,6.496483935243052e-06,5.348708166200577e-06,7,3,4
8549,NCAA,1.0687763893464371e-05,1.8979287041356905e-06,8,6,2
8550,NDA,4.400843956132392e-06,3.6233184351681345e-06,4,2,2
8551,NDP,2.3052039770217305e-06,1.8979287041356905e-06,3,1,2
8552,NEVER,4.400843956132392e-06,1.8979287041356905e-06,3,2,1
8553,NEW,2.326160376812834e-05,2.087721574549256e-05,24,12,12
8554,NEWS,2.5357243747239038e-05,1.2250267090330355e-05,20,12,8
8555,NFL,3.1644163684570994e-05,5.5385010366141504e-05,52,16,36
8556,NGO,2.326160376812834e-05,3.8131113055817005e-05,36,13,23
8557,NH,6.936568330856297e-05,2.777877466962238e-05,53,35,18
8558,NHK,2.3052039770217305e-06,3.6233184351681345e-06,5,1,4
8559,NI,4.400843956132392e-06,1.8979287041356905e-06,4,2,2
8560,NIH,2.3052039770217305e-06,8.79948762826546e-06,8,1,7
8561,NJ,1.278340387257504e-05,1.052487735929791e-05,13,7,6
8562,NK,6.496483935243052e-06,1.9151826014460126e-05,18,4,14
8563,NKorea,8.592123914353715e-06,2.087721574549256e-05,21,7,14
8564,NKorean,4.400843956132392e-06,5.348708166200577e-06,6,2,4
8565,NOAA,2.095639979110664e-07,7.074097897233022e-06,4,0,4
8566,NORAD,4.400843956132392e-06,1.8979287041356905e-06,4,3,1
8567,NOTE,2.3052039770217305e-06,3.6233184351681345e-06,3,1,2
8568,NOx,2.3052039770217305e-06,3.6233184351681345e-06,3,1,2
8569,NPD,4.400843956132392e-06,1.8979287041356905e-06,3,2,1
8570,NPR,3.583544364279237e-05,1.570104655239525e-05,28,18,10
8571,NPT,4.400843956132392e-06,5.348708166200577e-06,5,2,3
8572,NRA,6.72700433294523e-05,0.00012440059960743937,120,36,84
8573,NRABacked,4.400843956132392e-06,3.6233184351681345e-06,5,2,3
8574,NRCC,2.3052039770217305e-06,3.6233184351681345e-06,3,1,2
8575,NSA,0.000385807320154273,0.0003090173008279106,409,199,210
8576,NSC,4.400843956132392e-06,1.8979287041356905e-06,3,2,1
8577,NSFL,4.400843956132392e-06,1.7253897310324457e-07,4,2,2
8578,NSFW,3.1644163684570994e-05,2.087721574549256e-05,31,16,15
8579,NSW,8.592123914353715e-06,8.79948762826546e-06,12,6,6
8580,NWord,2.3052039770217305e-06,3.6233184351681345e-06,3,1,2
8581,NY,5.260056347567764e-05,3.468033359375216e-05,51,26,25
8582,NYC,6.936568330856297e-05,7.781507686956326e-05,86,37,49
8583,NYPD,2.954852370546031e-05,2.777877466962238e-05,35,17,18
8584,NYSE,6.496483935243052e-06,1.8979287041356905e-06,4,3,1
8585,NYT,1.6974683830796368e-05,3.2954943862719716e-05,31,10,21
8586,NYTime,8.592123914353715e-06,1.8979287041356905e-06,7,5,2
8587,NYTimescom,4.4218003559234974e-05,2.9504164400654783e-05,40,22,18
8588,NYU,8.592123914353715e-06,5.348708166200577e-06,7,4,3
8589,NZ,4.212236358012434e-05,4.8483451442011706e-05,53,21,32
8590,Nab,4.400843956132392e-06,5.348708166200577e-06,6,2,4
8591,Nablu,6.496483935243052e-06,1.7253897310324457e-07,3,3,0
8592,Nader,1.48790438516857e-05,1.7253897310324457e-07,11,11,0
8593,Nadler,4.400843956132392e-06,1.8979287041356905e-06,3,2,1
8594,Nae,4.400843956132392e-06,1.052487735929791e-05,10,2,8
8595,Nagasaki,8.592123914353715e-06,1.052487735929791e-05,10,4,6
8596,Nail,2.5357243747239038e-05,1.2250267090330355e-05,22,12,10
8597,Nailed,4.400843956132392e-06,3.6233184351681345e-06,4,2,2
8598,Nairobi,8.592123914353715e-06,5.348708166200577e-06,8,4,4
8599,Nakba,6.496483935243052e-06,7.074097897233022e-06,7,3,4
8600,Naked,1.278340387257504e-05,7.074097897233022e-06,11,6,5
8601,Name,0.00010918284291166549,0.0001589083942280881,158,60,98
8602,Named,2.7452883726349685e-05,3.640572332478458e-05,37,14,23
8603,Namibia,6.496483935243052e-06,3.6233184351681345e-06,8,5,3
8604,Naming,8.592123914353715e-06,1.8979287041356905e-06,7,4,3
8605,Nancy,9.660900303700153e-05,9.851975364195259e-05,107,47,60
8606,Nanjing,2.095639979110664e-07,1.2250267090330355e-05,7,0,7
8607,Nanny,8.592123914353715e-06,1.8979287041356905e-06,5,4,1
8608,Naomi,4.400843956132392e-06,8.79948762826546e-06,7,2,5
8609,Naoto,2.3052039770217305e-06,3.6233184351681345e-06,4,1,3
8610,Naple,2.095639979110664e-07,5.348708166200577e-06,3,0,3
8611,Napoleon,2.095639979110664e-07,3.6233184351681345e-06,4,2,2
8612,Napolitano,6.496483935243052e-06,1.8979287041356905e-06,4,3,1
8613,Napping,1.0687763893464371e-05,1.7253897310324457e-07,5,5,0
8614,Narco,2.3052039770217305e-06,3.6233184351681345e-06,3,1,2
8615,Narcotic,2.095639979110664e-07,1.8979287041356905e-06,3,0,3
8616,Narendra,8.592123914353715e-06,3.6233184351681345e-06,6,4,2
8617,Narrative,1.48790438516857e-05,1.2250267090330355e-05,17,8,9
8618,Narrow,1.0687763893464371e-05,1.2250267090330355e-05,12,5,7
8619,Narrowly,4.400843956132392e-06,8.79948762826546e-06,7,2,5
8620,Nasa,2.5357243747239038e-05,1.742643628342769e-05,27,13,14
8621,Nashville,4.400843956132392e-06,1.052487735929791e-05,8,2,6
8622,Nasrallah,6.496483935243052e-06,3.6233184351681345e-06,6,3,3
8623,Nassar,1.9070323809907035e-05,1.7253897310324457e-07,10,10,0
8624,Nasty,1.48790438516857e-05,7.074097897233022e-06,12,7,5
8625,Natalia,2.095639979110664e-07,7.074097897233022e-06,5,1,4
8626,Natalie,2.3052039770217305e-06,3.6233184351681345e-06,3,1,2
8627,Nate,6.496483935243052e-06,7.074097897233022e-06,7,3,4
8628,Nathan,1.0687763893464371e-05,1.742643628342769e-05,16,5,11
8629,Nation,0.0003166512008436211,0.00026933333701416437,351,168,183
8630,National,0.0005178326388382445,0.0005505718631724532,633,278,355
8631,Nationalism,8.592123914353715e-06,8.79948762826546e-06,9,4,5
8632,Nationalist,3.1644163684570994e-05,2.9504164400654783e-05,35,15,20
8633,Nationalize,4.400843956132392e-06,1.8979287041356905e-06,3,2,1
8634,Nationally,4.400843956132392e-06,5.348708166200577e-06,5,2,3
8635,Nationwide,1.278340387257504e-05,3.122955413168725e-05,27,8,19
8636,Native,6.936568330856297e-05,6.573734875233614e-05,85,35,50
8637,Nativist,4.400843956132392e-06,1.7253897310324457e-07,3,2,1
8638,Nato,6.098312339212028e-05,7.436429740749831e-05,74,29,45
8639,Natural,2.116596378901769e-05,3.2954943862719716e-05,31,12,19
8640,Naturally,2.3052039770217305e-06,5.348708166200577e-06,4,1,3
8641,Nature,4.212236358012434e-05,2.4327995207557487e-05,39,22,17
8642,Naughty,2.3052039770217305e-06,3.6233184351681345e-06,3,1,2
8643,Nauru,4.400843956132392e-06,3.6233184351681345e-06,4,2,2
8644,Navajo,1.48790438516857e-05,1.052487735929791e-05,16,9,7
8645,Naval,1.278340387257504e-05,1.052487735929791e-05,13,7,6
8646,Navalny,1.278340387257504e-05,7.074097897233022e-06,14,9,5
8647,Navarro,1.278340387257504e-05,7.074097897233022e-06,10,6,4
8648,Navi,2.3052039770217305e-06,5.348708166200577e-06,5,2,3
8649,Navient,2.095639979110664e-07,3.6233184351681345e-06,5,2,3
8650,Navigating,2.095639979110664e-07,5.348708166200577e-06,3,0,3
8651,Navigation,2.3052039770217305e-06,3.6233184351681345e-06,3,1,2
8652,Navy,0.00011337412286988677,0.0001036959228350498,127,60,67
8653,Nazca,2.3052039770217305e-06,7.074097897233022e-06,5,1,4
8654,Nazi,0.00013642616264010403,0.00016408456342118544,180,78,102
8655,Naziera,2.095639979110664e-07,5.348708166200577e-06,3,0,3
8656,Nazism,4.400843956132392e-06,5.348708166200577e-06,5,2,3
8657,Neal,2.3052039770217305e-06,3.6233184351681345e-06,3,1,2
8658,Neanderthal,1.48790438516857e-05,1.742643628342769e-05,17,7,10
8659,Near,6.307876337123095e-05,8.989280498679035e-05,92,33,59
8660,Nearby,8.592123914353715e-06,1.8979287041356905e-06,5,4,1
8661,Nearing,4.400843956132392e-06,7.074097897233022e-06,6,2,4
8662,Nearly,0.0002055822819507562,0.0001589083942280881,219,112,107
8663,Nebraska,2.5357243747239038e-05,3.122955413168725e-05,36,16,20
8664,Necessarily,4.400843956132392e-06,3.6233184351681345e-06,5,2,3
8665,Necessary,4.400843956132392e-06,8.79948762826546e-06,8,2,6
8666,Necessity,4.400843956132392e-06,1.8979287041356905e-06,3,2,1
8667,Neck,6.496483935243052e-06,5.348708166200577e-06,8,3,5
8668,Neda,8.592123914353715e-06,1.052487735929791e-05,11,4,7
8669,Need,0.0005157369988591341,0.0005402195247862584,635,283,352
8670,Needed,1.6974683830796368e-05,2.9504164400654783e-05,27,9,18
8671,Needle,2.095639979110664e-07,5.348708166200577e-06,4,0,4
8672,Needles,4.400843956132392e-06,5.348708166200577e-06,5,2,3
8673,Needy,2.3052039770217305e-06,7.074097897233022e-06,5,1,4
8674,Nefertiti,4.400843956132392e-06,3.6233184351681345e-06,6,2,4
8675,Negative,1.48790438516857e-05,1.570104655239525e-05,19,8,11
8676,Negev,6.496483935243052e-06,7.074097897233022e-06,9,5,4
8677,Neglect,6.496483935243052e-06,7.074097897233022e-06,7,3,4
8678,Neglected,6.496483935243052e-06,1.2250267090330355e-05,10,3,7
8679,Neglecting,4.400843956132392e-06,1.7253897310324457e-07,3,3,0
8680,Negotiate,8.592123914353715e-06,1.2250267090330355e-05,11,4,7
8681,Negotiating,6.496483935243052e-06,1.052487735929791e-05,10,3,7
8682,Negotiation,1.9070323809907035e-05,1.570104655239525e-05,19,10,9
8683,Negotiator,4.400843956132392e-06,8.79948762826546e-06,8,2,6
8684,Negro,2.3052039770217305e-06,5.348708166200577e-06,4,1,3
8685,Nehlen,2.3052039770217305e-06,3.6233184351681345e-06,3,1,2
8686,Neighbor,2.5357243747239038e-05,1.9151826014460126e-05,24,13,11
8687,Neighborhood,1.9070323809907035e-05,2.087721574549256e-05,21,9,12
8688,Neil,7.774824322500554e-05,7.954046660059569e-05,88,39,49
8689,Neither,3.583544364279237e-05,1.9151826014460126e-05,31,17,14
8690,Nelson,1.48790438516857e-05,3.985650278684949e-05,33,8,25
8691,Nemesi,2.3052039770217305e-06,5.348708166200577e-06,4,1,3
8692,Nemtsov,6.496483935243052e-06,7.074097897233022e-06,7,3,4
8693,NeoNazi,3.7931083621902995e-05,3.8131113055817005e-05,43,18,25
8694,Neocon,8.592123914353715e-06,7.074097897233022e-06,8,4,4
8695,Neonicotinoid,4.400843956132392e-06,1.8979287041356905e-06,4,2,2
8696,Nepal,8.613080314144832e-05,5.020884117304414e-05,77,44,33
8697,Nepalese,1.0687763893464371e-05,1.052487735929791e-05,12,5,7
8698,Nepali,8.592123914353715e-06,3.6233184351681345e-06,6,4,2
8699,Nephew,2.3052039770217305e-06,3.6233184351681345e-06,3,1,2
8700,Nepotism,8.592123914353715e-06,1.8979287041356905e-06,5,4,1
8701,Nerd,4.400843956132392e-06,1.570104655239525e-05,12,3,9
8702,Nerdy,4.400843956132392e-06,1.8979287041356905e-06,3,2,1
8703,Nerve,6.496483935243052e-06,3.6233184351681345e-06,6,3,3
8704,Nervou,4.400843956132392e-06,1.3975656821362803e-05,12,2,10
8705,Nest,2.3052039770217305e-06,5.348708166200577e-06,4,1,3
8706,Nestl,2.3052039770217305e-06,3.6233184351681345e-06,3,1,2
8707,Nestle,1.278340387257504e-05,8.79948762826546e-06,12,7,5
8708,Net,4.840928351745632e-05,0.00010714670229711469,94,27,67
8709,Netanyahu,0.00019510408205520246,0.0001847892401935746,229,103,126
8710,Netflix,4.002672360101368e-05,2.6053384938589907e-05,36,21,15
8711,Netherland,9.03220830996695e-05,8.126585633162811e-05,98,45,53
8712,Netroot,4.400843956132392e-06,3.6233184351681345e-06,4,2,2
8713,Network,8.193952318322689e-05,7.263890767646595e-05,89,43,46
8714,Networked,6.496483935243052e-06,1.8979287041356905e-06,4,3,1
8715,Networking,4.400843956132392e-06,1.2250267090330355e-05,9,2,7
8716,Neumann,4.400843956132392e-06,1.7253897310324457e-07,3,2,1
8717,Neutral,2.095639979110664e-07,5.348708166200577e-06,4,1,3
8718,Neutrality,2.116596378901769e-05,6.918812821440096e-05,56,14,42
8719,Neutron,2.3052039770217305e-06,3.6233184351681345e-06,4,2,2
8720,Nev,2.3052039770217305e-06,5.348708166200577e-06,4,1,3
8721,Nevada,5.260056347567764e-05,8.816741525575797e-05,82,30,52
8722,Never,0.00013013924270277222,0.0002141208656211263,205,70,135
8723,NeverTrump,8.592123914353715e-06,5.348708166200577e-06,10,5,5
8724,New,0.0028481842956092998,0.0024812829721977576,3115,1500,1615
8725,Newark,4.400843956132392e-06,7.074097897233022e-06,9,5,4
8726,Newborn,1.278340387257504e-05,1.3975656821362803e-05,17,6,11
8727,Newcastle,4.400843956132392e-06,1.8979287041356905e-06,3,2,1
8728,Newest,1.48790438516857e-05,1.052487735929791e-05,13,7,6
8729,Newfound,6.496483935243052e-06,1.7253897310324457e-07,3,3,0
8730,Newfoundland,6.496483935243052e-06,1.8979287041356905e-06,4,3,1
8731,Newly,2.7452883726349685e-05,2.087721574549256e-05,30,17,13
8732,Newman,1.278340387257504e-05,8.79948762826546e-06,14,8,6
8733,News,0.0009788734342425906,0.0010233286494753433,1168,514,654
8734,Newsbrief,0.00018462588215964923,0.00017961307100047735,220,102,118
8735,Newscomau,1.0687763893464371e-05,3.6233184351681345e-06,7,5,2
8736,Newsmax,4.400843956132392e-06,5.348708166200577e-06,5,2,3
8737,Newsnight,8.592123914353715e-06,1.7253897310324457e-07,4,4,0
8738,Newsom,1.48790438516857e-05,1.3975656821362803e-05,16,7,9
8739,Newspaper,5.050492349656699e-05,5.3659620635109e-05,66,28,38
8740,Newsroom,2.095639979110664e-07,7.074097897233022e-06,4,0,4
8741,Newsweek,2.095639979110664e-07,1.2250267090330355e-05,9,2,7
8742,Newt,2.326160376812834e-05,3.468033359375216e-05,33,12,21
8743,Newtown,1.278340387257504e-05,2.087721574549256e-05,20,7,13
8744,Next,0.0002097735619089774,0.0002451778807797103,270,113,157
8745,Nicaragua,1.278340387257504e-05,1.9151826014460126e-05,18,7,11
8746,Nicaraguan,8.592123914353715e-06,1.8979287041356905e-06,6,5,1
8747,Nice,2.7452883726349685e-05,3.468033359375216e-05,36,15,21
8748,Nichol,4.400843956132392e-06,1.8979287041356905e-06,3,2,1
8749,Nichola,1.0687763893464371e-05,2.2602605476525032e-05,18,5,13
8750,Nick,4.212236358012434e-05,2.6053384938589907e-05,40,24,16
8751,Nickname,6.496483935243052e-06,5.348708166200577e-06,6,3,3
8752,Nicol,4.400843956132392e-06,3.6233184351681345e-06,4,2,2
8753,Nicola,5.6791843433898893e-05,3.640572332478458e-05,54,29,25
8754,Nicole,4.400843956132392e-06,3.6233184351681345e-06,5,2,3
8755,Nicolle,2.3052039770217305e-06,3.6233184351681345e-06,3,1,2
8756,Nidal,2.095639979110664e-07,5.348708166200577e-06,3,0,3
8757,Niece,4.400843956132392e-06,3.6233184351681345e-06,4,2,2
8758,Nielsen,1.278340387257504e-05,5.348708166200577e-06,12,8,4
8759,Nieto,1.278340387257504e-05,1.742643628342769e-05,21,11,10
8760,Nigel,1.9070323809907035e-05,1.2250267090330355e-05,17,9,8
8761,Niger,2.7452883726349685e-05,2.4327995207557487e-05,28,13,15
8762,Nigeria,0.00012385232276544028,0.00017616229153841266,186,68,118
8763,Nigerian,9.451336305789087e-05,0.00011749904068330962,119,49,70
8764,Night,7.355696326678427e-05,6.573734875233614e-05,78,36,42
8765,Nightclub,8.592123914353715e-06,7.074097897233022e-06,8,4,4
8766,Nightmare,3.7931083621902995e-05,2.2602605476525032e-05,35,20,15
8767,Nighttime,2.3052039770217305e-06,3.6233184351681345e-06,3,1,2
8768,Nike,1.278340387257504e-05,2.2602605476525032e-05,20,6,14
8769,Nikki,3.1644163684570994e-05,2.9504164400654783e-05,38,17,21
8770,Nikola,4.400843956132392e-06,3.6233184351681345e-06,4,2,2
8771,Nile,2.095639979110664e-07,5.348708166200577e-06,4,1,3
8772,Nina,4.400843956132392e-06,5.348708166200577e-06,7,2,5
8773,Nine,3.7931083621902995e-05,3.2954943862719716e-05,38,18,20
8774,Nineteen,4.400843956132392e-06,1.8979287041356905e-06,3,2,1
8775,Nineteenyearold,2.095639979110664e-07,3.6233184351681345e-06,3,1,2
8776,Ninety,2.3052039770217305e-06,3.6233184351681345e-06,3,1,2
8777,Nineveh,4.400843956132392e-06,3.6233184351681345e-06,5,2,3
8778,Nino,8.592123914353715e-06,3.6233184351681345e-06,7,4,3
8779,Nintendo,1.278340387257504e-05,1.052487735929791e-05,15,7,8
8780,Nio,1.0687763893464371e-05,7.074097897233022e-06,9,5,4
8781,Nisman,8.592123914353715e-06,3.6233184351681345e-06,6,4,2
8782,Nissan,2.095639979110664e-07,7.074097897233022e-06,4,0,4
8783,Nix,8.592123914353715e-06,3.6233184351681345e-06,8,5,3
8784,Nixon,3.1644163684570994e-05,3.640572332478458e-05,46,19,27
8785,Niño,2.095639979110664e-07,3.6233184351681345e-06,3,1,2
8786,No,8.592123914353715e-06,1.052487735929791e-05,14,5,9
8787,NoFly,8.592123914353715e-06,5.348708166200577e-06,8,4,4
8788,NoGo,4.400843956132392e-06,5.348708166200577e-06,5,2,3
8789,NoShow,2.3052039770217305e-06,3.6233184351681345e-06,3,1,2
8790,Noah,1.278340387257504e-05,1.570104655239525e-05,21,6,15
8791,Noam,1.0687763893464371e-05,1.052487735929791e-05,13,6,7
8792,Nobel,0.00013223488268188294,0.00016753534288325053,178,72,106
8793,Noble,4.400843956132392e-06,1.8979287041356905e-06,3,2,1
8794,Nobody,6.517440335034157e-05,5.5385010366141504e-05,69,35,34
8795,Nod,8.592123914353715e-06,5.348708166200577e-06,7,4,3
8796,Noem,2.3052039770217305e-06,3.6233184351681345e-06,4,1,3
8797,Noise,2.3052039770217305e-06,5.348708166200577e-06,4,1,3
8798,Nokia,2.095639979110664e-07,1.570104655239525e-05,10,1,9
8799,Nominate,1.6974683830796368e-05,2.6053384938589907e-05,24,9,15
8800,Nominated,8.592123914353715e-06,1.2250267090330355e-05,13,4,9
8801,Nominating,4.400843956132392e-06,1.7253897310324457e-07,4,2,2
8802,Nomination,7.565260324589493e-05,6.573734875233614e-05,83,39,44
8803,Nominee,0.0001552869224521,0.00017098612234531542,197,83,114
8804,NonMuslim,4.400843956132392e-06,1.8979287041356905e-06,3,2,1
8805,NonProfit,2.095639979110664e-07,5.348708166200577e-06,3,0,3
8806,NonProliferation,4.400843956132392e-06,3.6233184351681345e-06,4,2,2
8807,Nondisclosure,2.3052039770217305e-06,3.6233184351681345e-06,5,2,3
8808,None,2.7452883726349685e-05,2.2602605476525032e-05,30,14,16
8809,Nonpartisan,4.400843956132392e-06,8.79948762826546e-06,7,2,5
8810,Nonprofit,2.7452883726349685e-05,3.2954943862719716e-05,36,17,19
8811,Nonsense,8.592123914353715e-06,1.3975656821362803e-05,13,4,9
8812,Nonsensical,4.400843956132392e-06,5.348708166200577e-06,5,2,3
8813,Nonviolent,6.496483935243052e-06,5.348708166200577e-06,8,3,5
8814,Noone,6.496483935243052e-06,1.8979287041356905e-06,4,3,1
8815,Noor,2.3052039770217305e-06,3.6233184351681345e-06,3,1,2
8816,Nope,8.592123914353715e-06,7.074097897233022e-06,9,4,5
8817,Nordic,6.496483935243052e-06,1.2250267090330355e-05,10,3,7
8818,Norm,2.3052039770217305e-06,5.348708166200577e-06,5,1,4
8819,Normal,1.48790438516857e-05,2.777877466962238e-05,25,7,18
8820,Normalize,4.400843956132392e-06,5.348708166200577e-06,5,2,3
8821,Normalizing,4.400843956132392e-06,1.8979287041356905e-06,3,2,1
8822,Normally,6.496483935243052e-06,8.79948762826546e-06,8,3,5
8823,Norman,8.592123914353715e-06,8.79948762826546e-06,10,4,6
8824,Normandy,4.400843956132392e-06,3.6233184351681345e-06,4,2,2
8825,Norri,8.592123914353715e-06,1.7253897310324457e-07,4,4,0
8826,North,0.0013120801909211855,0.0013131941242887934,1547,693,854
8827,Northam,6.496483935243052e-06,1.3975656821362803e-05,15,5,10
8828,Northeast,2.116596378901769e-05,1.2250267090330355e-05,18,11,7
8829,Northeastern,2.3052039770217305e-06,5.348708166200577e-06,4,1,3
8830,Northern,9.24177230787802e-05,0.00010542131256608228,117,48,69
8831,Northwest,6.496483935243052e-06,1.052487735929791e-05,9,3,6
8832,Northwestern,2.3052039770217305e-06,3.6233184351681345e-06,3,1,2
8833,Norton,2.3052039770217305e-06,8.79948762826546e-06,6,1,5
8834,Norway,0.00023282560167919462,0.00016753534288325053,239,125,114
8835,Norwegian,0.00013013924270277222,9.851975364195259e-05,133,71,62
8836,Nose,2.3052039770217305e-06,1.052487735929791e-05,10,3,7
8837,Nostalgia,4.400843956132392e-06,1.7253897310324457e-07,3,3,0
8838,Nostalgic,8.592123914353715e-06,1.8979287041356905e-06,5,4,1
8839,Not,4.400843956132392e-06,1.8979287041356905e-06,3,2,1
8840,NotSoSecret,4.400843956132392e-06,1.8979287041356905e-06,3,2,1
8841,Notch,2.3052039770217305e-06,5.348708166200577e-06,4,1,3
8842,Note,4.4218003559234974e-05,5.5385010366141504e-05,57,23,34
8843,Nothing,0.00011337412286988677,0.00011404826122124471,133,58,75
8844,Notice,1.6974683830796368e-05,1.570104655239525e-05,17,8,9
8845,Noticed,6.496483935243052e-06,1.052487735929791e-05,9,3,6
8846,Notification,4.400843956132392e-06,3.6233184351681345e-06,4,2,2
8847,Notify,2.3052039770217305e-06,5.348708166200577e-06,4,1,3
8848,Notion,2.3052039770217305e-06,5.348708166200577e-06,4,1,3
8849,Notoriou,1.278340387257504e-05,1.052487735929791e-05,14,7,7
8850,Nottingham,4.400843956132392e-06,7.074097897233022e-06,6,2,4
8851,Nouri,2.3052039770217305e-06,1.8979287041356905e-06,3,1,2
8852,Nouriel,2.3052039770217305e-06,1.8979287041356905e-06,3,1,2
8853,Nov,3.3739803663681634e-05,2.777877466962238e-05,36,18,18
8854,Novak,2.095639979110664e-07,5.348708166200577e-06,3,0,3
8855,Novarti,1.0687763893464371e-05,7.074097897233022e-06,11,7,4
8856,Novel,6.496483935243052e-06,3.6233184351681345e-06,5,3,2
8857,Novelist,2.095639979110664e-07,3.6233184351681345e-06,3,0,3
8858,November,0.00014900000251476814,0.00021239547589009395,218,83,135
8859,Novum,1.0687763893464371e-05,1.8979287041356905e-06,7,5,2
8860,Now,6.496483935243052e-06,5.348708166200577e-06,6,3,3
8861,Nowaday,2.095639979110664e-07,7.074097897233022e-06,4,0,4
8862,Nowhere,1.0687763893464371e-05,1.570104655239525e-05,15,6,9
8863,Nuclear,0.00021396484186719832,0.0002192970348142235,251,109,142
8864,Nugent,2.3052039770217305e-06,5.348708166200577e-06,4,1,3
8865,Nuisance,2.095639979110664e-07,5.348708166200577e-06,4,0,4
8866,Nuke,3.7931083621902995e-05,2.087721574549256e-05,35,20,15
8867,Number,0.00011337412286988677,0.00011059748175917965,133,61,72
8868,Numerou,2.3052039770217305e-06,8.79948762826546e-06,6,1,5
8869,Nun,1.9070323809907035e-05,1.052487735929791e-05,18,10,8
8870,Nunberg,2.095639979110664e-07,7.074097897233022e-06,4,0,4
8871,Nune,4.002672360101368e-05,2.9504164400654783e-05,36,19,17
8872,Nunn,2.095639979110664e-07,1.052487735929791e-05,6,0,6
8873,Nuri,2.3052039770217305e-06,3.6233184351681345e-06,3,1,2
8874,Nurse,2.5357243747239038e-05,1.742643628342769e-05,25,12,13
8875,Nursing,6.496483935243052e-06,5.348708166200577e-06,8,3,5
8876,Nusra,1.0687763893464371e-05,3.6233184351681345e-06,7,5,2
8877,Nut,4.400843956132392e-06,8.79948762826546e-06,8,2,6
8878,Nutella,2.3052039770217305e-06,7.074097897233022e-06,5,1,4
8879,Nutrition,6.496483935243052e-06,1.052487735929791e-05,10,4,6
8880,Nutshell,6.496483935243052e-06,1.7253897310324457e-07,3,3,0
8881,Nutt,8.592123914353715e-06,8.79948762826546e-06,10,4,6
8882,Nye,1.48790438516857e-05,3.6233184351681345e-06,10,7,3
8883,OBrien,1.278340387257504e-05,3.6233184351681345e-06,8,6,2
8884,OConnor,4.400843956132392e-06,5.348708166200577e-06,5,2,3
8885,ODonnell,6.496483935243052e-06,5.348708166200577e-06,6,3,3
8886,ODwyer,6.496483935243052e-06,8.79948762826546e-06,8,3,5
8887,OECD,1.6974683830796368e-05,1.9151826014460126e-05,19,8,11
8888,OHare,2.3052039770217305e-06,3.6233184351681345e-06,3,1,2
8889,OK,0.00010289592297433347,9.334358444885519e-05,116,54,62
8890,OKeefe,2.3052039770217305e-06,5.348708166200577e-06,4,1,3
8891,OMG,1.278340387257504e-05,1.8979287041356905e-06,9,8,1
8892,OMalley,2.326160376812834e-05,1.3975656821362803e-05,26,16,10
8893,ONE,4.400843956132392e-06,3.6233184351681345e-06,4,2,2
8894,ONLINE,1.0687763893464371e-05,3.6233184351681345e-06,8,6,2
8895,OPEC,1.9070323809907035e-05,1.052487735929791e-05,16,10,6
8896,OReilly,4.400843956132392e-06,2.2602605476525032e-05,15,2,13
8897,ORourke,4.400843956132392e-06,1.742643628342769e-05,15,4,11
8898,OSCE,6.496483935243052e-06,7.074097897233022e-06,7,3,4
8899,Oakland,1.0687763893464371e-05,1.052487735929791e-05,11,5,6
8900,Oath,1.9070323809907035e-05,1.9151826014460126e-05,23,12,11
8901,Oaxaca,4.400843956132392e-06,1.7253897310324457e-07,4,2,2
8902,Obama,0.0017856948262001953,0.0018325364333295585,2157,974,1183
8903,ObamaEra,4.400843956132392e-06,1.3975656821362803e-05,11,2,9
8904,Obamacare,0.00043191139969470744,0.00044704847931050624,515,226,289
8905,Obamaera,1.48790438516857e-05,1.742643628342769e-05,18,7,11
8906,Obergefell,2.095639979110664e-07,5.348708166200577e-06,3,0,3
8907,Obese,6.496483935243052e-06,8.79948762826546e-06,8,3,5
8908,Obesity,4.400843956132392e-06,7.074097897233022e-06,7,2,5
8909,Obey,8.592123914353715e-06,1.7253897310324457e-07,4,4,0
8910,Obituary,2.095639979110664e-07,8.79948762826546e-06,6,1,5
8911,Object,4.400843956132392e-06,8.79948762826546e-06,10,5,5
8912,Objection,8.592123914353715e-06,1.8979287041356905e-06,5,4,1
8913,Obligation,6.496483935243052e-06,5.348708166200577e-06,6,3,3
8914,Obnoxiou,4.400843956132392e-06,3.6233184351681345e-06,4,2,2
8915,Observation,4.400843956132392e-06,7.074097897233022e-06,6,2,4
8916,Observatory,4.400843956132392e-06,7.074097897233022e-06,6,2,4
8917,Observe,6.496483935243052e-06,1.7253897310324457e-07,3,3,0
8918,Observer,1.6974683830796368e-05,8.79948762826546e-06,14,9,5
8919,Obsessed,1.6974683830796368e-05,7.074097897233022e-06,13,8,5
8920,Obsession,1.0687763893464371e-05,1.742643628342769e-05,17,5,12
8921,Obsolete,4.400843956132392e-06,1.8979287041356905e-06,3,2,1
8922,Obstacle,1.0687763893464371e-05,1.2250267090330355e-05,15,5,10
8923,Obstruct,4.400843956132392e-06,1.8979287041356905e-06,3,2,1
8924,Obstruction,1.9070323809907035e-05,1.570104655239525e-05,18,9,9
8925,Obtain,4.400843956132392e-06,7.074097897233022e-06,7,3,4
8926,Obtained,4.400843956132392e-06,5.348708166200577e-06,5,2,3
8927,Obviou,4.400843956132392e-06,8.79948762826546e-06,7,2,5
8928,Obviously,6.496483935243052e-06,5.348708166200577e-06,9,4,5
8929,OcasioCortez,1.0687763893464371e-05,1.742643628342769e-05,17,7,10
8930,Occidental,6.496483935243052e-06,5.348708166200577e-06,6,3,3
8931,Occupation,1.48790438516857e-05,1.2250267090330355e-05,15,8,7
8932,Occupied,6.496483935243052e-06,7.074097897233022e-06,7,3,4
8933,Occupier,4.400843956132392e-06,1.8979287041356905e-06,4,3,1
8934,Occupy,4.212236358012434e-05,5.1934230904076595e-05,53,20,33
8935,Occur,2.095639979110664e-07,3.6233184351681345e-06,3,1,2
8936,Ocean,9.03220830996695e-05,8.299124606266055e-05,99,47,52
8937,Oceania,2.3052039770217305e-06,3.6233184351681345e-06,3,1,2
8938,Oceti,2.3052039770217305e-06,3.6233184351681345e-06,3,1,2
8939,Oct,2.116596378901769e-05,3.985650278684949e-05,39,15,24
8940,October,9.24177230787802e-05,0.00013130215853156914,131,49,82
8941,Oculu,2.3052039770217305e-06,3.6233184351681345e-06,3,1,2
8942,Odd,1.6974683830796368e-05,2.6053384938589907e-05,26,11,15
8943,Oddly,6.496483935243052e-06,1.7253897310324457e-07,4,3,1
8944,Odin,2.3052039770217305e-06,5.348708166200577e-06,4,1,3
8945,OffDuty,2.3052039770217305e-06,3.6233184351681345e-06,3,1,2
8946,Offend,6.496483935243052e-06,3.6233184351681345e-06,5,3,2
8947,Offended,2.095639979110664e-07,7.074097897233022e-06,5,0,5
8948,Offender,1.6974683830796368e-05,5.348708166200577e-06,15,8,7
8949,Offending,2.3052039770217305e-06,5.348708166200577e-06,4,1,3
8950,Offense,8.592123914353715e-06,8.79948762826546e-06,10,4,6
8951,Offensive,2.5357243747239038e-05,2.777877466962238e-05,31,14,17
8952,Offer,0.0001552869224521,0.00013130215853156914,161,78,83
8953,Offered,1.9070323809907035e-05,1.9151826014460126e-05,22,10,12
8954,Offering,1.278340387257504e-05,2.6053384938589907e-05,28,8,20
8955,Office,0.00019510408205520246,0.00022792398346938586,254,109,145
8956,Officer,0.00014480872255654665,0.00017271151207634748,188,80,108
8957,Official,0.0004444852395693713,0.00035732821329681935,464,230,234
8958,Officially,3.1644163684570994e-05,4.6758061710979285e-05,46,17,29
8959,Offshore,1.278340387257504e-05,3.640572332478458e-05,30,7,23
8960,Offshoring,4.400843956132392e-06,5.348708166200577e-06,5,2,3
8961,Ofsted,2.095639979110664e-07,5.348708166200577e-06,3,0,3
8962,Often,3.1644163684570994e-05,3.640572332478458e-05,40,17,23
8963,Oh,4.6313643538345614e-05,4.8483451442011706e-05,56,22,34
8964,Ohio,0.00013223488268188294,0.0001571830044970555,178,69,109
8965,Oil,0.0002956948010525145,0.0002469032705107427,315,151,164
8966,OilRich,6.496483935243052e-06,1.7253897310324457e-07,3,3,0
8967,Ok,6.496483935243052e-06,3.6233184351681345e-06,6,4,2
8968,Okay,6.496483935243052e-06,7.074097897233022e-06,9,4,5
8969,Okinawa,2.116596378901769e-05,2.6053384938589907e-05,27,10,17
8970,Oklahoma,5.888748341300963e-05,9.161819471782287e-05,90,32,58
8971,Oklahoman,2.095639979110664e-07,5.348708166200577e-06,3,0,3
8972,Oktoberfest,2.095639979110664e-07,8.79948762826546e-06,6,0,6
8973,Olbermann,4.400843956132392e-06,7.074097897233022e-06,6,2,4
8974,Old,0.00011127848289077625,9.334358444885519e-05,119,58,61
8975,Older,2.7452883726349685e-05,7.074097897233022e-06,17,13,4
8976,Oldest,2.116596378901769e-05,2.4327995207557487e-05,26,10,16
8977,Oleg,8.592123914353715e-06,1.7253897310324457e-07,4,4,0
8978,Oligarch,8.592123914353715e-06,7.074097897233022e-06,8,4,4
8979,Olive,1.0687763893464371e-05,7.074097897233022e-06,10,5,5
8980,Oliver,1.278340387257504e-05,2.087721574549256e-05,20,6,14
8981,Olivia,4.400843956132392e-06,1.8979287041356905e-06,4,3,1
8982,Ollove,2.095639979110664e-07,5.348708166200577e-06,4,1,3
8983,Olmert,6.496483935243052e-06,1.570104655239525e-05,15,3,12
8984,Olson,4.400843956132392e-06,3.6233184351681345e-06,5,3,2
8985,Olympian,1.6974683830796368e-05,1.052487735929791e-05,17,10,7
8986,Olympic,0.00020139100199253443,0.00023482554239351563,261,104,157
8987,Omaha,8.592123914353715e-06,1.7253897310324457e-07,4,4,0
8988,Oman,4.400843956132392e-06,1.052487735929791e-05,8,2,6
8989,Omar,2.5357243747239038e-05,2.9504164400654783e-05,32,12,20
8990,Omarosa,6.496483935243052e-06,7.074097897233022e-06,9,5,4
8991,Omidyar,2.095639979110664e-07,5.348708166200577e-06,4,1,3
8992,Omit,2.3052039770217305e-06,3.6233184351681345e-06,3,1,2
8993,Omnibu,6.496483935243052e-06,1.8979287041356905e-06,4,3,1
8994,On,2.3052039770217305e-06,5.348708166200577e-06,4,1,3
8995,OnAir,2.095639979110664e-07,5.348708166200577e-06,3,0,3
8996,Onboarding,1.48790438516857e-05,3.6233184351681345e-06,9,7,2
8997,One,0.0008803783552243891,0.0009267068245375264,1072,468,604
8998,OneChild,6.496483935243052e-06,1.8979287041356905e-06,4,3,1
8999,OneThird,8.592123914353715e-06,7.074097897233022e-06,8,4,4
9000,OneTime,2.3052039770217305e-06,1.8979287041356905e-06,3,1,2
9001,Onethird,2.095639979110664e-07,5.348708166200577e-06,4,0,4
9002,Ongoing,6.496483935243052e-06,1.052487735929791e-05,9,3,6
9003,Onion,1.6974683830796368e-05,2.2602605476525032e-05,24,8,16
9004,Online,0.0001531912824729893,0.00012440059960743937,159,77,82
9005,Ontario,4.212236358012434e-05,3.2954943862719716e-05,44,21,23
9006,Onto,4.400843956132392e-06,1.052487735929791e-05,11,4,7
9007,Oop,1.278340387257504e-05,1.3975656821362803e-05,15,7,8
9008,Op,6.496483935243052e-06,1.052487735929791e-05,10,4,6
9009,OpEd,1.6974683830796368e-05,1.9151826014460126e-05,21,9,12
9010,Opec,4.400843956132392e-06,5.348708166200577e-06,5,2,3
9011,Open,0.00020139100199253443,0.0001968669683108019,227,104,123
9012,Opened,4.400843956132392e-06,3.6233184351681345e-06,4,2,2
9013,Opening,2.5357243747239038e-05,2.4327995207557487e-05,30,13,17
9014,Openly,1.48790438516857e-05,1.2250267090330355e-05,15,8,7
9015,Operating,2.3052039770217305e-06,3.6233184351681345e-06,6,2,4
9016,Operation,6.936568330856297e-05,4.330728224891437e-05,66,37,29
9017,Operative,1.278340387257504e-05,1.570104655239525e-05,16,7,9
9018,Operator,8.592123914353715e-06,1.052487735929791e-05,11,4,7
9019,Opinion,3.7931083621902995e-05,3.122955413168725e-05,39,19,20
9020,Opioid,4.4218003559234974e-05,7.091351794543343e-05,69,25,44
9021,Opium,4.400843956132392e-06,1.052487735929791e-05,8,2,6
9022,Opponent,7.146132328767358e-05,7.091351794543343e-05,82,37,45
9023,Opportunity,3.583544364279237e-05,3.468033359375216e-05,43,20,23
9024,Oppose,3.583544364279237e-05,6.918812821440096e-05,61,19,42
9025,Opposed,2.326160376812834e-05,1.3975656821362803e-05,22,11,11
9026,Opposing,1.6974683830796368e-05,1.742643628342769e-05,19,9,10
9027,Opposition,8.613080314144832e-05,5.020884117304414e-05,75,43,32
9028,Oppressed,2.095639979110664e-07,5.348708166200577e-06,3,0,3
9029,Oppression,2.3052039770217305e-06,3.6233184351681345e-06,3,1,2
9030,Oprah,1.0687763893464371e-05,2.087721574549256e-05,20,7,13
9031,Optimism,4.400843956132392e-06,8.79948762826546e-06,8,2,6
9032,Optimistic,6.496483935243052e-06,7.074097897233022e-06,8,3,5
9033,Option,2.954852370546031e-05,4.1581892517881935e-05,41,15,26
9034,Opus,1.0687763893464371e-05,5.348708166200577e-06,10,6,4
9035,Oracle,6.496483935243052e-06,3.6233184351681345e-06,5,3,2
9036,Orange,3.3739803663681634e-05,4.6758061710979285e-05,51,19,32
9037,Orangutan,6.496483935243052e-06,8.79948762826546e-06,8,3,5
9038,Orban,6.496483935243052e-06,5.348708166200577e-06,6,3,3
9039,Orbit,8.592123914353715e-06,1.8979287041356905e-06,8,6,2
9040,Orca,2.3052039770217305e-06,3.6233184351681345e-06,4,2,2
9041,Ordeal,4.400843956132392e-06,1.7253897310324457e-07,3,2,1
9042,Order,0.00023282560167919462,0.0001968669683108019,245,117,128
9043,Ordered,3.7931083621902995e-05,2.087721574549256e-05,33,19,14
9044,Ordering,8.592123914353715e-06,3.6233184351681345e-06,6,4,2
9045,Ordinance,6.496483935243052e-06,1.7253897310324457e-07,3,3,0
9046,Ordinary,1.278340387257504e-05,1.3975656821362803e-05,16,8,8
9047,Ore,8.592123914353715e-06,1.7253897310324457e-07,4,4,0
9048,Oregon,0.00010499156295344414,6.746273848336857e-05,105,57,48
9049,Org,2.095639979110664e-07,5.348708166200577e-06,4,1,3
9050,Organ,1.278340387257504e-05,7.074097897233022e-06,10,6,4
9051,Organic,1.0687763893464371e-05,1.2250267090330355e-05,12,5,7
9052,Organisation,1.278340387257504e-05,2.087721574549256e-05,22,8,14
9053,Organised,4.400843956132392e-06,1.8979287041356905e-06,5,2,3
9054,Organization,6.72700433294523e-05,9.679436391092026e-05,95,37,58
9055,Organizational,4.400843956132392e-06,5.348708166200577e-06,5,2,3
9056,Organize,1.0687763893464371e-05,3.6233184351681345e-06,7,5,2
9057,Organized,1.6974683830796368e-05,1.052487735929791e-05,16,8,8
9058,Organizer,1.0687763893464371e-05,8.79948762826546e-06,11,6,5
9059,Organizing,8.592123914353715e-06,1.2250267090330355e-05,15,6,9
9060,Origin,1.0687763893464371e-05,1.052487735929791e-05,13,5,8
9061,Original,1.278340387257504e-05,5.348708166200577e-06,10,6,4
9062,Originally,4.400843956132392e-06,8.79948762826546e-06,9,4,5
9063,Orion,8.592123914353715e-06,3.6233184351681345e-06,7,4,3
9064,Orlando,9.24177230787802e-05,4.1581892517881935e-05,75,44,31
9065,Orlean,2.954852370546031e-05,2.9504164400654783e-05,35,16,19
9066,Oroville,2.095639979110664e-07,3.6233184351681345e-06,3,0,3
9067,Orphan,6.496483935243052e-06,7.074097897233022e-06,8,4,4
9068,Orphaned,6.496483935243052e-06,5.348708166200577e-06,8,3,5
9069,Orrin,4.400843956132392e-06,2.6053384938589907e-05,19,3,16
9070,Ortega,2.095639979110664e-07,8.79948762826546e-06,5,0,5
9071,Orthodox,3.583544364279237e-05,2.2602605476525032e-05,32,18,14
9072,Ortiz,4.400843956132392e-06,1.052487735929791e-05,8,2,6
9073,Orwell,8.592123914353715e-06,1.570104655239525e-05,16,6,10
9074,Orwellian,4.400843956132392e-06,5.348708166200577e-06,6,2,4
9075,Osaka,6.496483935243052e-06,5.348708166200577e-06,6,3,3
9076,Osama,0.00010080028299522283,5.020884117304414e-05,89,51,38
9077,Osborne,4.400843956132392e-06,7.074097897233022e-06,7,2,5
9078,Oscar,3.583544364279237e-05,2.087721574549256e-05,36,20,16
9079,Oscarwinning,4.400843956132392e-06,5.348708166200577e-06,6,3,3
9080,Oslo,4.6313643538345614e-05,1.742643628342769e-05,44,30,14
9081,Ossetia,4.212236358012434e-05,2.2602605476525032e-05,36,20,16
9082,Ossetian,4.400843956132392e-06,5.348708166200577e-06,5,2,3
9083,Ossoff,2.5357243747239038e-05,1.570104655239525e-05,21,12,9
9084,Ostrovsky,2.3052039770217305e-06,5.348708166200577e-06,4,1,3
9085,Oswald,4.400843956132392e-06,3.6233184351681345e-06,4,2,2
9086,Other,5.888748341300963e-05,7.608968713853079e-05,85,33,52
9087,Otherwise,1.6974683830796368e-05,1.570104655239525e-05,17,8,9
9088,Ottawa,2.326160376812834e-05,2.2602605476525032e-05,28,12,16
9089,Otto,1.48790438516857e-05,3.6233184351681345e-06,10,7,3
9090,Ottoman,1.278340387257504e-05,8.79948762826546e-06,11,6,5
9091,Ouch,1.0687763893464371e-05,3.6233184351681345e-06,10,6,4
9092,Our,1.6974683830796368e-05,8.79948762826546e-06,14,8,6
9093,Oust,8.592123914353715e-06,1.2250267090330355e-05,12,5,7
9094,Ousted,1.0687763893464371e-05,8.79948762826546e-06,10,5,5
9095,Ouster,8.592123914353715e-06,1.8979287041356905e-06,6,5,1
9096,Ousting,6.496483935243052e-06,1.8979287041356905e-06,4,3,1
9097,Out,4.400843956132392e-06,1.8979287041356905e-06,3,2,1
9098,Outage,1.278340387257504e-05,8.79948762826546e-06,11,6,5
9099,Outbreak,4.002672360101368e-05,2.087721574549256e-05,33,20,13
9100,Outburst,4.400843956132392e-06,3.6233184351681345e-06,4,2,2
9101,Outcome,8.592123914353715e-06,1.2250267090330355e-05,11,4,7
9102,Outcry,8.592123914353715e-06,8.79948762826546e-06,13,4,9
9103,Outdated,4.400843956132392e-06,3.6233184351681345e-06,4,2,2
9104,Outdoor,1.278340387257504e-05,1.742643628342769e-05,16,6,10
9105,Outgoing,2.3052039770217305e-06,5.348708166200577e-06,5,2,3
9106,Outing,4.400843956132392e-06,5.348708166200577e-06,5,2,3
9107,Outlaw,2.095639979110664e-07,7.074097897233022e-06,4,0,4
9108,Outlawed,4.400843956132392e-06,5.348708166200577e-06,5,2,3
9109,Outlet,4.400843956132392e-06,1.2250267090330355e-05,9,2,7
9110,Outline,4.400843956132392e-06,1.7253897310324457e-07,3,2,1
9111,Outlook,6.496483935243052e-06,5.348708166200577e-06,6,3,3
9112,Outperform,2.3052039770217305e-06,3.6233184351681345e-06,5,2,3
9113,Outpost,6.496483935243052e-06,1.8979287041356905e-06,4,3,1
9114,Output,6.496483935243052e-06,1.8979287041356905e-06,4,3,1
9115,Outrage,3.7931083621902995e-05,3.122955413168725e-05,46,23,23
9116,Outraged,1.9070323809907035e-05,1.570104655239525e-05,21,10,11
9117,Outrageou,1.6974683830796368e-05,1.3975656821362803e-05,17,8,9
9118,Outreach,6.496483935243052e-06,8.79948762826546e-06,8,3,5
9119,Outside,5.050492349656699e-05,6.573734875233614e-05,67,28,39
9120,Outsider,6.496483935243052e-06,2.087721574549256e-05,15,3,12
9121,Outsource,4.400843956132392e-06,3.6233184351681345e-06,4,2,2
9122,Outsourcing,8.592123914353715e-06,3.6233184351681345e-06,7,5,2
9123,Outspoken,8.592123914353715e-06,1.8979287041356905e-06,6,4,2
9124,Oval,1.0687763893464371e-05,2.777877466962238e-05,21,5,16
9125,Oven,2.095639979110664e-07,5.348708166200577e-06,3,0,3
9126,Overall,2.3052039770217305e-06,7.074097897233022e-06,7,1,6
9127,Overcame,4.400843956132392e-06,1.8979287041356905e-06,4,3,1
9128,Overcome,1.0687763893464371e-05,1.052487735929791e-05,14,6,8
9129,Overcoming,6.496483935243052e-06,1.8979287041356905e-06,5,4,1
9130,Overdose,2.326160376812834e-05,1.2250267090330355e-05,21,13,8
9131,Overdraft,6.496483935243052e-06,5.348708166200577e-06,6,3,3
9132,Overdue,2.3052039770217305e-06,1.8979287041356905e-06,3,1,2
9133,Overfishing,1.0687763893464371e-05,3.6233184351681345e-06,8,5,3
9134,Overhaul,1.6974683830796368e-05,1.570104655239525e-05,18,8,10
9135,Overlook,2.3052039770217305e-06,3.6233184351681345e-06,3,1,2
9136,Overlooked,8.592123914353715e-06,1.8979287041356905e-06,7,5,2
9137,Overnight,1.6974683830796368e-05,7.074097897233022e-06,15,9,6
9138,Overreach,2.3052039770217305e-06,3.6233184351681345e-06,5,1,4
9139,Override,1.0687763893464371e-05,1.8979287041356905e-06,6,5,1
9140,Overrule,4.400843956132392e-06,1.8979287041356905e-06,4,2,2
9141,Oversea,1.48790438516857e-05,8.79948762826546e-06,14,8,6
9142,Oversee,6.496483935243052e-06,1.8979287041356905e-06,4,3,1
9143,Overseeing,6.496483935243052e-06,1.8979287041356905e-06,5,4,1
9144,Oversight,3.1644163684570994e-05,2.9504164400654783e-05,35,15,20
9145,Overspending,4.400843956132392e-06,5.348708166200577e-06,5,2,3
9146,Overtake,4.400843956132392e-06,7.074097897233022e-06,6,2,4
9147,Overthrow,2.095639979110664e-07,3.6233184351681345e-06,3,1,2
9148,Overtime,1.0687763893464371e-05,1.3975656821362803e-05,15,6,9
9149,Overturn,2.326160376812834e-05,2.2602605476525032e-05,26,11,15
9150,Overturned,8.592123914353715e-06,5.348708166200577e-06,8,4,4
9151,Overturning,4.400843956132392e-06,1.7253897310324457e-07,3,3,0
9152,Overweight,4.400843956132392e-06,1.8979287041356905e-06,3,2,1
9153,Overwhelm,4.400843956132392e-06,1.8979287041356905e-06,5,3,2
9154,Overwhelmed,2.3052039770217305e-06,1.052487735929791e-05,7,1,6
9155,Overwhelming,4.400843956132392e-06,5.348708166200577e-06,6,2,4
9156,Overwhelmingly,1.278340387257504e-05,1.3975656821362803e-05,16,7,9
9157,Owe,1.48790438516857e-05,2.777877466962238e-05,23,7,16
9158,Owed,2.3052039770217305e-06,3.6233184351681345e-06,4,2,2
9159,Owen,4.400843956132392e-06,5.348708166200577e-06,5,2,3
9160,Own,6.496483935243052e-06,5.348708166200577e-06,8,4,4
9161,Owned,1.0687763893464371e-05,1.3975656821362803e-05,14,5,9
9162,Owner,6.72700433294523e-05,7.608968713853079e-05,85,38,47
9163,Ownership,4.400843956132392e-06,1.052487735929791e-05,8,2,6
9164,Owning,6.496483935243052e-06,5.348708166200577e-06,7,4,3
9165,Oxfam,2.326160376812834e-05,1.2250267090330355e-05,22,13,9
9166,Oxford,1.9070323809907035e-05,1.9151826014460126e-05,21,9,12
9167,OxyContin,2.095639979110664e-07,8.79948762826546e-06,5,0,5
9168,Oxygen,2.3052039770217305e-06,3.6233184351681345e-06,5,2,3
9169,Oz,1.48790438516857e-05,1.052487735929791e-05,14,7,7
9170,Ozone,4.400843956132392e-06,3.6233184351681345e-06,5,2,3
9171,P2P,2.095639979110664e-07,7.074097897233022e-06,6,0,6
9172,PA,6.496483935243052e-06,1.570104655239525e-05,13,3,10
9173,PAC,0.0001154697628489974,9.679436391092026e-05,132,60,72
9174,PAKISTAN,8.592123914353715e-06,5.348708166200577e-06,7,4,3
9175,PARK,4.400843956132392e-06,1.8979287041356905e-06,3,2,1
9176,PB,1.48790438516857e-05,8.79948762826546e-06,12,7,5
9177,PC,6.496483935243052e-06,1.3975656821362803e-05,13,4,9
9178,PDF,4.400843956132392e-06,7.074097897233022e-06,8,2,6
9179,PFC,4.400843956132392e-06,1.8979287041356905e-06,3,2,1
9180,PGE,4.400843956132392e-06,3.6233184351681345e-06,4,2,2
9181,PGP,4.400843956132392e-06,1.8979287041356905e-06,3,2,1
9182,PHOTO,2.7452883726349685e-05,5.020884117304414e-05,45,15,30
9183,PIC,1.9070323809907035e-05,1.9151826014460126e-05,21,9,12
9184,PIN,6.496483935243052e-06,3.6233184351681345e-06,5,3,2
9185,PKK,1.6974683830796368e-05,1.052487735929791e-05,16,9,7
9186,PLA,4.400843956132392e-06,1.8979287041356905e-06,3,2,1
9187,PLO,6.496483935243052e-06,1.052487735929791e-05,9,3,6
9188,PM,0.00029150352109429334,0.00029693957271068364,356,153,203
9189,PNC,4.400843956132392e-06,1.8979287041356905e-06,3,2,1
9190,PNG,2.3052039770217305e-06,5.348708166200577e-06,4,1,3
9191,POLICE,4.400843956132392e-06,3.6233184351681345e-06,4,2,2
9192,POLL,6.496483935243052e-06,5.348708166200577e-06,6,3,3
9193,POTU,4.400843956132392e-06,1.2250267090330355e-05,11,4,7
9194,POW,2.3052039770217305e-06,1.052487735929791e-05,8,1,7
9195,PR,5.050492349656699e-05,3.468033359375216e-05,46,25,21
9196,PRISM,1.0687763893464371e-05,1.8979287041356905e-06,8,7,1
9197,PSA,6.496483935243052e-06,1.2250267090330355e-05,12,5,7
9198,PTSD,1.278340387257504e-05,1.3975656821362803e-05,14,6,8
9199,Pa,4.400843956132392e-06,3.6233184351681345e-06,4,2,2
9200,Pablo,4.400843956132392e-06,1.8979287041356905e-06,3,2,1
9201,Pace,1.0687763893464371e-05,1.570104655239525e-05,15,5,10
9202,Pacific,0.00011966104280721883,0.00011922443041434203,131,59,72
9203,Pack,6.496483935243052e-06,1.2250267090330355e-05,11,4,7
9204,Package,1.9070323809907035e-05,1.570104655239525e-05,21,10,11
9205,Packard,2.3052039770217305e-06,3.6233184351681345e-06,3,1,2
9206,Packer,8.592123914353715e-06,3.6233184351681345e-06,6,4,2
9207,Pact,2.5357243747239038e-05,2.777877466962238e-05,32,13,19
9208,Pad,4.400843956132392e-06,3.6233184351681345e-06,5,2,3
9209,Paedophile,2.3052039770217305e-06,5.348708166200577e-06,5,1,4
9210,Pagan,2.3052039770217305e-06,7.074097897233022e-06,5,1,4
9211,Page,1.9070323809907035e-05,3.985650278684949e-05,38,13,25
9212,Pai,4.400843956132392e-06,8.79948762826546e-06,7,2,5
9213,Paid,9.03220830996695e-05,8.989280498679035e-05,110,51,59
9214,Pain,1.0687763893464371e-05,2.2602605476525032e-05,18,5,13
9215,Painfully,6.496483935243052e-06,1.8979287041356905e-06,5,3,2
9216,Paint,8.592123914353715e-06,7.074097897233022e-06,8,4,4
9217,Painter,2.3052039770217305e-06,1.8979287041356905e-06,3,1,2
9218,Painting,1.278340387257504e-05,8.79948762826546e-06,11,6,5
9219,Pair,8.592123914353715e-06,7.074097897233022e-06,9,4,5
9220,Pajama,4.400843956132392e-06,1.8979287041356905e-06,3,2,1
9221,Pak,1.278340387257504e-05,1.8979287041356905e-06,9,7,2
9222,Pakistan,0.0007085358769373152,0.0006075097242965237,758,362,396
9223,Pakistani,0.00023282560167919462,0.00022274781427628854,261,119,142
9224,Pal,2.3052039770217305e-06,1.2250267090330355e-05,8,1,7
9225,Palace,1.278340387257504e-05,1.2250267090330355e-05,16,8,8
9226,Palantir,2.3052039770217305e-06,3.6233184351681345e-06,3,1,2
9227,Palau,6.496483935243052e-06,3.6233184351681345e-06,5,3,2
9228,Pale,2.3052039770217305e-06,3.6233184351681345e-06,3,1,2
9229,Paleontologist,4.400843956132392e-06,1.8979287041356905e-06,3,2,1
9230,Palestina,2.3052039770217305e-06,3.6233184351681345e-06,3,1,2
9231,Palestine,8.193952318322689e-05,0.0001019705331040174,113,46,67
9232,Palestinian,0.0008719957953079463,0.0008921990299168768,1028,455,573
9233,Palin,4.6313643538345614e-05,3.640572332478458e-05,45,23,22
9234,Palm,2.116596378901769e-05,1.570104655239525e-05,21,10,11
9235,Palmer,1.48790438516857e-05,8.79948762826546e-06,12,7,5
9236,Palmyra,1.48790438516857e-05,1.3975656821362803e-05,16,7,9
9237,Palsy,2.3052039770217305e-06,8.79948762826546e-06,8,3,5
9238,Pam,6.496483935243052e-06,3.6233184351681345e-06,5,3,2
9239,Pan,1.0687763893464371e-05,1.052487735929791e-05,11,5,6
9240,Panama,0.0001154697628489974,5.3659620635109e-05,89,56,33
9241,Panamanian,4.400843956132392e-06,1.7253897310324457e-07,3,3,0
9242,Panasonic,8.592123914353715e-06,1.8979287041356905e-06,5,4,1
9243,Panda,1.6974683830796368e-05,8.79948762826546e-06,14,8,6
9244,Pandemic,1.0687763893464371e-05,2.9504164400654783e-05,24,5,19
9245,Pandora,2.095639979110664e-07,1.052487735929791e-05,6,0,6
9246,Panel,6.307876337123095e-05,6.401195902130366e-05,77,34,43
9247,Panic,1.48790438516857e-05,2.4327995207557487e-05,27,10,17
9248,Panorama,1.48790438516857e-05,1.7253897310324457e-07,7,7,0
9249,Pant,6.496483935243052e-06,7.074097897233022e-06,8,3,5
9250,Panther,4.400843956132392e-06,5.348708166200577e-06,5,2,3
9251,Pantry,4.400843956132392e-06,1.8979287041356905e-06,3,2,1
9252,Pao,4.400843956132392e-06,3.6233184351681345e-06,4,2,2
9253,Paolo,4.400843956132392e-06,5.348708166200577e-06,5,2,3
9254,Papa,8.592123914353715e-06,1.7253897310324457e-07,6,4,2
9255,Papadopoulo,2.3052039770217305e-06,3.6233184351681345e-06,6,3,3
9256,Papal,4.400843956132392e-06,1.8979287041356905e-06,3,2,1
9257,Papandreou,4.400843956132392e-06,8.79948762826546e-06,7,2,5
9258,Paper,0.00012385232276544028,6.746273848336857e-05,106,63,43
9259,Paperwork,4.400843956132392e-06,1.8979287041356905e-06,5,4,1
9260,Papua,2.5357243747239038e-05,2.777877466962238e-05,30,13,17
9261,Papuan,6.496483935243052e-06,1.7253897310324457e-07,3,3,0
9262,Parachute,4.400843956132392e-06,3.6233184351681345e-06,4,2,2
9263,Parade,2.326160376812834e-05,1.570104655239525e-05,24,13,11
9264,Paradigm,4.400843956132392e-06,3.6233184351681345e-06,4,2,2
9265,Paradise,1.278340387257504e-05,7.074097897233022e-06,12,7,5
9266,Paradox,4.400843956132392e-06,5.348708166200577e-06,6,2,4
9267,Paraguay,6.496483935243052e-06,8.79948762826546e-06,11,4,7
9268,Paraguayan,4.400843956132392e-06,1.7253897310324457e-07,4,3,1
9269,Parallel,4.400843956132392e-06,3.6233184351681345e-06,4,2,2
9270,Paralympian,4.400843956132392e-06,1.8979287041356905e-06,3,2,1
9271,Paralympic,4.400843956132392e-06,7.074097897233022e-06,6,2,4
9272,Paralysed,2.095639979110664e-07,5.348708166200577e-06,3,0,3
9273,Paralyzed,8.592123914353715e-06,1.742643628342769e-05,17,5,12
9274,Paramilitary,2.3052039770217305e-06,1.8979287041356905e-06,3,2,1
9275,Paramount,4.400843956132392e-06,1.8979287041356905e-06,3,2,1
9276,Paranoid,2.3052039770217305e-06,3.6233184351681345e-06,4,1,3
9277,Paratrooper,4.400843956132392e-06,1.8979287041356905e-06,3,2,1
9278,Parched,2.3052039770217305e-06,3.6233184351681345e-06,3,1,2
9279,Parchin,4.400843956132392e-06,1.8979287041356905e-06,3,2,1
9280,Pardon,1.9070323809907035e-05,4.50326719799468e-05,40,11,29
9281,Pardoned,2.3052039770217305e-06,3.6233184351681345e-06,3,1,2
9282,Pardoning,2.095639979110664e-07,5.348708166200577e-06,3,0,3
9283,Parent,0.00011337412286988677,0.00011404826122124471,144,67,77
9284,Parental,2.326160376812834e-05,1.570104655239525e-05,24,13,11
9285,Parenthood,0.00013642616264010403,0.00017961307100047735,188,77,111
9286,Parenting,6.496483935243052e-06,5.348708166200577e-06,6,3,3
9287,Pari,0.00027054712130318646,0.0003262711981382355,348,136,212
9288,Parisian,2.3052039770217305e-06,7.074097897233022e-06,5,1,4
9289,Park,0.00012804360272366158,0.00010714670229711469,137,66,71
9290,Parker,1.48790438516857e-05,1.742643628342769e-05,17,7,10
9291,Parking,8.592123914353715e-06,7.074097897233022e-06,8,4,4
9292,Parkinson,4.400843956132392e-06,5.348708166200577e-06,5,2,3
9293,Parkland,4.002672360101368e-05,2.9504164400654783e-05,40,22,18
9294,Parliament,0.00019091280209698145,0.00018824001965563945,218,97,121
9295,Parliamentarian,2.3052039770217305e-06,3.6233184351681345e-06,3,1,2
9296,Parliamentary,4.400843956132392e-06,1.8979287041356905e-06,4,3,1
9297,Parma,2.095639979110664e-07,7.074097897233022e-06,4,0,4
9298,Parna,2.095639979110664e-07,7.074097897233022e-06,4,0,4
9299,Parnell,8.592123914353715e-06,3.6233184351681345e-06,6,4,2
9300,Parody,1.0687763893464371e-05,7.074097897233022e-06,12,6,6
9301,Parole,6.496483935243052e-06,5.348708166200577e-06,6,3,3
9302,Parrot,4.400843956132392e-06,3.6233184351681345e-06,4,2,2
9303,Parson,2.3052039770217305e-06,7.074097897233022e-06,5,1,4
9304,Part,0.00010708720293255492,0.00014510527637982858,152,61,91
9305,Partial,6.496483935243052e-06,5.348708166200577e-06,7,4,3
9306,Partially,1.0687763893464371e-05,1.7253897310324457e-07,5,5,0
9307,Participant,4.400843956132392e-06,5.348708166200577e-06,5,2,3
9308,Participate,6.496483935243052e-06,3.6233184351681345e-06,5,3,2
9309,Participating,2.3052039770217305e-06,7.074097897233022e-06,5,1,4
9310,Participation,2.3052039770217305e-06,7.074097897233022e-06,6,2,4
9311,Particle,6.496483935243052e-06,1.3975656821362803e-05,11,3,8
9312,Particular,4.400843956132392e-06,1.8979287041356905e-06,3,2,1
9313,Particularly,4.400843956132392e-06,3.6233184351681345e-06,4,2,2
9314,Partier,2.095639979110664e-07,3.6233184351681345e-06,3,0,3
9315,Parting,2.3052039770217305e-06,7.074097897233022e-06,5,1,4
9316,Partisan,2.116596378901769e-05,1.3975656821362803e-05,20,11,9
9317,Partisanship,4.400843956132392e-06,3.6233184351681345e-06,4,2,2
9318,Partly,2.3052039770217305e-06,5.348708166200577e-06,5,1,4
9319,Partner,3.583544364279237e-05,2.2602605476525032e-05,36,18,18
9320,Partnership,5.4696203454788295e-05,6.746273848336857e-05,70,27,43
9321,Party,0.0005953713180653392,0.0005557480323655505,667,308,359
9322,Pas,8.613080314144832e-05,6.746273848336857e-05,90,47,43
9323,Paso,1.6974683830796368e-05,1.742643628342769e-05,19,8,11
9324,Pass,8.613080314144832e-05,9.334358444885519e-05,105,45,60
9325,Passage,1.48790438516857e-05,1.052487735929791e-05,14,7,7
9326,Passed,2.5357243747239038e-05,2.2602605476525032e-05,25,12,13
9327,Passenger,3.583544364279237e-05,4.8483451442011706e-05,47,18,29
9328,Passing,1.278340387257504e-05,1.2250267090330355e-05,18,8,10
9329,Passion,8.592123914353715e-06,1.2250267090330355e-05,11,4,7
9330,Passionate,4.400843956132392e-06,1.8979287041356905e-06,4,2,2
9331,Passover,2.3052039770217305e-06,3.6233184351681345e-06,3,1,2
9332,Passport,1.0687763893464371e-05,8.79948762826546e-06,10,5,5
9333,Password,8.592123914353715e-06,1.052487735929791e-05,10,4,6
9334,Past,7.355696326678427e-05,7.954046660059569e-05,89,41,48
9335,Pastafarian,6.496483935243052e-06,1.8979287041356905e-06,5,4,1
9336,Pastor,1.9070323809907035e-05,2.4327995207557487e-05,26,11,15
9337,Pat,4.002672360101368e-05,4.8483451442011706e-05,51,23,28
9338,Patagonia,1.0687763893464371e-05,1.052487735929791e-05,11,5,6
9339,Pataki,4.400843956132392e-06,1.7253897310324457e-07,4,3,1
9340,Patch,1.48790438516857e-05,3.6233184351681345e-06,9,7,2
9341,Patel,4.400843956132392e-06,3.6233184351681345e-06,4,2,2
9342,Patent,2.5357243747239038e-05,2.087721574549256e-05,27,13,14
9343,Paternity,4.400843956132392e-06,3.6233184351681345e-06,4,2,2
9344,Paterson,2.3052039770217305e-06,1.7253897310324457e-07,3,3,0
9345,Path,2.954852370546031e-05,4.330728224891437e-05,41,15,26
9346,Pathetic,2.3052039770217305e-06,7.074097897233022e-06,6,2,4
9347,Pathway,1.0687763893464371e-05,3.6233184351681345e-06,7,5,2
9348,Patience,1.278340387257504e-05,1.8979287041356905e-06,7,6,1
9349,Patient,4.212236358012434e-05,3.985650278684949e-05,48,22,26
9350,Patio,2.095639979110664e-07,3.6233184351681345e-06,3,0,3
9351,Patriarchy,4.400843956132392e-06,1.8979287041356905e-06,3,2,1
9352,Patricia,4.400843956132392e-06,5.348708166200577e-06,6,3,3
9353,Patrick,1.9070323809907035e-05,4.330728224891437e-05,43,14,29
9354,Patriot,3.583544364279237e-05,2.6053384938589907e-05,34,17,17
9355,Patriotic,6.496483935243052e-06,5.348708166200577e-06,6,3,3
9356,Patriotism,6.496483935243052e-06,7.074097897233022e-06,8,4,4
9357,Patrol,3.583544364279237e-05,3.640572332478458e-05,40,17,23
9358,Patron,6.496483935243052e-06,3.6233184351681345e-06,5,3,2
9359,Pattern,1.278340387257504e-05,5.348708166200577e-06,11,7,4
9360,Patton,2.095639979110664e-07,7.074097897233022e-06,4,0,4
9361,Patty,4.400843956132392e-06,5.348708166200577e-06,5,2,3
9362,Paul,0.00043400703967381825,0.0005022609507035446,565,237,328
9363,Paula,2.3052039770217305e-06,1.3975656821362803e-05,9,1,8
9364,Pauline,2.095639979110664e-07,5.348708166200577e-06,3,0,3
9365,Paulo,1.6974683830796368e-05,2.2602605476525032e-05,27,14,13
9366,Paulson,4.400843956132392e-06,1.8979287041356905e-06,4,3,1
9367,Pause,8.592123914353715e-06,1.2250267090330355e-05,11,4,7
9368,Pave,1.278340387257504e-05,8.79948762826546e-06,11,6,5
9369,Paved,8.592123914353715e-06,3.6233184351681345e-06,7,4,3
9370,Paving,6.496483935243052e-06,1.7253897310324457e-07,3,3,0
9371,Paw,2.3052039770217305e-06,8.79948762826546e-06,6,1,5
9372,Paxman,2.3052039770217305e-06,5.348708166200577e-06,4,1,3
9373,Paxton,6.496483935243052e-06,1.7253897310324457e-07,4,3,1
9374,Pay,0.00027054712130318646,0.0003245458084072032,342,143,199
9375,PayPal,1.48790438516857e-05,2.087721574549256e-05,22,8,14
9376,Payback,4.400843956132392e-06,3.6233184351681345e-06,7,3,4
9377,Paycheck,1.48790438516857e-05,1.9151826014460126e-05,18,7,11
9378,Payday,2.326160376812834e-05,1.3975656821362803e-05,20,11,9
9379,Payer,2.095639979110664e-07,7.074097897233022e-06,4,0,4
9380,Paying,5.050492349656699e-05,7.263890767646595e-05,68,25,43
9381,Payment,4.212236358012434e-05,5.883578982820635e-05,58,21,37
9382,Payoff,2.095639979110664e-07,1.3975656821362803e-05,9,0,9
9383,Payout,8.592123914353715e-06,5.348708166200577e-06,8,4,4
9384,Paypal,6.496483935243052e-06,7.074097897233022e-06,8,4,4
9385,Payroll,4.400843956132392e-06,7.074097897233022e-06,6,2,4
9386,Paz,2.3052039770217305e-06,5.348708166200577e-06,4,1,3
9387,Pea,2.3052039770217305e-06,5.348708166200577e-06,4,1,3
9388,Peabody,2.3052039770217305e-06,7.074097897233022e-06,5,1,4
9389,Peace,0.00014061744259832545,0.00017098612234531542,177,72,105
9390,Peaceful,8.592123914353715e-06,7.074097897233022e-06,9,5,4
9391,Peacekeeper,4.400843956132392e-06,1.8979287041356905e-06,4,2,2
9392,Peacemaker,2.095639979110664e-07,5.348708166200577e-06,3,0,3
9393,Peach,4.400843956132392e-06,3.6233184351681345e-06,4,2,2
9394,Peacock,2.3052039770217305e-06,1.8979287041356905e-06,4,1,3
9395,Peak,1.278340387257504e-05,1.742643628342769e-05,17,6,11
9396,Peake,2.3052039770217305e-06,5.348708166200577e-06,5,1,4
9397,Peanut,6.496483935243052e-06,8.79948762826546e-06,10,3,7
9398,Pearl,1.278340387257504e-05,1.570104655239525e-05,18,8,10
9399,Pearson,4.400843956132392e-06,3.6233184351681345e-06,4,2,2
9400,Peasant,2.3052039770217305e-06,1.8979287041356905e-06,4,3,1
9401,Pebble,2.095639979110664e-07,3.6233184351681345e-06,5,3,2
9402,Peddling,4.400843956132392e-06,3.6233184351681345e-06,4,2,2
9403,Pedestrian,2.095639979110664e-07,5.348708166200577e-06,3,0,3
9404,Pediatric,2.3052039770217305e-06,5.348708166200577e-06,4,1,3
9405,Pediatrician,4.400843956132392e-06,3.6233184351681345e-06,4,2,2
9406,Pedophile,1.278340387257504e-05,1.052487735929791e-05,16,8,8
9407,Pedophilia,2.3052039770217305e-06,7.074097897233022e-06,6,1,5
9408,Pedro,2.3052039770217305e-06,1.052487735929791e-05,8,1,7
9409,Pee,4.400843956132392e-06,5.348708166200577e-06,5,2,3
9410,Peeing,4.400843956132392e-06,1.8979287041356905e-06,3,2,1
9411,Peek,2.3052039770217305e-06,7.074097897233022e-06,5,1,4
9412,Peer,6.496483935243052e-06,5.348708166200577e-06,6,3,3
9413,Peeve,4.400843956132392e-06,1.7253897310324457e-07,3,2,1
9414,Peggy,6.496483935243052e-06,1.8979287041356905e-06,4,3,1
9415,Pell,6.496483935243052e-06,3.6233184351681345e-06,5,3,2
9416,Pelletier,2.095639979110664e-07,5.348708166200577e-06,3,0,3
9417,Pelosi,0.00011127848289077625,0.00011232287149021227,121,54,67
9418,Pen,1.278340387257504e-05,3.2954943862719716e-05,32,9,23
9419,Pena,8.592123914353715e-06,7.074097897233022e-06,8,4,4
9420,Penalize,2.3052039770217305e-06,1.8979287041356905e-06,3,1,2
9421,Penalty,5.888748341300963e-05,6.746273848336857e-05,77,33,44
9422,Pence,0.0001385218026192147,0.0001968669683108019,190,70,120
9423,Pending,2.095639979110664e-07,7.074097897233022e-06,4,0,4
9424,Penguin,1.0687763893464371e-05,8.79948762826546e-06,11,6,5
9425,Peni,4.400843956132392e-06,7.074097897233022e-06,7,3,4
9426,Peninsula,8.592123914353715e-06,5.348708166200577e-06,7,4,3
9427,Penn,4.400843956132392e-06,7.074097897233022e-06,7,2,5
9428,Pennsylvania,0.00014271308257743603,0.00011059748175917965,144,75,69
9429,Penny,1.278340387257504e-05,1.2250267090330355e-05,14,6,8
9430,Pension,1.48790438516857e-05,3.640572332478458e-05,29,8,21
9431,Pensioner,4.400843956132392e-06,3.6233184351681345e-06,4,2,2
9432,Pentagon,0.00011966104280721883,0.0001485560558418934,154,61,93
9433,Pentecostal,2.095639979110664e-07,5.348708166200577e-06,4,0,4
9434,People,6.72700433294523e-05,4.330728224891437e-05,65,36,29
9435,Pepe,8.592123914353715e-06,8.79948762826546e-06,9,4,5
9436,Pepper,2.3052039770217305e-06,1.570104655239525e-05,10,1,9
9437,Pepsi,1.278340387257504e-05,1.2250267090330355e-05,13,6,7
9438,PepsiCo,2.3052039770217305e-06,3.6233184351681345e-06,3,1,2
9439,Per,2.116596378901769e-05,2.6053384938589907e-05,29,12,17
9440,Percent,0.0001385218026192147,0.00010887209202814718,144,71,73
9441,Percentage,2.095639979110664e-07,7.074097897233022e-06,5,0,5
9442,Perdue,2.3052039770217305e-06,2.087721574549256e-05,16,2,14
9443,Pere,8.592123914353715e-06,5.348708166200577e-06,7,4,3
9444,Perez,1.9070323809907035e-05,3.640572332478458e-05,33,10,23
9445,Perfect,3.583544364279237e-05,5.1934230904076595e-05,49,18,31
9446,Perfectly,1.278340387257504e-05,1.3975656821362803e-05,16,7,9
9447,Perform,8.592123914353715e-06,8.79948762826546e-06,9,4,5
9448,Performance,1.9070323809907035e-05,2.6053384938589907e-05,26,9,17
9449,Perhap,2.326160376812834e-05,3.8131113055817005e-05,35,11,24
9450,Peril,4.400843956132392e-06,1.052487735929791e-05,8,2,6
9451,Perino,4.400843956132392e-06,1.8979287041356905e-06,3,2,1
9452,Period,2.954852370546031e-05,8.79948762826546e-06,23,16,7
9453,Perjury,6.496483935243052e-06,7.074097897233022e-06,8,4,4
9454,Perk,6.496483935243052e-06,5.348708166200577e-06,6,3,3
9455,Perkin,6.496483935243052e-06,1.7253897310324457e-07,3,3,0
9456,Permanent,6.496483935243052e-06,2.4327995207557487e-05,18,3,15
9457,Permanently,4.400843956132392e-06,1.052487735929791e-05,10,2,8
9458,Permission,8.592123914353715e-06,7.074097897233022e-06,12,5,7
9459,Permit,8.592123914353715e-06,1.570104655239525e-05,15,4,11
9460,Perriello,8.592123914353715e-06,1.3975656821362803e-05,12,4,8
9461,Perry,4.4218003559234974e-05,5.883578982820635e-05,58,23,35
9462,Persecuted,6.496483935243052e-06,5.348708166200577e-06,6,3,3
9463,Persecution,2.3052039770217305e-06,3.6233184351681345e-06,4,1,3
9464,Persian,3.1644163684570994e-05,2.087721574549256e-05,28,16,12
9465,Persist,6.496483935243052e-06,1.7253897310324457e-07,3,3,0
9466,Persky,1.0687763893464371e-05,1.052487735929791e-05,11,5,6
9467,Person,0.0008740914352870574,0.0008749451326065526,1032,467,565
9468,Personal,8.193952318322689e-05,8.299124606266055e-05,96,42,54
9469,Personality,4.400843956132392e-06,1.8979287041356905e-06,3,2,1
9470,Personally,2.095639979110664e-07,1.052487735929791e-05,8,0,8
9471,Personhood,2.095639979110664e-07,3.6233184351681345e-06,3,0,3
9472,Personnel,4.400843956132392e-06,1.052487735929791e-05,8,2,6
9473,Perspective,2.116596378901769e-05,2.4327995207557487e-05,25,10,15
9474,Perth,4.400843956132392e-06,8.79948762826546e-06,8,3,5
9475,Peru,7.565260324589493e-05,7.436429740749831e-05,85,39,46
9476,Peruvian,2.326160376812834e-05,1.570104655239525e-05,23,13,10
9477,Pervez,2.095639979110664e-07,3.6233184351681345e-06,3,1,2
9478,Peshawar,1.0687763893464371e-05,7.074097897233022e-06,9,5,4
9479,Peshmerga,2.116596378901769e-05,5.348708166200577e-06,14,10,4
9480,Pesticide,1.6974683830796368e-05,1.3975656821362803e-05,17,8,9
9481,Pet,2.7452883726349685e-05,3.122955413168725e-05,33,14,19
9482,Pete,1.6974683830796368e-05,3.8131113055817005e-05,34,9,25
9483,Peter,7.146132328767358e-05,8.4716635793693e-05,87,38,49
9484,Petersburg,1.0687763893464371e-05,1.052487735929791e-05,13,6,7
9485,Petersen,2.3052039770217305e-06,3.6233184351681345e-06,3,1,2
9486,Peterson,1.0687763893464371e-05,3.6233184351681345e-06,7,5,2
9487,Petition,3.7931083621902995e-05,2.9504164400654783e-05,37,20,17
9488,Petraeu,2.116596378901769e-05,2.4327995207557487e-05,25,10,15
9489,Petro,4.400843956132392e-06,3.6233184351681345e-06,4,2,2
9490,Petrobra,2.3052039770217305e-06,5.348708166200577e-06,4,1,3
9491,Petroleum,1.48790438516857e-05,8.79948762826546e-06,12,7,5
9492,Petty,8.592123914353715e-06,5.348708166200577e-06,7,4,3
9493,Pew,8.592123914353715e-06,2.4327995207557487e-05,20,5,15
9494,Peña,6.496483935243052e-06,5.348708166200577e-06,11,8,3
9495,Pfizer,6.496483935243052e-06,1.3975656821362803e-05,17,6,11
9496,PhD,6.496483935243052e-06,1.3975656821362803e-05,11,3,8
9497,Phantom,2.3052039770217305e-06,5.348708166200577e-06,4,1,3
9498,Pharma,3.583544364279237e-05,4.8483451442011706e-05,49,17,32
9499,Pharmaceutical,6.496483935243052e-06,1.742643628342769e-05,15,5,10
9500,Pharmacy,4.400843956132392e-06,3.6233184351681345e-06,4,2,2
9501,Pharrell,2.095639979110664e-07,5.348708166200577e-06,4,0,4
9502,Phase,1.0687763893464371e-05,1.2250267090330355e-05,12,5,7
9503,Phil,1.6974683830796368e-05,1.742643628342769e-05,23,12,11
9504,Philadelphia,3.583544364279237e-05,3.468033359375216e-05,39,19,20
9505,Philae,4.400843956132392e-06,7.074097897233022e-06,8,2,6
9506,Philando,2.3052039770217305e-06,1.052487735929791e-05,9,1,8
9507,Philanthropist,4.400843956132392e-06,7.074097897233022e-06,8,4,4
9508,Philanthropy,6.496483935243052e-06,5.348708166200577e-06,9,4,5
9509,Philip,1.9070323809907035e-05,2.9504164400654783e-05,27,10,17
9510,Philippine,0.00014061744259832545,0.00017098612234531542,183,78,105
9511,Phillip,6.496483935243052e-06,1.8979287041356905e-06,4,3,1
9512,Philly,6.496483935243052e-06,1.052487735929791e-05,9,3,6
9513,Philosopher,2.095639979110664e-07,7.074097897233022e-06,6,2,4
9514,Philosophy,2.3052039770217305e-06,1.8979287041356905e-06,3,1,2
9515,Phishing,4.400843956132392e-06,1.8979287041356905e-06,3,2,1
9516,Phoenician,2.3052039770217305e-06,5.348708166200577e-06,4,1,3
9517,Phoenix,2.095639979110664e-07,3.122955413168725e-05,20,1,19
9518,Phone,0.00014480872255654665,0.00011404826122124471,147,75,72
9519,PhoneHacking,2.3052039770217305e-06,1.8979287041356905e-06,3,2,1
9520,Phony,8.592123914353715e-06,7.074097897233022e-06,11,4,7
9521,Phosphoru,2.095639979110664e-07,1.3975656821362803e-05,10,1,9
9522,Photo,0.0001825302421805385,0.00018651462992460717,230,105,125
9523,Photobomb,4.400843956132392e-06,1.8979287041356905e-06,3,2,1
9524,Photograph,1.0687763893464371e-05,1.742643628342769e-05,17,6,11
9525,Photographer,2.5357243747239038e-05,2.4327995207557487e-05,30,14,16
9526,Photography,2.095639979110664e-07,3.6233184351681345e-06,3,1,2
9527,Photojournalist,8.592123914353715e-06,1.8979287041356905e-06,5,4,1
9528,Photoshop,1.0687763893464371e-05,5.348708166200577e-06,9,6,3
9529,Photoshopped,4.400843956132392e-06,3.6233184351681345e-06,4,2,2
9530,Phrase,4.400843956132392e-06,5.348708166200577e-06,5,2,3
9531,Physic,8.592123914353715e-06,1.2250267090330355e-05,11,4,7
9532,Physical,6.496483935243052e-06,1.052487735929791e-05,9,3,6
9533,Physician,1.278340387257504e-05,1.570104655239525e-05,17,8,9
9534,PhysicianAssisted,2.3052039770217305e-06,1.8979287041356905e-06,3,1,2
9535,Physicist,1.278340387257504e-05,1.052487735929791e-05,13,6,7
9536,Pi,4.400843956132392e-06,1.8979287041356905e-06,3,2,1
9537,Pic,1.6974683830796368e-05,2.087721574549256e-05,21,9,12
9538,Picasso,1.278340387257504e-05,7.074097897233022e-06,11,6,5
9539,Pick,0.0001531912824729893,0.0002400017115866128,253,92,161
9540,Picked,2.954852370546031e-05,7.074097897233022e-06,20,15,5
9541,Picket,2.3052039770217305e-06,3.6233184351681345e-06,3,1,2
9542,Picking,1.48790438516857e-05,1.052487735929791e-05,14,7,7
9543,Pickle,2.3052039770217305e-06,3.6233184351681345e-06,3,1,2
9544,Pickup,4.400843956132392e-06,7.074097897233022e-06,7,2,5
9545,Picture,8.613080314144832e-05,6.401195902130366e-05,85,45,40
9546,Pie,2.095639979110664e-07,1.052487735929791e-05,6,0,6
9547,Piece,1.0687763893464371e-05,2.4327995207557487e-05,21,5,16
9548,Pier,2.116596378901769e-05,1.8979287041356905e-06,12,11,1
9549,Pierce,4.400843956132392e-06,5.348708166200577e-06,5,2,3
9550,Pierre,4.400843956132392e-06,3.6233184351681345e-06,5,3,2
9551,Pig,1.9070323809907035e-05,1.2250267090330355e-05,17,10,7
9552,Piggy,2.095639979110664e-07,5.348708166200577e-06,3,0,3
9553,Pike,2.3052039770217305e-06,5.348708166200577e-06,4,1,3
9554,Piketty,1.278340387257504e-05,1.3975656821362803e-05,14,6,8
9555,Pile,1.48790438516857e-05,1.2250267090330355e-05,14,7,7
9556,Pilger,2.095639979110664e-07,3.6233184351681345e-06,5,2,3
9557,Pilgrim,2.3052039770217305e-06,5.348708166200577e-06,4,1,3
9558,Pill,6.496483935243052e-06,1.3975656821362803e-05,11,3,8
9559,Pillar,4.400843956132392e-06,1.8979287041356905e-06,3,2,1
9560,Pillay,2.095639979110664e-07,7.074097897233022e-06,5,1,4
9561,Pilot,3.1644163684570994e-05,3.8131113055817005e-05,43,18,25
9562,Pimp,2.095639979110664e-07,3.6233184351681345e-06,3,0,3
9563,Pin,6.496483935243052e-06,1.052487735929791e-05,10,4,6
9564,Pine,2.3052039770217305e-06,1.8979287041356905e-06,3,2,1
9565,Pining,4.400843956132392e-06,1.7253897310324457e-07,3,2,1
9566,Pink,1.278340387257504e-05,8.79948762826546e-06,12,7,5
9567,Pinocchio,2.095639979110664e-07,5.348708166200577e-06,3,0,3
9568,Pinochet,6.496483935243052e-06,7.074097897233022e-06,8,4,4
9569,Pioneer,2.3052039770217305e-06,7.074097897233022e-06,6,2,4
9570,Pioneering,4.400843956132392e-06,3.6233184351681345e-06,4,2,2
9571,Pipe,1.48790438516857e-05,1.052487735929791e-05,14,7,7
9572,Pipeline,7.774824322500554e-05,5.711040009717395e-05,82,38,44
9573,Piracy,2.116596378901769e-05,1.742643628342769e-05,21,10,11
9574,Pirate,0.00023911252161652657,0.00020721930669699654,252,123,129
9575,Piratebay,2.3052039770217305e-06,5.348708166200577e-06,5,1,4
9576,Pirating,2.095639979110664e-07,3.6233184351681345e-06,3,1,2
9577,Pissed,6.496483935243052e-06,3.6233184351681345e-06,7,5,2
9578,Pistoriu,6.496483935243052e-06,1.8979287041356905e-06,5,4,1
9579,Pit,1.9070323809907035e-05,2.6053384938589907e-05,27,10,17
9580,Pitch,8.592123914353715e-06,1.2250267090330355e-05,12,4,8
9581,Pitched,2.095639979110664e-07,5.348708166200577e-06,4,1,3
9582,Pittsburgh,1.48790438516857e-05,2.777877466962238e-05,23,7,16
9583,Pity,2.3052039770217305e-06,5.348708166200577e-06,4,1,3
9584,Pivot,1.278340387257504e-05,1.570104655239525e-05,15,6,9
9585,Pivotal,8.592123914353715e-06,1.8979287041356905e-06,6,4,2
9586,Pivoting,2.3052039770217305e-06,7.074097897233022e-06,5,1,4
9587,Pizza,4.4218003559234974e-05,2.087721574549256e-05,39,24,15
9588,Pizzeria,2.3052039770217305e-06,3.6233184351681345e-06,4,2,2
9589,Place,7.984388320411623e-05,0.00012267520987640663,119,40,79
9590,Placed,2.3052039770217305e-06,3.6233184351681345e-06,3,1,2
9591,Plagiarism,2.095639979110664e-07,1.570104655239525e-05,9,0,9
9592,Plagiarized,2.095639979110664e-07,5.348708166200577e-06,3,0,3
9593,Plague,8.592123914353715e-06,1.052487735929791e-05,12,6,6
9594,Plagued,2.3052039770217305e-06,5.348708166200577e-06,6,1,5
9595,Plain,6.496483935243052e-06,8.79948762826546e-06,8,3,5
9596,Plaintiff,4.400843956132392e-06,5.348708166200577e-06,5,2,3
9597,Plan,0.0005199282788173553,0.0006609968059585296,696,277,419
9598,Plane,8.403516316233764e-05,8.126585633162811e-05,103,48,55
9599,Planet,6.72700433294523e-05,6.573734875233614e-05,80,37,43
9600,Planetary,6.496483935243052e-06,3.6233184351681345e-06,5,3,2
9601,Planned,0.00015947820241032126,0.00020549391696596386,216,90,126
9602,Planner,6.496483935243052e-06,3.6233184351681345e-06,6,3,3
9603,Planning,4.002672360101368e-05,4.50326719799468e-05,51,22,29
9604,Plant,7.355696326678427e-05,5.711040009717395e-05,75,38,37
9605,Planted,2.3052039770217305e-06,5.348708166200577e-06,4,1,3
9606,Planting,6.496483935243052e-06,3.6233184351681345e-06,5,3,2
9607,Plaque,2.3052039770217305e-06,1.8979287041356905e-06,3,2,1
9608,Plastic,4.4218003559234974e-05,2.2602605476525032e-05,36,22,14
9609,Plate,4.400843956132392e-06,3.6233184351681345e-06,4,2,2
9610,Platform,2.116596378901769e-05,4.6758061710979285e-05,43,11,32
9611,Platini,2.3052039770217305e-06,3.6233184351681345e-06,3,1,2
9612,Play,6.936568330856297e-05,6.746273848336857e-05,76,36,40
9613,PlayStation,8.592123914353715e-06,1.7253897310324457e-07,6,5,1
9614,Playbook,6.496483935243052e-06,1.8979287041356905e-06,6,5,1
9615,Playboy,6.496483935243052e-06,5.348708166200577e-06,6,3,3
9616,Played,1.48790438516857e-05,1.3975656821362803e-05,16,8,8
9617,Player,1.6974683830796368e-05,3.468033359375216e-05,30,9,21
9618,Playground,2.3052039770217305e-06,3.6233184351681345e-06,3,1,2
9619,Playing,2.954852370546031e-05,3.122955413168725e-05,35,15,20
9620,Playlist,2.3052039770217305e-06,7.074097897233022e-06,6,1,5
9621,Plaza,2.3052039770217305e-06,3.6233184351681345e-06,4,2,2
9622,Plea,2.7452883726349685e-05,4.8483451442011706e-05,48,19,29
9623,Plead,2.5357243747239038e-05,5.883578982820635e-05,55,16,39
9624,Please,6.307876337123095e-05,6.056117955923882e-05,72,32,40
9625,Pleased,2.3052039770217305e-06,3.6233184351681345e-06,3,1,2
9626,Pledge,4.4218003559234974e-05,7.263890767646595e-05,72,24,48
9627,Pledged,2.3052039770217305e-06,3.6233184351681345e-06,3,1,2
9628,Plenty,1.0687763893464371e-05,1.2250267090330355e-05,13,5,8
9629,Plight,4.400843956132392e-06,5.348708166200577e-06,5,2,3
9630,Plot,4.6313643538345614e-05,6.056117955923882e-05,58,22,36
9631,Plotter,4.400843956132392e-06,1.8979287041356905e-06,3,2,1
9632,Plotting,4.400843956132392e-06,8.79948762826546e-06,7,2,5
9633,Plow,4.400843956132392e-06,1.8979287041356905e-06,3,2,1
9634,Plu,2.326160376812834e-05,2.777877466962238e-05,29,13,16
9635,Plug,1.0687763893464371e-05,1.052487735929791e-05,11,5,6
9636,Plugging,2.095639979110664e-07,5.348708166200577e-06,3,0,3
9637,Plummet,1.48790438516857e-05,8.79948762826546e-06,12,7,5
9638,Plummeting,4.400843956132392e-06,7.074097897233022e-06,7,2,5
9639,Plunge,2.5357243747239038e-05,1.742643628342769e-05,22,12,10
9640,Pluto,2.116596378901769e-05,4.50326719799468e-05,39,11,28
9641,Plutocrat,4.400843956132392e-06,5.348708166200577e-06,6,2,4
9642,Plutonium,2.095639979110664e-07,5.348708166200577e-06,3,0,3
9643,Pneumonia,1.0687763893464371e-05,3.6233184351681345e-06,8,5,3
9644,Poached,2.095639979110664e-07,1.8979287041356905e-06,3,1,2
9645,Poacher,3.3739803663681634e-05,1.9151826014460126e-05,31,20,11
9646,Poaching,1.0687763893464371e-05,1.052487735929791e-05,13,6,7
9647,Pocahonta,2.095639979110664e-07,1.2250267090330355e-05,8,0,8
9648,Pocket,4.400843956132392e-06,3.6233184351681345e-06,4,2,2
9649,Pod,4.400843956132392e-06,1.8979287041356905e-06,3,2,1
9650,Podcast,4.400843956132392e-06,1.8979287041356905e-06,6,3,3
9651,Podesta,4.400843956132392e-06,5.348708166200577e-06,7,4,3
9652,Podium,4.400843956132392e-06,1.8979287041356905e-06,3,2,1
9653,Poet,4.400843956132392e-06,1.8979287041356905e-06,6,2,4
9654,Poetic,4.400843956132392e-06,1.8979287041356905e-06,3,2,1
9655,Poetry,2.095639979110664e-07,5.348708166200577e-06,3,0,3
9656,Poignant,2.095639979110664e-07,3.6233184351681345e-06,3,1,2
9657,Point,0.00011127848289077625,8.816741525575797e-05,119,59,60
9658,Pointed,2.3052039770217305e-06,3.6233184351681345e-06,3,1,2
9659,Pointing,4.400843956132392e-06,3.6233184351681345e-06,4,2,2
9660,Pointles,6.496483935243052e-06,5.348708166200577e-06,6,3,3
9661,Poised,1.278340387257504e-05,1.052487735929791e-05,17,9,8
9662,Poison,8.592123914353715e-06,1.3975656821362803e-05,13,4,9
9663,Poisoned,1.278340387257504e-05,7.074097897233022e-06,12,6,6
9664,Poisoning,1.6974683830796368e-05,1.3975656821362803e-05,18,9,9
9665,Poisonou,2.3052039770217305e-06,3.6233184351681345e-06,3,1,2
9666,Pokemon,2.5357243747239038e-05,3.122955413168725e-05,32,12,20
9667,Poker,2.3052039770217305e-06,5.348708166200577e-06,4,1,3
9668,Poking,2.095639979110664e-07,5.348708166200577e-06,3,0,3
9669,Pokémon,8.592123914353715e-06,8.79948762826546e-06,10,4,6
9670,Pol,4.400843956132392e-06,3.6233184351681345e-06,5,3,2
9671,Poland,0.00016786076232676425,0.0001278513790695043,167,84,83
9672,Polanski,4.400843956132392e-06,8.79948762826546e-06,9,3,6
9673,Polar,1.48790438516857e-05,8.79948762826546e-06,12,7,5
9674,Polarization,6.496483935243052e-06,1.7253897310324457e-07,3,3,0
9675,Pole,3.1644163684570994e-05,1.052487735929791e-05,23,17,6
9676,Poli,2.3052039770217305e-06,5.348708166200577e-06,5,1,4
9677,Police,0.0007860745561644094,0.0008093803228273195,955,430,525
9678,Policeman,1.48790438516857e-05,1.2250267090330355e-05,14,7,7
9679,Policewoman,4.400843956132392e-06,1.8979287041356905e-06,3,2,1
9680,Policing,1.48790438516857e-05,1.570104655239525e-05,18,8,10
9681,Policy,0.00027054712130318646,0.0002313747629314509,289,141,148
9682,Policymaker,2.095639979110664e-07,7.074097897233022e-06,4,0,4
9683,Polio,8.592123914353715e-06,2.6053384938589907e-05,20,4,16
9684,PolioFree,2.3052039770217305e-06,3.6233184351681345e-06,4,2,2
9685,Polish,7.355696326678427e-05,7.608968713853079e-05,93,41,52
9686,Politic,0.00012804360272366158,0.00017271151207634748,178,71,107
9687,Political,0.00014271308257743603,0.0002020431375038992,211,78,133
9688,Politically,1.278340387257504e-05,1.742643628342769e-05,18,7,11
9689,Politician,0.00010289592297433347,0.00011059748175917965,127,59,68
9690,Politicize,2.3052039770217305e-06,5.348708166200577e-06,4,1,3
9691,Politicizing,2.3052039770217305e-06,5.348708166200577e-06,4,1,3
9692,Politico,1.48790438516857e-05,1.742643628342769e-05,18,7,11
9693,Politkovskaya,2.3052039770217305e-06,5.348708166200577e-06,4,1,3
9694,Politwoop,2.3052039770217305e-06,1.8979287041356905e-06,3,2,1
9695,Poll,0.0002935991610734039,0.00027450950620726186,343,156,187
9696,Pollination,4.400843956132392e-06,3.6233184351681345e-06,4,2,2
9697,Polling,4.6313643538345614e-05,4.50326719799468e-05,53,26,27
9698,Pollster,3.1644163684570994e-05,2.2602605476525032e-05,32,17,15
9699,Pollute,4.400843956132392e-06,1.8979287041356905e-06,3,2,1
9700,Polluted,4.400843956132392e-06,1.2250267090330355e-05,9,2,7
9701,Polluter,2.095639979110664e-07,1.052487735929791e-05,6,0,6
9702,Pollution,3.1644163684570994e-05,3.468033359375216e-05,40,17,23
9703,Polygraph,4.400843956132392e-06,1.8979287041356905e-06,3,2,1
9704,Pompeii,1.0687763893464371e-05,1.8979287041356905e-06,6,5,1
9705,Pompeo,2.116596378901769e-05,3.2954943862719716e-05,32,11,21
9706,Pond,4.400843956132392e-06,5.348708166200577e-06,5,2,3
9707,Ponder,6.496483935243052e-06,3.6233184351681345e-06,7,4,3
9708,Ponzi,8.592123914353715e-06,1.052487735929791e-05,10,4,6
9709,Poo,4.400843956132392e-06,3.6233184351681345e-06,4,2,2
9710,Pooch,4.400843956132392e-06,8.79948762826546e-06,7,2,5
9711,Pool,1.278340387257504e-05,1.742643628342769e-05,16,6,10
9712,Poop,6.496483935243052e-06,3.6233184351681345e-06,5,3,2
9713,Poor,0.00010708720293255492,0.0001278513790695043,143,61,82
9714,Poorer,1.0687763893464371e-05,5.348708166200577e-06,8,5,3
9715,Poorest,1.278340387257504e-05,8.79948762826546e-06,12,7,5
9716,Poorly,4.400843956132392e-06,3.6233184351681345e-06,4,2,2
9717,Pop,8.592123914353715e-06,7.074097897233022e-06,11,5,6
9718,Pope,0.0003522770804885024,0.0002986649624417165,381,182,199
9719,Popovich,2.3052039770217305e-06,3.6233184351681345e-06,3,1,2
9720,Popular,4.6313643538345614e-05,3.640572332478458e-05,48,24,24
9721,Popularity,6.496483935243052e-06,1.052487735929791e-05,10,3,7
9722,Population,3.583544364279237e-05,3.640572332478458e-05,46,20,26
9723,Populism,8.592123914353715e-06,7.074097897233022e-06,9,5,4
9724,Populist,1.48790438516857e-05,1.3975656821362803e-05,19,9,10
9725,Porch,4.400843956132392e-06,1.7253897310324457e-07,3,2,1
9726,Pork,2.3052039770217305e-06,7.074097897233022e-06,5,1,4
9727,Porn,4.4218003559234974e-05,3.985650278684949e-05,48,23,25
9728,Pornographic,2.3052039770217305e-06,3.6233184351681345e-06,3,1,2
9729,Pornography,6.496483935243052e-06,5.348708166200577e-06,7,4,3
9730,Poroshenko,1.278340387257504e-05,3.6233184351681345e-06,8,6,2
9731,Porsche,6.496483935243052e-06,1.2250267090330355e-05,10,3,7
9732,Port,1.9070323809907035e-05,2.087721574549256e-05,25,10,15
9733,PortauPrince,4.400843956132392e-06,3.6233184351681345e-06,4,2,2
9734,Porter,2.116596378901769e-05,3.8131113055817005e-05,34,12,22
9735,Portfolio,2.3052039770217305e-06,1.052487735929791e-05,7,1,6
9736,Portion,6.496483935243052e-06,3.6233184351681345e-06,5,3,2
9737,Portland,2.326160376812834e-05,1.9151826014460126e-05,25,11,14
9738,Portman,4.400843956132392e-06,8.79948762826546e-06,8,2,6
9739,Portrait,2.326160376812834e-05,1.2250267090330355e-05,20,12,8
9740,Portray,6.496483935243052e-06,1.8979287041356905e-06,4,3,1
9741,Portrayal,4.400843956132392e-06,3.6233184351681345e-06,5,3,2
9742,Portugal,4.840928351745632e-05,5.020884117304414e-05,62,27,35
9743,Portuguese,1.278340387257504e-05,7.074097897233022e-06,10,6,4
9744,Pose,1.6974683830796368e-05,1.570104655239525e-05,18,9,9
9745,Posh,4.400843956132392e-06,1.8979287041356905e-06,3,2,1
9746,Posing,6.496483935243052e-06,3.6233184351681345e-06,5,3,2
9747,Position,2.7452883726349685e-05,3.8131113055817005e-05,42,14,28
9748,Positive,2.7452883726349685e-05,3.468033359375216e-05,39,14,25
9749,Possession,8.592123914353715e-06,1.052487735929791e-05,11,5,6
9750,Possibility,4.400843956132392e-06,1.2250267090330355e-05,9,2,7
9751,Possible,6.307876337123095e-05,9.334358444885519e-05,98,35,63
9752,Possibly,1.0687763893464371e-05,1.3975656821362803e-05,14,5,9
9753,Post,0.00020348664197164515,0.0001916907991177046,227,108,119
9754,Post911,4.400843956132392e-06,1.8979287041356905e-06,4,2,2
9755,PostConvention,4.400843956132392e-06,1.8979287041356905e-06,3,2,1
9756,PostDebate,8.592123914353715e-06,7.074097897233022e-06,9,5,4
9757,PostElection,6.496483935243052e-06,1.742643628342769e-05,14,3,11
9758,Postal,4.400843956132392e-06,1.2250267090330355e-05,9,2,7
9759,Postcard,2.3052039770217305e-06,7.074097897233022e-06,5,1,4
9760,Posted,4.400843956132392e-06,8.79948762826546e-06,8,3,5
9761,Poster,1.0687763893464371e-05,1.2250267090330355e-05,12,5,7
9762,Posting,4.400843956132392e-06,5.348708166200577e-06,7,2,5
9763,Postmaster,2.095639979110664e-07,5.348708166200577e-06,3,0,3
9764,Postpone,4.400843956132392e-06,5.348708166200577e-06,6,2,4
9765,Postponed,6.496483935243052e-06,1.7253897310324457e-07,3,3,0
9766,Pot,5.050492349656699e-05,5.3659620635109e-05,60,26,34
9767,Potato,2.3052039770217305e-06,7.074097897233022e-06,5,1,4
9768,Potential,5.260056347567764e-05,5.3659620635109e-05,59,26,33
9769,Potentially,1.278340387257504e-05,1.742643628342769e-05,17,6,11
9770,Potter,1.48790438516857e-05,8.79948762826546e-06,13,7,6
9771,Poultry,2.3052039770217305e-06,5.348708166200577e-06,4,1,3
9772,Pounce,4.400843956132392e-06,1.7253897310324457e-07,3,3,0
9773,Pound,2.326160376812834e-05,1.8979287041356905e-06,12,11,1
9774,Pour,4.400843956132392e-06,2.4327995207557487e-05,18,2,16
9775,Poverty,4.212236358012434e-05,6.401195902130366e-05,65,25,40
9776,Povich,2.095639979110664e-07,7.074097897233022e-06,5,0,5
9777,Powder,8.592123914353715e-06,7.074097897233022e-06,8,4,4
9778,Powell,1.6974683830796368e-05,2.6053384938589907e-05,24,9,15
9779,Power,0.00022863432172097337,0.00023482554239351563,268,117,151
9780,Powerball,1.0687763893464371e-05,2.087721574549256e-05,20,7,13
9781,Powered,6.496483935243052e-06,5.348708166200577e-06,6,3,3
9782,Powerful,6.307876337123095e-05,9.851975364195259e-05,98,34,64
9783,Powerles,2.3052039770217305e-06,3.6233184351681345e-06,3,1,2
9784,Practical,1.278340387257504e-05,5.348708166200577e-06,9,6,3
9785,Practically,4.400843956132392e-06,1.8979287041356905e-06,3,2,1
9786,Practice,4.002672360101368e-05,3.2954943862719716e-05,45,21,24
9787,Practicing,2.095639979110664e-07,7.074097897233022e-06,4,0,4
9788,Pradesh,2.3052039770217305e-06,7.074097897233022e-06,6,1,5
9789,Prague,6.496483935243052e-06,1.2250267090330355e-05,11,3,8
9790,Praise,3.1644163684570994e-05,6.056117955923882e-05,57,20,37
9791,Praised,2.3052039770217305e-06,7.074097897233022e-06,6,1,5
9792,Praising,2.3052039770217305e-06,5.348708166200577e-06,4,1,3
9793,Pramila,4.400843956132392e-06,3.6233184351681345e-06,4,2,2
9794,Prank,1.0687763893464371e-05,3.6233184351681345e-06,8,5,3
9795,Prankster,2.3052039770217305e-06,3.6233184351681345e-06,3,1,2
9796,Pratt,2.3052039770217305e-06,3.6233184351681345e-06,3,1,2
9797,Pray,1.48790438516857e-05,7.074097897233022e-06,11,7,4
9798,Prayer,2.326160376812834e-05,2.9504164400654783e-05,34,14,20
9799,Pre,8.592123914353715e-06,8.79948762826546e-06,10,4,6
9800,PreExisting,8.592123914353715e-06,3.6233184351681345e-06,8,4,4
9801,Preach,4.400843956132392e-06,1.8979287041356905e-06,3,2,1
9802,Precision,4.400843956132392e-06,1.8979287041356905e-06,3,2,1
9803,Predator,8.592123914353715e-06,1.570104655239525e-05,14,5,9
9804,Predatory,6.496483935243052e-06,7.074097897233022e-06,7,3,4
9805,Predecessor,2.3052039770217305e-06,3.6233184351681345e-06,3,1,2
9806,Predict,2.326160376812834e-05,2.4327995207557487e-05,29,14,15
9807,Predictable,2.3052039770217305e-06,3.6233184351681345e-06,3,1,2
9808,Predictably,4.400843956132392e-06,1.8979287041356905e-06,3,2,1
9809,Predicted,6.496483935243052e-06,7.074097897233022e-06,7,3,4
9810,Predicting,2.095639979110664e-07,3.6233184351681345e-06,3,1,2
9811,Prediction,2.326160376812834e-05,1.3975656821362803e-05,24,15,9
9812,Preet,4.400843956132392e-06,3.6233184351681345e-06,7,5,2
9813,Prefer,1.0687763893464371e-05,1.2250267090330355e-05,15,6,9
9814,Preference,2.095639979110664e-07,7.074097897233022e-06,4,0,4
9815,Preferred,4.400843956132392e-06,1.8979287041356905e-06,3,2,1
9816,Pregnancy,1.278340387257504e-05,1.742643628342769e-05,16,6,10
9817,Pregnant,3.1644163684570994e-05,4.330728224891437e-05,45,18,27
9818,Prehistoric,4.400843956132392e-06,1.052487735929791e-05,8,2,6
9819,Preliminary,4.400843956132392e-06,1.8979287041356905e-06,4,2,2
9820,Premature,4.400843956132392e-06,3.6233184351681345e-06,4,2,2
9821,Premier,1.48790438516857e-05,1.9151826014460126e-05,19,7,12
9822,Premium,4.400843956132392e-06,8.79948762826546e-06,7,2,5
9823,Prep,8.592123914353715e-06,7.074097897233022e-06,8,4,4
9824,Prepaid,1.48790438516857e-05,1.9151826014460126e-05,19,7,12
9825,Prepare,5.888748341300963e-05,6.573734875233614e-05,75,32,43
9826,Prepared,1.278340387257504e-05,1.9151826014460126e-05,17,6,11
9827,Preparednes,2.3052039770217305e-06,3.6233184351681345e-06,3,1,2
9828,Preparing,2.326160376812834e-05,2.2602605476525032e-05,28,12,16
9829,Prepping,6.496483935243052e-06,3.6233184351681345e-06,6,3,3
9830,Pres,0.00015738256243121094,0.00015373222503499084,183,83,100
9831,Preschool,1.0687763893464371e-05,1.2250267090330355e-05,14,6,8
9832,Prescription,8.592123914353715e-06,1.9151826014460126e-05,15,4,11
9833,Presence,4.400843956132392e-06,1.3975656821362803e-05,10,2,8
9834,Present,8.592123914353715e-06,1.2250267090330355e-05,14,6,8
9835,Preserve,6.496483935243052e-06,7.074097897233022e-06,7,3,4
9836,Preserved,4.400843956132392e-06,5.348708166200577e-06,5,2,3
9837,Preserving,4.400843956132392e-06,1.8979287041356905e-06,3,2,1
9838,Presidency,8.613080314144832e-05,6.918812821440096e-05,88,47,41
9839,President,0.0017647384264090895,0.001806655587364073,2110,945,1165
9840,PresidentElect,1.278340387257504e-05,1.3975656821362803e-05,14,6,8
9841,Presidentelect,3.1644163684570994e-05,2.087721574549256e-05,31,16,15
9842,Presidential,0.00029779044103162505,0.00025553021916590484,328,160,168
9843,Press,1.278340387257504e-05,8.79948762826546e-06,11,6,5
9844,Pressed,4.400843956132392e-06,3.6233184351681345e-06,4,2,2
9845,Pressing,4.400843956132392e-06,3.6233184351681345e-06,5,2,3
9846,Pressley,2.3052039770217305e-06,8.79948762826546e-06,7,1,6
9847,Pressure,6.517440335034157e-05,5.883578982820635e-05,75,34,41
9848,Pressured,6.496483935243052e-06,1.052487735929791e-05,9,3,6
9849,Presumably,4.400843956132392e-06,1.7253897310324457e-07,3,3,0
9850,Pretend,8.592123914353715e-06,5.348708166200577e-06,9,5,4
9851,Pretending,4.400843956132392e-06,8.79948762826546e-06,7,2,5
9852,Pretty,5.4696203454788295e-05,5.711040009717395e-05,64,28,36
9853,Pretzel,2.3052039770217305e-06,3.6233184351681345e-06,3,1,2
9854,Prevail,6.496483935243052e-06,7.074097897233022e-06,7,3,4
9855,Prevent,5.050492349656699e-05,5.5385010366141504e-05,63,26,37
9856,Prevented,4.400843956132392e-06,3.6233184351681345e-06,4,2,2
9857,Preventing,1.0687763893464371e-05,7.074097897233022e-06,9,5,4
9858,Prevention,1.9070323809907035e-05,3.640572332478458e-05,30,9,21
9859,Preventive,2.3052039770217305e-06,3.6233184351681345e-06,3,1,2
9860,Preview,4.400843956132392e-06,7.074097897233022e-06,7,2,5
9861,Previou,8.592123914353715e-06,7.074097897233022e-06,8,4,4
9862,Previously,1.6974683830796368e-05,2.4327995207557487e-05,22,8,14
9863,Prey,4.400843956132392e-06,3.6233184351681345e-06,6,4,2
9864,Prez,4.400843956132392e-06,3.6233184351681345e-06,4,2,2
9865,Price,0.0001552869224521,0.00016235917369015308,188,82,106
9866,PriceFixing,2.095639979110664e-07,5.348708166200577e-06,3,0,3
9867,PriceGouging,4.400843956132392e-06,1.8979287041356905e-06,3,2,1
9868,Priceles,1.278340387257504e-05,1.8979287041356905e-06,8,7,1
9869,Pricey,4.400843956132392e-06,5.348708166200577e-06,5,2,3
9870,Pricing,1.0687763893464371e-05,1.052487735929791e-05,12,5,7
9871,Pride,3.7931083621902995e-05,1.570104655239525e-05,27,18,9
9872,Priebu,3.3739803663681634e-05,1.570104655239525e-05,27,17,10
9873,Priest,2.5357243747239038e-05,3.2954943862719716e-05,33,13,20
9874,Primary,0.00021186920188808795,0.0002141208656211263,263,117,146
9875,Prime,0.00036694656034227697,0.0003417997057175273,421,189,232
9876,Primed,2.3052039770217305e-06,5.348708166200577e-06,4,1,3
9877,Prince,7.355696326678427e-05,6.573734875233614e-05,74,36,38
9878,Princes,1.278340387257504e-05,2.6053384938589907e-05,22,7,15
9879,Princeton,4.400843956132392e-06,5.348708166200577e-06,6,2,4
9880,Principal,1.9070323809907035e-05,8.79948762826546e-06,16,10,6
9881,Principle,2.116596378901769e-05,8.79948762826546e-06,16,11,5
9882,Print,6.496483935243052e-06,8.79948762826546e-06,9,3,6
9883,Printed,2.095639979110664e-07,8.79948762826546e-06,5,0,5
9884,Printer,4.400843956132392e-06,3.6233184351681345e-06,5,2,3
9885,Printing,2.3052039770217305e-06,5.348708166200577e-06,4,1,3
9886,Prior,4.400843956132392e-06,1.2250267090330355e-05,9,2,7
9887,Prioritize,6.496483935243052e-06,8.79948762826546e-06,8,3,5
9888,Prioritizing,2.095639979110664e-07,3.6233184351681345e-06,3,1,2
9889,Priority,1.48790438516857e-05,2.2602605476525032e-05,22,9,13
9890,Prism,2.3052039770217305e-06,7.074097897233022e-06,5,1,4
9891,Prison,0.00017205204228498542,0.0001916907991177046,222,94,128
9892,Prisoner,5.050492349656699e-05,5.5385010366141504e-05,66,29,37
9893,Privacy,4.4218003559234974e-05,6.918812821440096e-05,66,22,44
9894,Private,0.0001343305226609934,9.161819471782287e-05,131,67,64
9895,Privately,1.278340387257504e-05,8.79948762826546e-06,12,7,5
9896,Privatisation,4.400843956132392e-06,1.8979287041356905e-06,5,2,3
9897,Privatization,6.496483935243052e-06,3.6233184351681345e-06,5,3,2
9898,Privatize,6.496483935243052e-06,1.8979287041356905e-06,4,3,1
9899,Privilege,1.6974683830796368e-05,1.3975656821362803e-05,16,8,8
9900,Privileged,6.496483935243052e-06,1.7253897310324457e-07,3,3,0
9901,Prix,8.592123914353715e-06,1.7253897310324457e-07,4,4,0
9902,Prize,9.870464301611217e-05,0.0001295767688005365,135,53,82
9903,Prizewinning,2.095639979110664e-07,3.6233184351681345e-06,3,1,2
9904,Pro,1.6974683830796368e-05,2.4327995207557487e-05,24,9,15
9905,ProChoice,2.3052039770217305e-06,3.6233184351681345e-06,3,1,2
9906,ProClinton,8.592123914353715e-06,1.8979287041356905e-06,7,4,3
9907,ProDemocracy,6.496483935243052e-06,1.8979287041356905e-06,6,3,3
9908,ProGun,4.400843956132392e-06,7.074097897233022e-06,7,2,5
9909,ProLife,4.400843956132392e-06,1.052487735929791e-05,8,2,6
9910,ProPalestinian,6.496483935243052e-06,1.8979287041356905e-06,4,3,1
9911,ProPublica,8.592123914353715e-06,3.6233184351681345e-06,6,4,2
9912,ProRussia,2.3052039770217305e-06,5.348708166200577e-06,5,2,3
9913,ProRussian,1.278340387257504e-05,1.570104655239525e-05,17,8,9
9914,ProSlavery,8.592123914353715e-06,1.7253897310324457e-07,4,4,0
9915,ProTrump,2.116596378901769e-05,1.742643628342769e-05,20,10,10
9916,Probably,7.984388320411623e-05,8.989280498679035e-05,100,41,59
9917,Probation,2.095639979110664e-07,3.6233184351681345e-06,3,0,3
9918,Probe,0.00018881716211787043,0.00019859235804183437,229,97,132
9919,Probed,2.095639979110664e-07,5.348708166200577e-06,3,0,3
9920,Probing,1.48790438516857e-05,1.2250267090330355e-05,14,7,7
9921,Problem,0.00020348664197164515,0.00022274781427628854,244,107,137
9922,Problematic,4.400843956132392e-06,7.074097897233022e-06,8,3,5
9923,Procedure,2.3052039770217305e-06,3.6233184351681345e-06,3,1,2
9924,Proceed,2.095639979110664e-07,3.6233184351681345e-06,4,1,3
9925,Proceedings,4.400843956132392e-06,5.348708166200577e-06,5,2,3
9926,Proces,2.954852370546031e-05,3.468033359375216e-05,40,14,26
9927,Processing,2.3052039770217305e-06,3.6233184351681345e-06,3,1,2
9928,Proclaim,2.095639979110664e-07,5.348708166200577e-06,3,0,3
9929,Proclamation,2.3052039770217305e-06,5.348708166200577e-06,4,1,3
9930,Produce,1.9070323809907035e-05,1.3975656821362803e-05,19,9,10
9931,Produced,8.592123914353715e-06,5.348708166200577e-06,7,4,3
9932,Producer,2.3052039770217305e-06,7.074097897233022e-06,6,1,5
9933,Producing,4.400843956132392e-06,1.8979287041356905e-06,3,2,1
9934,Product,2.7452883726349685e-05,4.50326719799468e-05,43,14,29
9935,Production,8.592123914353715e-06,8.79948762826546e-06,12,4,8
9936,Productive,4.400843956132392e-06,1.052487735929791e-05,8,2,6
9937,Productivity,8.592123914353715e-06,7.074097897233022e-06,9,4,5
9938,Prof,8.592123914353715e-06,7.074097897233022e-06,11,5,6
9939,Profession,2.3052039770217305e-06,5.348708166200577e-06,4,1,3
9940,Professional,1.48790438516857e-05,2.2602605476525032e-05,21,8,13
9941,Professor,4.212236358012434e-05,6.573734875233614e-05,62,22,40
9942,Profile,1.48790438516857e-05,2.2602605476525032e-05,21,8,13
9943,Profiling,2.3052039770217305e-06,1.8979287041356905e-06,3,1,2
9944,Profit,5.050492349656699e-05,4.6758061710979285e-05,56,28,28
9945,Profiting,6.496483935243052e-06,3.6233184351681345e-06,5,3,2
9946,Profound,6.496483935243052e-06,3.6233184351681345e-06,5,3,2
9947,Program,0.00013642616264010403,0.00018306385046254245,200,76,124
9948,Programmatic,2.3052039770217305e-06,5.348708166200577e-06,4,1,3
9949,Programme,8.592123914353715e-06,7.074097897233022e-06,8,4,4
9950,Progres,4.212236358012434e-05,4.6758061710979285e-05,57,26,31
9951,Progressive,0.00013642616264010403,0.0001554576147660233,171,73,98
9952,Prohibit,2.3052039770217305e-06,3.6233184351681345e-06,3,1,2
9953,Prohibition,4.400843956132392e-06,1.7253897310324457e-07,4,2,2
9954,Project,6.72700433294523e-05,6.746273848336857e-05,85,38,47
9955,Projected,6.496483935243052e-06,8.79948762826546e-06,9,3,6
9956,Prokhorov,6.496483935243052e-06,1.7253897310324457e-07,4,4,0
9957,Prolonged,2.095639979110664e-07,5.348708166200577e-06,3,0,3
9958,Prom,4.400843956132392e-06,1.8979287041356905e-06,3,2,1
9959,Prominent,2.116596378901769e-05,2.777877466962238e-05,32,12,20
9960,Promise,8.403516316233764e-05,0.00010887209202814718,123,48,75
9961,Promised,1.0687763893464371e-05,2.4327995207557487e-05,20,6,14
9962,Promising,4.400843956132392e-06,1.052487735929791e-05,8,2,6
9963,Promo,4.400843956132392e-06,1.8979287041356905e-06,3,2,1
9964,Promote,2.116596378901769e-05,2.9504164400654783e-05,29,12,17
9965,Promoted,2.3052039770217305e-06,5.348708166200577e-06,4,1,3
9966,Promoting,1.0687763893464371e-05,1.2250267090330355e-05,14,6,8
9967,Promotion,4.400843956132392e-06,7.074097897233022e-06,6,2,4
9968,Prompt,1.48790438516857e-05,1.052487735929791e-05,15,7,8
9969,Proof,3.7931083621902995e-05,3.8131113055817005e-05,44,21,23
9970,Prop,1.0687763893464371e-05,7.074097897233022e-06,9,5,4
9971,Propaganda,6.496483935243052e-06,2.777877466962238e-05,24,6,18
9972,Proper,6.496483935243052e-06,5.348708166200577e-06,7,3,4
9973,Properly,2.3052039770217305e-06,7.074097897233022e-06,6,1,5
9974,Property,3.583544364279237e-05,2.777877466962238e-05,35,19,16
9975,Prophet,4.4218003559234974e-05,3.640572332478458e-05,46,22,24
9976,Proponent,2.095639979110664e-07,8.79948762826546e-06,5,0,5
9977,Proportion,4.400843956132392e-06,1.8979287041356905e-06,3,2,1
9978,Proposal,6.72700433294523e-05,8.299124606266055e-05,87,35,52
9979,Propose,4.840928351745632e-05,5.3659620635109e-05,58,25,33
9980,Proposed,5.4696203454788295e-05,4.50326719799468e-05,65,31,34
9981,Proposition,4.400843956132392e-06,7.074097897233022e-06,6,2,4
9982,Propping,2.3052039770217305e-06,3.6233184351681345e-06,3,1,2
9983,Prosecute,1.0687763893464371e-05,1.3975656821362803e-05,13,5,8
9984,Prosecuted,1.278340387257504e-05,5.348708166200577e-06,10,7,3
9985,Prosecuting,4.400843956132392e-06,3.6233184351681345e-06,4,2,2
9986,Prosecution,1.0687763893464371e-05,2.087721574549256e-05,20,8,12
9987,Prosecutor,7.774824322500554e-05,0.00010024514337298497,106,43,63
9988,Prospect,1.278340387257504e-05,1.742643628342769e-05,16,6,10
9989,Prosperity,2.095639979110664e-07,5.348708166200577e-06,4,0,4
9990,Prosthetic,1.278340387257504e-05,5.348708166200577e-06,11,7,4
9991,Prostitute,1.0687763893464371e-05,1.2250267090330355e-05,14,5,9
9992,Prostitution,8.592123914353715e-06,7.074097897233022e-06,9,4,5
9993,Protect,9.451336305789087e-05,0.00013992910718673112,141,51,90
9994,Protected,2.326160376812834e-05,1.9151826014460126e-05,22,11,11
9995,Protecting,3.7931083621902995e-05,4.330728224891437e-05,44,18,26
9996,Protection,0.00011966104280721883,0.00011577365095227703,136,63,73
9997,Protectionism,2.3052039770217305e-06,1.7253897310324457e-07,3,2,1
9998,Protective,4.400843956132392e-06,1.7253897310324457e-07,3,3,0
9999,Protector,6.496483935243052e-06,1.8979287041356905e-06,4,3,1
10000,Protein,2.3052039770217305e-06,1.8979287041356905e-06,3,2,1
10001,Protest,0.00031455556086451027,0.00024345249104867797,325,163,162
10002,Protestant,4.400843956132392e-06,3.6233184351681345e-06,5,2,3
10003,Protested,2.3052039770217305e-06,3.6233184351681345e-06,4,1,3
10004,Protester,0.0002097735619089774,0.0002141208656211263,256,113,143
10005,Protesting,2.326160376812834e-05,2.9504164400654783e-05,31,12,19
10006,Protestor,2.326160376812834e-05,1.570104655239525e-05,22,12,10
10007,Protocol,1.278340387257504e-05,5.348708166200577e-06,10,7,3
10008,Proton,2.095639979110664e-07,5.348708166200577e-06,3,0,3
10009,Prototype,2.3052039770217305e-06,3.6233184351681345e-06,3,1,2
10010,Proud,1.6974683830796368e-05,1.570104655239525e-05,19,9,10
10011,Prove,6.72700433294523e-05,8.126585633162811e-05,89,34,55
10012,Proved,6.496483935243052e-06,1.052487735929791e-05,10,4,6
10013,Proven,8.592123914353715e-06,1.8979287041356905e-06,6,5,1
10014,Provide,2.7452883726349685e-05,3.640572332478458e-05,37,13,24
10015,Providence,4.400843956132392e-06,3.6233184351681345e-06,4,2,2
10016,Provider,2.326160376812834e-05,1.570104655239525e-05,22,13,9
10017,Providing,1.278340387257504e-05,1.2250267090330355e-05,14,7,7
10018,Province,8.592123914353715e-06,1.052487735929791e-05,13,5,8
10019,Proving,6.496483935243052e-06,3.6233184351681345e-06,7,4,3
10020,Provision,1.0687763893464371e-05,5.348708166200577e-06,10,6,4
10021,Provocation,4.400843956132392e-06,1.8979287041356905e-06,3,2,1
10022,Provocative,4.400843956132392e-06,3.6233184351681345e-06,4,2,2
10023,Provoke,4.400843956132392e-06,3.6233184351681345e-06,4,2,2
10024,Proxy,2.3052039770217305e-06,1.8979287041356905e-06,4,1,3
10025,Pruitt,6.517440335034157e-05,0.00012094982014537423,117,39,78
10026,Psaki,6.496483935243052e-06,8.79948762826546e-06,9,3,6
10027,Psy,6.496483935243052e-06,3.6233184351681345e-06,6,4,2
10028,Psychedelic,2.095639979110664e-07,7.074097897233022e-06,4,0,4
10029,Psychiatrist,2.095639979110664e-07,7.074097897233022e-06,4,0,4
10030,Psychological,1.0687763893464371e-05,7.074097897233022e-06,9,5,4
10031,Psychologist,1.0687763893464371e-05,7.074097897233022e-06,11,6,5
10032,Psychology,1.0687763893464371e-05,5.348708166200577e-06,10,5,5
10033,Pt,2.095639979110664e-07,5.348708166200577e-06,4,0,4
10034,Puberty,2.3052039770217305e-06,5.348708166200577e-06,4,1,3
10035,Public,0.00025797328142852257,0.0002486286602417749,289,138,151
10036,Publication,2.3052039770217305e-06,8.79948762826546e-06,7,2,5
10037,Publicly,1.0687763893464371e-05,1.3975656821362803e-05,15,5,10
10038,Publish,1.48790438516857e-05,1.052487735929791e-05,13,7,6
10039,Published,2.3052039770217305e-06,8.79948762826546e-06,6,1,5
10040,Publisher,4.400843956132392e-06,1.052487735929791e-05,8,2,6
10041,Publishing,2.3052039770217305e-06,7.074097897233022e-06,6,1,5
10042,Puerto,8.403516316233764e-05,0.00010714670229711469,128,56,72
10043,Pug,2.3052039770217305e-06,5.348708166200577e-06,4,1,3
10044,Pulitzer,4.400843956132392e-06,1.052487735929791e-05,8,2,6
10045,Pulitzerwinning,4.400843956132392e-06,1.8979287041356905e-06,4,2,2
10046,Pull,5.050492349656699e-05,4.6758061710979285e-05,56,26,30
10047,Pulled,6.496483935243052e-06,1.3975656821362803e-05,13,3,10
10048,Pulling,1.9070323809907035e-05,1.9151826014460126e-05,25,10,15
10049,Pulse,8.592123914353715e-06,3.6233184351681345e-06,6,4,2
10050,Pump,4.400843956132392e-06,5.348708166200577e-06,5,2,3
10051,Pumped,4.400843956132392e-06,1.8979287041356905e-06,5,3,2
10052,Pumping,2.3052039770217305e-06,5.348708166200577e-06,4,1,3
10053,Pumpkin,2.3052039770217305e-06,5.348708166200577e-06,5,1,4
10054,Punch,1.0687763893464371e-05,7.074097897233022e-06,9,5,4
10055,Punching,4.400843956132392e-06,3.6233184351681345e-06,5,2,3
10056,Punchline,2.3052039770217305e-06,3.6233184351681345e-06,3,1,2
10057,Pundit,1.48790438516857e-05,1.9151826014460126e-05,20,8,12
10058,Punish,2.326160376812834e-05,1.742643628342769e-05,25,13,12
10059,Punished,1.9070323809907035e-05,1.052487735929791e-05,18,12,6
10060,Punishing,1.0687763893464371e-05,8.79948762826546e-06,12,5,7
10061,Punishment,2.116596378901769e-05,1.2250267090330355e-05,21,11,10
10062,Punjab,6.496483935243052e-06,1.052487735929791e-05,10,3,7
10063,Punk,2.3052039770217305e-06,3.6233184351681345e-06,3,1,2
10064,Punt,6.496483935243052e-06,3.6233184351681345e-06,5,3,2
10065,Pup,1.48790438516857e-05,2.6053384938589907e-05,23,7,16
10066,Pupil,2.3052039770217305e-06,1.8979287041356905e-06,3,2,1
10067,Puppet,2.3052039770217305e-06,7.074097897233022e-06,5,1,4
10068,Puppy,2.7452883726349685e-05,3.468033359375216e-05,40,17,23
10069,Purchase,1.6974683830796368e-05,8.79948762826546e-06,15,8,7
10070,Purchasing,4.400843956132392e-06,1.7253897310324457e-07,3,3,0
10071,Purdue,6.496483935243052e-06,1.3975656821362803e-05,13,3,10
10072,Pure,4.400843956132392e-06,1.2250267090330355e-05,9,2,7
10073,Purge,1.6974683830796368e-05,1.3975656821362803e-05,18,8,10
10074,Purple,1.48790438516857e-05,8.79948762826546e-06,12,7,5
10075,Purpose,2.3052039770217305e-06,1.2250267090330355e-05,9,1,8
10076,Purse,4.400843956132392e-06,1.8979287041356905e-06,3,2,1
10077,Pursue,2.3052039770217305e-06,1.3975656821362803e-05,10,1,9
10078,Pursued,2.3052039770217305e-06,1.8979287041356905e-06,3,1,2
10079,Pursuing,1.0687763893464371e-05,1.8979287041356905e-06,6,5,1
10080,Pursuit,8.592123914353715e-06,5.348708166200577e-06,8,4,4
10081,Push,0.0001531912824729893,0.0002020431375038992,215,88,127
10082,Pushback,2.3052039770217305e-06,3.6233184351681345e-06,3,1,2
10083,Pushed,1.48790438516857e-05,1.3975656821362803e-05,15,7,8
10084,Pushing,4.212236358012434e-05,2.6053384938589907e-05,39,22,17
10085,Pussy,3.3739803663681634e-05,3.640572332478458e-05,39,18,21
10086,Put,0.00014480872255654665,0.00017616229153841266,196,80,116
10087,Putin,0.0006184233578355568,0.0005522972529034856,687,320,367
10088,PutinTrump,2.3052039770217305e-06,5.348708166200577e-06,4,1,3
10089,Putting,1.9070323809907035e-05,4.50326719799468e-05,44,14,30
10090,Puzder,8.592123914353715e-06,1.052487735929791e-05,14,4,10
10091,PwC,8.592123914353715e-06,3.6233184351681345e-06,7,5,2
10092,Py,6.496483935243052e-06,3.6233184351681345e-06,5,3,2
10093,Pyeongchang,2.3052039770217305e-06,3.6233184351681345e-06,3,1,2
10094,Pyongyang,4.4218003559234974e-05,2.9504164400654783e-05,43,24,19
10095,Pyramid,1.9070323809907035e-05,1.2250267090330355e-05,16,9,7
10096,Python,1.48790438516857e-05,3.6233184351681345e-06,10,7,3
10097,QA,3.7931083621902995e-05,4.8483451442011706e-05,50,19,31
10098,QAnon,1.0687763893464371e-05,1.3975656821362803e-05,15,5,10
10099,QZ8501,2.095639979110664e-07,3.6233184351681345e-06,4,2,2
10100,Qaddafi,2.954852370546031e-05,2.777877466962238e-05,31,14,17
10101,Qaeda,9.03220830996695e-05,8.644202552472544e-05,101,46,55
10102,Qaedalinked,2.3052039770217305e-06,3.6233184351681345e-06,4,1,3
10103,Qaida,2.095639979110664e-07,8.79948762826546e-06,5,0,5
10104,Qalamoun,2.3052039770217305e-06,3.6233184351681345e-06,3,1,2
10105,QampA,6.496483935243052e-06,5.348708166200577e-06,7,3,4
10106,Qanta,4.400843956132392e-06,5.348708166200577e-06,6,2,4
10107,Qatar,9.24177230787802e-05,0.0001036959228350498,119,45,74
10108,Qatari,1.0687763893464371e-05,1.9151826014460126e-05,16,5,11
10109,Quack,2.3052039770217305e-06,3.6233184351681345e-06,3,1,2
10110,Quadruple,2.3052039770217305e-06,3.6233184351681345e-06,3,1,2
10111,Quagmire,2.3052039770217305e-06,5.348708166200577e-06,4,1,3
10112,Quake,8.592123914353715e-06,1.3975656821362803e-05,16,7,9
10113,Qualification,8.592123914353715e-06,1.7253897310324457e-07,4,4,0
10114,Qualified,1.278340387257504e-05,1.3975656821362803e-05,15,7,8
10115,Qualify,2.3052039770217305e-06,3.6233184351681345e-06,4,1,3
10116,Quality,8.592123914353715e-06,7.074097897233022e-06,9,5,4
10117,Quantum,4.400843956132392e-06,3.6233184351681345e-06,5,3,2
10118,Quarantine,2.3052039770217305e-06,5.348708166200577e-06,5,1,4
10119,Quarantined,4.400843956132392e-06,3.6233184351681345e-06,6,2,4
10120,Quarter,2.5357243747239038e-05,1.742643628342769e-05,25,14,11
10121,Quartet,2.095639979110664e-07,3.6233184351681345e-06,3,0,3
10122,Quash,1.0687763893464371e-05,1.7253897310324457e-07,5,5,0
10123,Quebec,6.307876337123095e-05,4.50326719799468e-05,62,33,29
10124,Queen,5.888748341300963e-05,7.436429740749831e-05,76,28,48
10125,Queensland,2.326160376812834e-05,3.122955413168725e-05,34,12,22
10126,Quest,1.6974683830796368e-05,8.79948762826546e-06,13,8,5
10127,Question,0.00019300844207609195,0.0001968669683108019,240,104,136
10128,Questionable,6.496483935243052e-06,8.79948762826546e-06,10,4,6
10129,Questioned,6.496483935243052e-06,7.074097897233022e-06,7,3,4
10130,Questioning,1.278340387257504e-05,2.087721574549256e-05,19,6,13
10131,Quick,1.48790438516857e-05,1.2250267090330355e-05,18,9,9
10132,Quickly,1.278340387257504e-05,7.074097897233022e-06,11,7,4
10133,Quiet,1.278340387257504e-05,2.087721574549256e-05,22,6,16
10134,Quietly,2.326160376812834e-05,1.9151826014460126e-05,27,14,13
10135,Quinn,6.496483935243052e-06,7.074097897233022e-06,7,3,4
10136,Quinnipiac,4.400843956132392e-06,1.8979287041356905e-06,3,2,1
10137,Quinton,2.095639979110664e-07,3.6233184351681345e-06,3,1,2
10138,Quirky,4.400843956132392e-06,1.8979287041356905e-06,4,2,2
10139,Quist,4.400843956132392e-06,8.79948762826546e-06,7,2,5
10140,Quit,6.936568330856297e-05,7.263890767646595e-05,80,35,45
10141,Quite,1.278340387257504e-05,2.2602605476525032e-05,23,7,16
10142,Quito,2.3052039770217305e-06,3.6233184351681345e-06,3,1,2
10143,Quitting,6.496483935243052e-06,5.348708166200577e-06,6,3,3
10144,Quiz,2.116596378901769e-05,3.122955413168725e-05,31,11,20
10145,Quo,4.400843956132392e-06,1.8979287041356905e-06,4,3,1
10146,Quota,2.095639979110664e-07,5.348708166200577e-06,5,1,4
10147,Quote,8.592123914353715e-06,2.087721574549256e-05,20,4,16
10148,Quran,1.9070323809907035e-05,1.2250267090330355e-05,18,10,8
10149,RAF,1.0687763893464371e-05,1.052487735929791e-05,12,5,7
10150,RAriz,6.496483935243052e-06,5.348708166200577e-06,7,3,4
10151,RB,1.9070323809907035e-05,1.3975656821362803e-05,17,9,8
10152,RBG,4.400843956132392e-06,5.348708166200577e-06,5,2,3
10153,RCMP,1.48790438516857e-05,8.79948762826546e-06,15,8,7
10154,RCO,4.400843956132392e-06,7.074097897233022e-06,6,2,4
10155,REAL,2.3052039770217305e-06,3.6233184351681345e-06,3,1,2
10156,REALLY,1.0687763893464371e-05,1.8979287041356905e-06,8,5,3
10157,REDDIT,2.3052039770217305e-06,1.8979287041356905e-06,3,1,2
10158,REI,8.592123914353715e-06,8.79948762826546e-06,10,5,5
10159,RELATED,2.3052039770217305e-06,8.79948762826546e-06,7,2,5
10160,REPORT,1.48790438516857e-05,2.087721574549256e-05,21,8,13
10161,RESULT,6.496483935243052e-06,1.7253897310324457e-07,3,3,0
10162,RFla,2.095639979110664e-07,1.8979287041356905e-06,3,1,2
10163,RIA,2.095639979110664e-07,3.6233184351681345e-06,3,0,3
10164,RIAA,2.3052039770217305e-06,5.348708166200577e-06,5,2,3
10165,RIGHT,2.3052039770217305e-06,1.8979287041356905e-06,3,1,2
10166,RIP,6.496483935243052e-06,1.570104655239525e-05,16,5,11
10167,RInd,2.095639979110664e-07,3.6233184351681345e-06,3,1,2
10168,RKY,4.400843956132392e-06,1.8979287041356905e-06,3,2,1
10169,RLa,4.400843956132392e-06,1.8979287041356905e-06,3,2,1
10170,RNC,0.00010289592297433347,0.00010542131256608228,116,51,65
10171,RNY,4.400843956132392e-06,3.6233184351681345e-06,6,3,3
10172,ROI,2.3052039770217305e-06,3.6233184351681345e-06,3,1,2
10173,ROhio,2.3052039770217305e-06,1.8979287041356905e-06,3,1,2
10174,RPa,4.400843956132392e-06,3.6233184351681345e-06,5,2,3
10175,RSA,2.095639979110664e-07,7.074097897233022e-06,4,0,4
10176,RSC,2.095639979110664e-07,5.348708166200577e-06,4,1,3
10177,RT,3.3739803663681634e-05,1.9151826014460126e-05,30,17,13
10178,RTenn,6.496483935243052e-06,1.8979287041356905e-06,4,3,1
10179,RTexa,4.400843956132392e-06,7.074097897233022e-06,6,2,4
10180,RU486,2.3052039770217305e-06,3.6233184351681345e-06,3,1,2
10181,RUtah,2.3052039770217305e-06,1.8979287041356905e-06,3,2,1
10182,RWi,4.400843956132392e-06,5.348708166200577e-06,5,2,3
10183,Ra,4.400843956132392e-06,1.8979287041356905e-06,4,3,1
10184,Rabbi,2.954852370546031e-05,1.570104655239525e-05,30,15,15
10185,Rabbit,1.278340387257504e-05,7.074097897233022e-06,10,6,4
10186,Rabid,2.3052039770217305e-06,3.6233184351681345e-06,3,1,2
10187,Rabin,2.3052039770217305e-06,3.6233184351681345e-06,3,1,2
10188,Race,0.00024120816159563723,0.00034697587491062454,352,133,219
10189,Racetrack,4.400843956132392e-06,5.348708166200577e-06,5,2,3
10190,Rachel,1.48790438516857e-05,2.6053384938589907e-05,23,7,16
10191,Racial,4.840928351745632e-05,4.6758061710979285e-05,60,24,36
10192,Racially,2.095639979110664e-07,1.052487735929791e-05,6,0,6
10193,Racing,2.095639979110664e-07,8.79948762826546e-06,5,0,5
10194,Racism,6.098312339212028e-05,6.918812821440096e-05,77,33,44
10195,Racist,0.00011127848289077625,0.00014337988664879628,148,57,91
10196,Racket,2.3052039770217305e-06,3.6233184351681345e-06,3,1,2
10197,Radar,4.400843956132392e-06,1.8979287041356905e-06,5,2,3
10198,Radiation,3.7931083621902995e-05,3.122955413168725e-05,37,19,18
10199,Radical,5.260056347567764e-05,3.2954943862719716e-05,49,27,22
10200,Radicalization,2.095639979110664e-07,3.6233184351681345e-06,3,1,2
10201,Radically,6.496483935243052e-06,5.348708166200577e-06,7,4,3
10202,Radio,2.954852370546031e-05,3.640572332478458e-05,43,20,23
10203,RadioShack,4.400843956132392e-06,7.074097897233022e-06,6,2,4
10204,Radioactive,1.6974683830796368e-05,1.742643628342769e-05,22,8,14
10205,Radioactivity,2.3052039770217305e-06,1.8979287041356905e-06,3,1,2
10206,Rafael,8.592123914353715e-06,3.6233184351681345e-06,7,5,2
10207,Rafah,2.3052039770217305e-06,8.79948762826546e-06,6,1,5
10208,Rafale,4.400843956132392e-06,3.6233184351681345e-06,4,2,2
10209,Raffle,2.095639979110664e-07,5.348708166200577e-06,3,0,3
10210,Rafik,2.095639979110664e-07,7.074097897233022e-06,4,0,4
10211,Rafsanjani,6.496483935243052e-06,1.8979287041356905e-06,4,3,1
10212,Rage,2.326160376812834e-05,2.9504164400654783e-05,31,14,17
10213,Raging,6.496483935243052e-06,8.79948762826546e-06,8,3,5
10214,Rahami,2.095639979110664e-07,1.052487735929791e-05,6,0,6
10215,Rahm,1.9070323809907035e-05,1.052487735929791e-05,18,10,8
10216,Raid,6.936568330856297e-05,7.781507686956326e-05,93,42,51
10217,Raider,2.095639979110664e-07,5.348708166200577e-06,4,0,4
10218,Raiding,6.496483935243052e-06,1.7253897310324457e-07,3,3,0
10219,Raif,6.496483935243052e-06,3.6233184351681345e-06,5,3,2
10220,Rail,2.5357243747239038e-05,1.742643628342769e-05,23,13,10
10221,Railroad,6.496483935243052e-06,5.348708166200577e-06,6,3,3
10222,Railway,2.116596378901769e-05,8.79948762826546e-06,15,10,5
10223,Rain,2.326160376812834e-05,1.570104655239525e-05,22,13,9
10224,Rainbow,6.496483935243052e-06,8.79948762826546e-06,8,3,5
10225,Rainforest,1.0687763893464371e-05,8.79948762826546e-06,10,5,5
10226,Rainy,4.400843956132392e-06,1.8979287041356905e-06,3,2,1
10227,Raise,0.00010918284291166549,0.0001589083942280881,157,62,95
10228,Raised,2.954852370546031e-05,1.742643628342769e-05,28,16,12
10229,Raising,2.116596378901769e-05,2.2602605476525032e-05,30,12,18
10230,Ral,6.496483935243052e-06,5.348708166200577e-06,6,3,3
10231,Rally,0.00011966104280721883,0.0001278513790695043,144,64,80
10232,Rallying,2.3052039770217305e-06,8.79948762826546e-06,6,1,5
10233,Ralph,2.5357243747239038e-05,1.570104655239525e-05,28,17,11
10234,Ramadan,2.326160376812834e-05,2.4327995207557487e-05,27,11,16
10235,Ramadi,1.48790438516857e-05,1.3975656821362803e-05,18,7,11
10236,Ramirez,2.3052039770217305e-06,5.348708166200577e-06,6,2,4
10237,Ramon,4.400843956132392e-06,1.8979287041356905e-06,3,2,1
10238,Ramp,1.48790438516857e-05,1.2250267090330355e-05,17,8,9
10239,RampD,4.400843956132392e-06,1.8979287041356905e-06,3,2,1
10240,Rampage,2.3052039770217305e-06,7.074097897233022e-06,5,1,4
10241,Rampant,1.48790438516857e-05,1.052487735929791e-05,17,7,10
10242,Ramzan,2.3052039770217305e-06,1.8979287041356905e-06,3,1,2
10243,Ran,1.278340387257504e-05,7.074097897233022e-06,10,6,4
10244,Rana,2.3052039770217305e-06,5.348708166200577e-06,4,1,3
10245,Ranch,8.592123914353715e-06,1.8979287041356905e-06,5,4,1
10246,Rancher,2.3052039770217305e-06,3.6233184351681345e-06,3,1,2
10247,Rand,7.774824322500554e-05,8.989280498679035e-05,92,38,54
10248,Randi,4.400843956132392e-06,8.79948762826546e-06,7,2,5
10249,Random,6.496483935243052e-06,7.074097897233022e-06,7,3,4
10250,Randomly,2.3052039770217305e-06,3.6233184351681345e-06,4,1,3
10251,Randy,2.3052039770217305e-06,8.79948762826546e-06,6,1,5
10252,Range,4.400843956132392e-06,1.2250267090330355e-05,10,2,8
10253,Rangel,2.3052039770217305e-06,3.6233184351681345e-06,3,1,2
10254,Ranger,1.278340387257504e-05,5.348708166200577e-06,11,8,3
10255,Rank,1.0687763893464371e-05,3.6233184351681345e-06,8,5,3
10256,Ranked,4.400843956132392e-06,5.348708166200577e-06,5,2,3
10257,Ranking,1.6974683830796368e-05,1.570104655239525e-05,19,9,10
10258,Ransom,8.592123914353715e-06,1.7253897310324457e-07,6,4,2
10259,Ransomware,8.592123914353715e-06,1.8979287041356905e-06,5,4,1
10260,Rant,3.583544364279237e-05,3.122955413168725e-05,37,18,19
10261,Rap,1.0687763893464371e-05,8.79948762826546e-06,10,5,5
10262,Rape,0.00010708720293255492,9.851975364195259e-05,122,55,67
10263,Raped,2.5357243747239038e-05,1.052487735929791e-05,20,14,6
10264,Raphael,8.592123914353715e-06,1.8979287041356905e-06,5,4,1
10265,Rapid,6.496483935243052e-06,1.2250267090330355e-05,11,4,7
10266,Rapidly,2.095639979110664e-07,5.348708166200577e-06,4,1,3
10267,Raping,2.3052039770217305e-06,5.348708166200577e-06,4,1,3
10268,Rapist,1.48790438516857e-05,3.6233184351681345e-06,10,7,3
10269,Rapper,2.3052039770217305e-06,1.3975656821362803e-05,10,1,9
10270,Raptor,4.400843956132392e-06,3.6233184351681345e-06,4,2,2
10271,Raqqa,1.0687763893464371e-05,7.074097897233022e-06,15,6,9
10272,Rare,6.098312339212028e-05,5.3659620635109e-05,71,31,40
10273,Rarely,8.592123914353715e-06,3.6233184351681345e-06,6,4,2
10274,Rash,4.400843956132392e-06,1.8979287041356905e-06,3,2,1
10275,Rashida,2.095639979110664e-07,1.8979287041356905e-06,3,2,1
10276,Raskin,2.095639979110664e-07,8.79948762826546e-06,5,0,5
10277,Rat,1.278340387257504e-05,1.3975656821362803e-05,15,7,8
10278,Rate,9.870464301611217e-05,0.00010024514337298497,118,53,65
10279,Rated,2.3052039770217305e-06,7.074097897233022e-06,6,2,4
10280,Rather,5.6791843433898893e-05,4.8483451442011706e-05,57,29,28
10281,Rating,3.1644163684570994e-05,4.330728224891437e-05,53,23,30
10282,Rationing,6.496483935243052e-06,3.6233184351681345e-06,5,3,2
10283,Ratko,2.3052039770217305e-06,1.7253897310324457e-07,5,2,3
10284,Raucou,2.095639979110664e-07,7.074097897233022e-06,4,0,4
10285,Raul,2.3052039770217305e-06,8.79948762826546e-06,8,2,6
10286,Rauner,4.400843956132392e-06,5.348708166200577e-06,5,2,3
10287,Rave,4.400843956132392e-06,3.6233184351681345e-06,4,2,2
10288,Raw,1.278340387257504e-05,8.79948762826546e-06,13,7,6
10289,Ray,8.592123914353715e-06,2.6053384938589907e-05,21,6,15
10290,Raymond,2.3052039770217305e-06,1.052487735929791e-05,9,1,8
10291,ReElected,2.3052039770217305e-06,1.570104655239525e-05,11,1,10
10292,ReElection,2.116596378901769e-05,3.8131113055817005e-05,35,12,23
10293,Reach,6.098312339212028e-05,8.989280498679035e-05,94,32,62
10294,Reached,1.48790438516857e-05,1.2250267090330355e-05,15,7,8
10295,Reaching,8.592123914353715e-06,1.052487735929791e-05,11,5,6
10296,React,1.9070323809907035e-05,1.742643628342769e-05,21,11,10
10297,Reacted,4.400843956132392e-06,1.8979287041356905e-06,3,2,1
10298,Reaction,1.9070323809907035e-05,2.2602605476525032e-05,27,13,14
10299,Reactor,2.954852370546031e-05,2.6053384938589907e-05,30,14,16
10300,Read,9.660900303700153e-05,0.00010542131256608228,122,53,69
10301,Reader,2.326160376812834e-05,1.3975656821362803e-05,21,13,8
10302,Readines,2.3052039770217305e-06,1.8979287041356905e-06,3,2,1
10303,Reading,1.48790438516857e-05,3.122955413168725e-05,26,8,18
10304,Ready,0.0001154697628489974,0.00013130215853156914,153,62,91
10305,Readying,6.496483935243052e-06,1.7253897310324457e-07,3,3,0
10306,Reaffirm,2.3052039770217305e-06,5.348708166200577e-06,4,1,3
10307,Reagan,3.7931083621902995e-05,3.2954943862719716e-05,40,19,21
10308,Reaganera,6.496483935243052e-06,1.7253897310324457e-07,3,3,0
10309,Real,0.0002097735619089774,0.00018306385046254245,234,113,121
10310,RealLife,2.3052039770217305e-06,3.6233184351681345e-06,5,3,2
10311,Realism,2.3052039770217305e-06,3.6233184351681345e-06,3,1,2
10312,Realistic,2.095639979110664e-07,5.348708166200577e-06,4,1,3
10313,Reality,5.6791843433898893e-05,6.573734875233614e-05,72,32,40
10314,Realize,1.48790438516857e-05,1.570104655239525e-05,16,7,9
10315,Realized,4.400843956132392e-06,5.348708166200577e-06,5,2,3
10316,Realizing,2.095639979110664e-07,7.074097897233022e-06,6,0,6
10317,Reallife,2.095639979110664e-07,3.6233184351681345e-06,4,1,3
10318,Really,0.00024120816159563723,0.00026760794728313193,304,131,173
10319,Reap,4.400843956132392e-06,3.6233184351681345e-06,4,2,2
10320,Rear,2.095639979110664e-07,5.348708166200577e-06,3,0,3
10321,Reason,0.00014061744259832545,0.00014683066611086105,168,74,94
10322,Reasonable,1.48790438516857e-05,7.074097897233022e-06,11,7,4
10323,Reassure,8.592123914353715e-06,3.6233184351681345e-06,7,4,3
10324,Rebecca,2.3052039770217305e-06,3.6233184351681345e-06,4,2,2
10325,Rebekah,4.212236358012434e-05,1.3975656821362803e-05,28,20,8
10326,Rebel,9.660900303700153e-05,9.506897417988779e-05,112,52,60
10327,Rebellion,6.496483935243052e-06,1.8979287041356905e-06,4,3,1
10328,Reboot,8.592123914353715e-06,1.7253897310324457e-07,4,4,0
10329,Reborn,6.496483935243052e-06,1.8979287041356905e-06,4,3,1
10330,Rebound,2.3052039770217305e-06,1.052487735929791e-05,7,1,6
10331,Rebuff,2.3052039770217305e-06,1.8979287041356905e-06,4,1,3
10332,Rebuild,8.592123914353715e-06,8.79948762826546e-06,11,4,7
10333,Rebuilding,6.496483935243052e-06,7.074097897233022e-06,7,3,4
10334,Rebuke,1.48790438516857e-05,2.087721574549256e-05,22,8,14
10335,Recall,2.5357243747239038e-05,2.4327995207557487e-05,30,13,17
10336,Recalled,2.3052039770217305e-06,8.79948762826546e-06,8,2,6
10337,Recapture,4.400843956132392e-06,1.8979287041356905e-06,4,2,2
10338,Receipt,4.400843956132392e-06,1.8979287041356905e-06,4,2,2
10339,Receive,5.4696203454788295e-05,4.330728224891437e-05,56,29,27
10340,Received,1.278340387257504e-05,7.074097897233022e-06,11,6,5
10341,Receiving,6.496483935243052e-06,1.8979287041356905e-06,4,3,1
10342,Recent,5.050492349656699e-05,4.330728224891437e-05,52,24,28
10343,Recently,1.278340387257504e-05,1.052487735929791e-05,14,7,7
10344,Recep,2.7452883726349685e-05,1.3975656821362803e-05,25,14,11
10345,Reception,2.095639979110664e-07,5.348708166200577e-06,4,0,4
10346,Reces,8.592123914353715e-06,3.6233184351681345e-06,6,4,2
10347,Recession,2.954852370546031e-05,3.985650278684949e-05,39,14,25
10348,Recipe,2.3052039770217305e-06,3.6233184351681345e-06,3,1,2
10349,Recipient,1.6974683830796368e-05,8.79948762826546e-06,14,8,6
10350,Reciprocity,4.400843956132392e-06,1.8979287041356905e-06,3,2,1
10351,Reckles,6.496483935243052e-06,5.348708166200577e-06,6,3,3
10352,Reckoning,6.496483935243052e-06,7.074097897233022e-06,9,4,5
10353,Reclaim,4.400843956132392e-06,1.8979287041356905e-06,4,3,1
10354,Reclaiming,6.496483935243052e-06,3.6233184351681345e-06,5,3,2
10355,Recognition,1.48790438516857e-05,1.570104655239525e-05,17,8,9
10356,Recognize,2.7452883726349685e-05,2.4327995207557487e-05,32,14,18
10357,Recognized,2.3052039770217305e-06,8.79948762826546e-06,6,1,5
10358,Recognizing,6.496483935243052e-06,7.074097897233022e-06,10,5,5
10359,Recommend,1.6974683830796368e-05,8.79948762826546e-06,13,8,5
10360,Recommendation,6.496483935243052e-06,3.6233184351681345e-06,5,3,2
10361,Reconciliation,8.592123914353715e-06,7.074097897233022e-06,9,4,5
10362,Reconsider,1.0687763893464371e-05,8.79948762826546e-06,10,5,5
10363,Reconstruction,1.278340387257504e-05,5.348708166200577e-06,10,7,3
10364,Record,0.00015947820241032126,0.0002244732040073209,228,84,144
10365,RecordBreaking,4.400843956132392e-06,7.074097897233022e-06,7,2,5
10366,Recorded,6.496483935243052e-06,8.79948762826546e-06,9,4,5
10367,Recording,1.9070323809907035e-05,1.3975656821362803e-05,19,11,8
10368,Recount,1.48790438516857e-05,2.6053384938589907e-05,26,8,18
10369,Recover,1.278340387257504e-05,8.79948762826546e-06,12,7,5
10370,Recovered,6.496483935243052e-06,8.79948762826546e-06,10,4,6
10371,Recovering,6.496483935243052e-06,1.2250267090330355e-05,10,3,7
10372,Recovery,1.9070323809907035e-05,4.50326719799468e-05,40,11,29
10373,Recreate,1.0687763893464371e-05,1.8979287041356905e-06,6,5,1
10374,Recreational,8.592123914353715e-06,5.348708166200577e-06,8,4,4
10375,Recruit,1.6974683830796368e-05,1.570104655239525e-05,17,8,9
10376,Recruiter,2.3052039770217305e-06,3.6233184351681345e-06,3,1,2
10377,Recruiting,6.496483935243052e-06,3.6233184351681345e-06,5,3,2
10378,Recycle,4.400843956132392e-06,1.7253897310324457e-07,3,2,1
10379,Recycled,4.400843956132392e-06,3.6233184351681345e-06,5,3,2
10380,Recycling,6.496483935243052e-06,5.348708166200577e-06,6,3,3
10381,Red,0.00016576512234765329,0.00012612598933847184,170,85,85
10382,Reddit,5.888748341300963e-05,5.1934230904076595e-05,62,29,33
10383,Redditor,1.0687763893464371e-05,7.074097897233022e-06,12,6,6
10384,Redefine,6.496483935243052e-06,5.348708166200577e-06,7,4,3
10385,Redefining,2.3052039770217305e-06,3.6233184351681345e-06,6,2,4
10386,Redemption,4.400843956132392e-06,1.8979287041356905e-06,3,2,1
10387,Reding,2.095639979110664e-07,5.348708166200577e-06,3,0,3
10388,Redistricting,1.0687763893464371e-05,1.3975656821362803e-05,13,5,8
10389,Redrawing,4.400843956132392e-06,5.348708166200577e-06,5,2,3
10390,Redstone,2.095639979110664e-07,8.79948762826546e-06,5,0,5
10391,Reduce,2.116596378901769e-05,4.50326719799468e-05,44,13,31
10392,Reduced,4.400843956132392e-06,1.8979287041356905e-06,3,2,1
10393,Reducing,1.48790438516857e-05,8.79948762826546e-06,12,7,5
10394,Reduction,1.0687763893464371e-05,1.2250267090330355e-05,12,5,7
10395,Redwood,2.3052039770217305e-06,3.6233184351681345e-06,3,1,2
10396,Reed,4.400843956132392e-06,7.074097897233022e-06,6,2,4
10397,Reef,6.098312339212028e-05,6.573734875233614e-05,71,30,41
10398,Reelection,1.6974683830796368e-05,1.742643628342769e-05,20,8,12
10399,Reeling,4.400843956132392e-06,1.8979287041356905e-06,5,3,2
10400,Reeve,2.3052039770217305e-06,8.79948762826546e-06,6,1,5
10401,Refer,6.496483935243052e-06,7.074097897233022e-06,8,3,5
10402,Reference,8.592123914353715e-06,3.6233184351681345e-06,7,5,2
10403,Referendum,1.9070323809907035e-05,1.570104655239525e-05,20,9,11
10404,Referred,4.400843956132392e-06,3.6233184351681345e-06,4,2,2
10405,Refinance,4.400843956132392e-06,1.7253897310324457e-07,3,3,0
10406,Reflect,1.278340387257504e-05,1.742643628342769e-05,17,7,10
10407,Reflecting,6.496483935243052e-06,3.6233184351681345e-06,5,3,2
10408,Reflection,1.6974683830796368e-05,8.79948762826546e-06,14,9,5
10409,Reform,0.00018881716211787043,0.00021584625535215864,242,103,139
10410,Reformer,1.278340387257504e-05,3.6233184351681345e-06,8,6,2
10411,Reforming,4.400843956132392e-06,1.8979287041356905e-06,3,2,1
10412,Refrigerator,6.496483935243052e-06,1.7253897310324457e-07,3,3,0
10413,Refuge,2.116596378901769e-05,1.052487735929791e-05,17,11,6
10414,Refugee,0.00016995640230587486,0.00021584625535215864,226,87,139
10415,Refund,1.6974683830796368e-05,2.6053384938589907e-05,23,8,15
10416,Refus,6.307876337123095e-05,7.263890767646595e-05,77,34,43
10417,Refusal,2.954852370546031e-05,1.2250267090330355e-05,21,14,7
10418,Refuse,2.5357243747239038e-05,2.777877466962238e-05,30,13,17
10419,Refused,1.6974683830796368e-05,2.087721574549256e-05,22,8,14
10420,Refusing,2.5357243747239038e-05,1.570104655239525e-05,21,12,9
10421,Refute,4.400843956132392e-06,1.8979287041356905e-06,3,2,1
10422,Reg,4.400843956132392e-06,1.8979287041356905e-06,3,2,1
10423,Regain,8.592123914353715e-06,3.6233184351681345e-06,7,5,2
10424,Regaining,4.400843956132392e-06,1.8979287041356905e-06,4,3,1
10425,Regard,4.400843956132392e-06,5.348708166200577e-06,6,3,3
10426,Regarding,6.496483935243052e-06,7.074097897233022e-06,8,4,4
10427,Regardles,1.48790438516857e-05,1.3975656821362803e-05,17,7,10
10428,Regime,2.7452883726349685e-05,2.2602605476525032e-05,27,13,14
10429,Region,2.5357243747239038e-05,1.742643628342769e-05,25,13,12
10430,Regional,1.278340387257504e-05,5.348708166200577e-06,11,6,5
10431,Register,2.5357243747239038e-05,3.6233184351681345e-06,15,12,3
10432,Registered,6.496483935243052e-06,7.074097897233022e-06,7,3,4
10433,Registering,2.095639979110664e-07,5.348708166200577e-06,4,1,3
10434,Registration,2.326160376812834e-05,1.9151826014460126e-05,28,15,13
10435,Registry,6.496483935243052e-06,3.6233184351681345e-06,6,4,2
10436,Regret,1.0687763893464371e-05,2.4327995207557487e-05,23,6,17
10437,Regular,1.278340387257504e-05,1.2250267090330355e-05,14,7,7
10438,Regulate,8.592123914353715e-06,5.348708166200577e-06,9,4,5
10439,Regulated,2.3052039770217305e-06,3.6233184351681345e-06,3,1,2
10440,Regulating,8.592123914353715e-06,1.8979287041356905e-06,7,6,1
10441,Regulation,4.002672360101368e-05,3.640572332478458e-05,46,21,25
10442,Regulator,2.954852370546031e-05,1.742643628342769e-05,24,14,10
10443,Regulatory,6.496483935243052e-06,8.79948762826546e-06,9,4,5
10444,Rehman,2.3052039770217305e-06,5.348708166200577e-06,4,1,3
10445,Reich,1.0687763893464371e-05,7.074097897233022e-06,10,6,4
10446,Reid,7.355696326678427e-05,8.126585633162811e-05,92,42,50
10447,Reign,2.3052039770217305e-06,3.6233184351681345e-06,3,1,2
10448,Reignite,2.3052039770217305e-06,3.6233184351681345e-06,4,1,3
10449,Reilly,1.6974683830796368e-05,5.348708166200577e-06,11,8,3
10450,Rein,6.496483935243052e-06,5.348708166200577e-06,6,3,3
10451,Reince,3.3739803663681634e-05,1.570104655239525e-05,27,17,10
10452,Reindeer,2.3052039770217305e-06,3.6233184351681345e-06,4,2,2
10453,Reinfeldt,4.400843956132392e-06,1.8979287041356905e-06,3,2,1
10454,Reinstate,4.400843956132392e-06,3.6233184351681345e-06,6,4,2
10455,Reinstating,6.496483935243052e-06,3.6233184351681345e-06,5,3,2
10456,Reintroduce,2.3052039770217305e-06,3.6233184351681345e-06,3,1,2
10457,Reinventing,4.400843956132392e-06,1.8979287041356905e-06,3,2,1
10458,Reject,9.660900303700153e-05,7.781507686956326e-05,107,50,57
10459,Rejected,8.592123914353715e-06,1.2250267090330355e-05,11,4,7
10460,Rejecting,8.592123914353715e-06,7.074097897233022e-06,9,5,4
10461,Rejection,1.0687763893464371e-05,7.074097897233022e-06,10,5,5
10462,Rejoice,4.400843956132392e-06,3.6233184351681345e-06,6,3,3
10463,Related,6.496483935243052e-06,3.6233184351681345e-06,7,3,4
10464,Relation,4.212236358012434e-05,4.50326719799468e-05,49,20,29
10465,Relationship,2.954852370546031e-05,2.777877466962238e-05,32,16,16
10466,Relative,8.592123914353715e-06,1.2250267090330355e-05,11,4,7
10467,Relatively,2.3052039770217305e-06,3.6233184351681345e-06,4,1,3
10468,Relax,2.3052039770217305e-06,3.6233184351681345e-06,3,1,2
10469,Release,0.00016995640230587486,0.00013130215853156914,172,85,87
10470,Released,5.888748341300963e-05,4.330728224891437e-05,57,31,26
10471,Releasing,8.592123914353715e-06,1.3975656821362803e-05,12,4,8
10472,Relentlessly,4.400843956132392e-06,3.6233184351681345e-06,4,2,2
10473,Relied,2.3052039770217305e-06,3.6233184351681345e-06,3,1,2
10474,Relief,4.4218003559234974e-05,7.781507686956326e-05,69,22,47
10475,Relieved,2.095639979110664e-07,5.348708166200577e-06,3,0,3
10476,Religion,2.954852370546031e-05,2.087721574549256e-05,28,15,13
10477,Religiou,7.774824322500554e-05,7.436429740749831e-05,87,38,49
10478,Relocating,4.400843956132392e-06,1.8979287041356905e-06,3,2,1
10479,Reluctant,8.592123914353715e-06,7.074097897233022e-06,8,4,4
10480,Reluctantly,6.496483935243052e-06,1.7253897310324457e-07,4,4,0
10481,Rely,1.48790438516857e-05,1.8979287041356905e-06,9,7,2
10482,Relying,1.0687763893464371e-05,3.6233184351681345e-06,7,5,2
10483,Remain,6.098312339212028e-05,7.091351794543343e-05,78,33,45
10484,Remained,2.095639979110664e-07,3.6233184351681345e-06,4,0,4
10485,Remaining,6.496483935243052e-06,7.074097897233022e-06,10,4,6
10486,Remaking,2.3052039770217305e-06,3.6233184351681345e-06,3,1,2
10487,Remark,3.583544364279237e-05,2.9504164400654783e-05,38,20,18
10488,Remarkable,8.592123914353715e-06,8.79948762826546e-06,10,4,6
10489,Remarkably,2.3052039770217305e-06,5.348708166200577e-06,5,2,3
10490,Rematch,4.400843956132392e-06,5.348708166200577e-06,6,2,4
10491,Remember,0.00010499156295344414,0.0001019705331040174,121,53,68
10492,Remembering,4.400843956132392e-06,2.2602605476525032e-05,18,3,15
10493,Remembrance,2.3052039770217305e-06,7.074097897233022e-06,5,1,4
10494,Remind,4.4218003559234974e-05,3.468033359375216e-05,45,21,24
10495,Reminded,4.400843956132392e-06,1.8979287041356905e-06,3,2,1
10496,Reminder,1.9070323809907035e-05,3.2954943862719716e-05,32,11,21
10497,Reminding,2.3052039770217305e-06,5.348708166200577e-06,4,1,3
10498,Remittance,2.3052039770217305e-06,3.6233184351681345e-06,3,1,2
10499,Remorse,2.095639979110664e-07,7.074097897233022e-06,4,0,4
10500,Remote,1.48790438516857e-05,1.052487735929791e-05,17,9,8
10501,Remotely,4.400843956132392e-06,1.8979287041356905e-06,3,2,1
10502,Removal,1.0687763893464371e-05,8.79948762826546e-06,13,6,7
10503,Remove,3.1644163684570994e-05,4.6758061710979285e-05,49,17,32
10504,Removed,2.326160376812834e-05,1.2250267090330355e-05,22,13,9
10505,Removing,1.6974683830796368e-05,1.052487735929791e-05,15,9,6
10506,Rename,6.496483935243052e-06,1.7253897310324457e-07,3,3,0
10507,Renault,8.592123914353715e-06,3.6233184351681345e-06,6,4,2
10508,Rendition,4.400843956132392e-06,1.052487735929791e-05,8,2,6
10509,Renegade,4.400843956132392e-06,1.8979287041356905e-06,3,2,1
10510,Renegotiate,4.400843956132392e-06,1.8979287041356905e-06,4,2,2
10511,Renew,8.592123914353715e-06,8.79948762826546e-06,11,4,7
10512,Renewable,5.4696203454788295e-05,3.640572332478458e-05,51,28,23
10513,Renewed,6.496483935243052e-06,3.6233184351681345e-06,5,3,2
10514,Renowned,2.3052039770217305e-06,5.348708166200577e-06,4,1,3
10515,Rent,2.7452883726349685e-05,2.9504164400654783e-05,31,14,17
10516,Rental,1.9070323809907035e-05,5.348708166200577e-06,13,10,3
10517,Rented,4.400843956132392e-06,1.8979287041356905e-06,4,3,1
10518,Renter,2.3052039770217305e-06,3.6233184351681345e-06,4,2,2
10519,Renting,8.592123914353715e-06,1.052487735929791e-05,16,8,8
10520,Reopen,1.278340387257504e-05,2.6053384938589907e-05,22,6,16
10521,Reopening,4.400843956132392e-06,8.79948762826546e-06,8,2,6
10522,Rep,0.0003522770804885024,0.0003866598387243709,437,190,247
10523,Repair,6.496483935243052e-06,8.79948762826546e-06,12,5,7
10524,Repairing,4.400843956132392e-06,1.8979287041356905e-06,5,2,3
10525,Reparation,6.496483935243052e-06,5.348708166200577e-06,6,3,3
10526,Repay,4.400843956132392e-06,1.2250267090330355e-05,11,3,8
10527,Repeal,0.0001971997220343134,0.0001520068353039585,197,100,97
10528,Repealed,2.3052039770217305e-06,8.79948762826546e-06,6,1,5
10529,Repealing,8.592123914353715e-06,1.742643628342769e-05,15,4,11
10530,Repeat,1.48790438516857e-05,1.9151826014460126e-05,18,7,11
10531,Repeated,4.400843956132392e-06,1.8979287041356905e-06,3,2,1
10532,Repeatedly,1.0687763893464371e-05,3.6233184351681345e-06,8,5,3
10533,Repeating,2.3052039770217305e-06,3.6233184351681345e-06,3,1,2
10534,Replace,6.517440335034157e-05,5.5385010366141504e-05,74,37,37
10535,Replaced,2.3052039770217305e-06,8.79948762826546e-06,6,1,5
10536,Replacement,2.954852370546031e-05,4.6758061710979285e-05,42,14,28
10537,Replacing,1.0687763893464371e-05,3.6233184351681345e-06,7,5,2
10538,Reply,2.3052039770217305e-06,5.348708166200577e-06,4,1,3
10539,Report,0.0007336835566866429,0.0006782507032688539,821,378,443
10540,Reported,2.5357243747239038e-05,2.6053384938589907e-05,29,12,17
10541,Reportedly,0.0001259479627445509,0.0001485560558418934,162,65,97
10542,Reporter,9.24177230787802e-05,0.00011922443041434203,130,51,79
10543,Reporting,2.116596378901769e-05,2.087721574549256e-05,24,11,13
10544,Represent,1.0687763893464371e-05,1.570104655239525e-05,14,5,9
10545,Representation,2.3052039770217305e-06,3.6233184351681345e-06,4,1,3
10546,Representative,4.212236358012434e-05,4.1581892517881935e-05,44,20,24
10547,Representing,2.3052039770217305e-06,5.348708166200577e-06,5,2,3
10548,Repression,2.3052039770217305e-06,5.348708166200577e-06,5,2,3
10549,Repressive,4.400843956132392e-06,1.8979287041356905e-06,3,2,1
10550,Reprieve,1.0687763893464371e-05,1.8979287041356905e-06,6,5,1
10551,Reproductive,1.0687763893464371e-05,1.3975656821362803e-05,15,6,9
10552,Reptile,2.3052039770217305e-06,1.8979287041356905e-06,3,2,1
10553,Republic,0.00011127848289077625,9.506897417988779e-05,126,60,66
10554,Republican,0.0020937539031294626,0.002153458923301593,2497,1092,1405
10555,Republicanbacked,8.592123914353715e-06,1.7253897310324457e-07,4,4,0
10556,Republicancontrolled,6.496483935243052e-06,1.052487735929791e-05,9,3,6
10557,Republicandominated,2.095639979110664e-07,5.348708166200577e-06,3,0,3
10558,Republicanled,6.496483935243052e-06,8.79948762826546e-06,9,4,5
10559,Republicans,1.278340387257504e-05,1.3975656821362803e-05,16,8,8
10560,Repulsive,2.3052039770217305e-06,3.6233184351681345e-06,4,1,3
10561,Reputation,1.48790438516857e-05,1.052487735929791e-05,13,7,6
10562,Request,4.840928351745632e-05,4.6758061710979285e-05,58,26,32
10563,Requested,2.095639979110664e-07,5.348708166200577e-06,3,0,3
10564,Require,2.326160376812834e-05,2.087721574549256e-05,28,13,15
10565,Required,6.496483935243052e-06,5.348708166200577e-06,8,4,4
10566,Requirement,1.6974683830796368e-05,1.2250267090330355e-05,17,8,9
10567,Requiring,8.592123914353715e-06,1.052487735929791e-05,11,4,7
10568,Rescind,8.592123914353715e-06,5.348708166200577e-06,8,5,3
10569,Rescue,6.098312339212028e-05,8.816741525575797e-05,87,30,57
10570,Rescued,2.7452883726349685e-05,2.087721574549256e-05,29,15,14
10571,Rescuer,6.496483935243052e-06,1.2250267090330355e-05,10,3,7
10572,Rescuing,8.592123914353715e-06,1.8979287041356905e-06,5,4,1
10573,Research,0.00010918284291166549,0.00010024514337298497,121,59,62
10574,Researched,2.095639979110664e-07,5.348708166200577e-06,3,0,3
10575,Researcher,8.822644312055891e-05,6.918812821440096e-05,93,45,48
10576,Resemble,8.592123914353715e-06,3.6233184351681345e-06,6,4,2
10577,Reservation,1.0687763893464371e-05,5.348708166200577e-06,8,5,3
10578,Reserve,4.840928351745632e-05,7.091351794543343e-05,70,26,44
10579,Reset,6.496483935243052e-06,8.79948762826546e-06,8,3,5
10580,Resettlement,6.496483935243052e-06,5.348708166200577e-06,7,3,4
10581,Reshape,2.3052039770217305e-06,7.074097897233022e-06,5,1,4
10582,Residence,2.3052039770217305e-06,3.6233184351681345e-06,3,1,2
10583,Residency,4.400843956132392e-06,5.348708166200577e-06,7,3,4
10584,Resident,7.774824322500554e-05,8.816741525575797e-05,95,40,55
10585,Resign,0.0001343305226609934,0.00011922443041434203,144,71,73
10586,Resignation,1.278340387257504e-05,3.640572332478458e-05,31,6,25
10587,Resigned,4.400843956132392e-06,1.052487735929791e-05,9,2,7
10588,Resigning,4.400843956132392e-06,3.6233184351681345e-06,4,2,2
10589,Resilience,6.496483935243052e-06,8.79948762826546e-06,9,3,6
10590,Resist,1.9070323809907035e-05,8.79948762826546e-06,15,9,6
10591,Resistance,4.212236358012434e-05,3.985650278684949e-05,50,23,27
10592,Resisting,4.400843956132392e-06,7.074097897233022e-06,6,2,4
10593,Resolution,3.7931083621902995e-05,2.9504164400654783e-05,40,21,19
10594,Resolve,6.496483935243052e-06,3.6233184351681345e-06,6,4,2
10595,Resolved,2.095639979110664e-07,3.6233184351681345e-06,3,0,3
10596,Resort,1.48790438516857e-05,1.2250267090330355e-05,16,8,8
10597,Resource,3.583544364279237e-05,1.742643628342769e-05,30,19,11
10598,Respect,4.002672360101368e-05,2.6053384938589907e-05,37,22,15
10599,Respected,6.496483935243052e-06,1.8979287041356905e-06,4,3,1
10600,Respecting,2.3052039770217305e-06,5.348708166200577e-06,4,1,3
10601,Respond,5.4696203454788295e-05,5.5385010366141504e-05,67,29,38
10602,Responded,6.496483935243052e-06,3.6233184351681345e-06,8,5,3
10603,Responder,8.592123914353715e-06,1.3975656821362803e-05,13,5,8
10604,Responding,8.592123914353715e-06,1.8979287041356905e-06,7,5,2
10605,Response,0.00011756540282810809,0.00011404826122124471,135,61,74
10606,Responsibility,1.9070323809907035e-05,1.052487735929791e-05,18,10,8
10607,Responsible,3.1644163684570994e-05,2.9504164400654783e-05,32,15,17
10608,Rest,2.326160376812834e-05,3.8131113055817005e-05,41,13,28
10609,Restaurant,5.888748341300963e-05,4.330728224891437e-05,59,29,30
10610,Restles,2.3052039770217305e-06,3.6233184351681345e-06,3,1,2
10611,Restoration,1.0687763893464371e-05,5.348708166200577e-06,8,5,3
10612,Restore,2.5357243747239038e-05,2.4327995207557487e-05,31,14,17
10613,Restored,6.496483935243052e-06,7.074097897233022e-06,7,3,4
10614,Restoring,1.48790438516857e-05,8.79948762826546e-06,13,7,6
10615,Restrain,4.400843956132392e-06,1.8979287041356905e-06,3,2,1
10616,Restraint,4.400843956132392e-06,1.8979287041356905e-06,3,2,1
10617,Restrict,1.278340387257504e-05,1.052487735929791e-05,14,8,6
10618,Restricting,4.400843956132392e-06,5.348708166200577e-06,7,2,5
10619,Restriction,2.7452883726349685e-05,3.468033359375216e-05,40,16,24
10620,Restrictive,2.3052039770217305e-06,8.79948762826546e-06,6,1,5
10621,Restroom,6.496483935243052e-06,1.8979287041356905e-06,4,3,1
10622,Result,7.774824322500554e-05,0.00011404826122124471,112,41,71
10623,Resume,2.7452883726349685e-05,2.2602605476525032e-05,28,13,15
10624,Resuming,4.400843956132392e-06,1.7253897310324457e-07,3,2,1
10625,Resurface,6.496483935243052e-06,1.8979287041356905e-06,4,3,1
10626,Resurrect,6.496483935243052e-06,5.348708166200577e-06,6,3,3
10627,Retail,1.0687763893464371e-05,1.3975656821362803e-05,13,5,8
10628,Retailer,1.6974683830796368e-05,1.9151826014460126e-05,20,8,12
10629,Retake,2.3052039770217305e-06,7.074097897233022e-06,6,1,5
10630,Retaliate,4.400843956132392e-06,3.6233184351681345e-06,4,2,2
10631,Retaliation,1.0687763893464371e-05,5.348708166200577e-06,9,5,4
10632,Rethink,1.0687763893464371e-05,1.3975656821362803e-05,14,5,9
10633,Rethinking,8.592123914353715e-06,1.8979287041356905e-06,5,4,1
10634,Retire,1.278340387257504e-05,1.9151826014460126e-05,19,8,11
10635,Retired,2.7452883726349685e-05,2.9504164400654783e-05,32,13,19
10636,Retiree,1.0687763893464371e-05,5.348708166200577e-06,8,5,3
10637,Retirement,6.098312339212028e-05,5.711040009717395e-05,68,33,35
10638,Retiring,1.278340387257504e-05,1.2250267090330355e-05,13,6,7
10639,Retract,2.3052039770217305e-06,5.348708166200577e-06,4,1,3
10640,Retreat,1.9070323809907035e-05,1.3975656821362803e-05,18,9,9
10641,Retriever,2.3052039770217305e-06,3.6233184351681345e-06,4,1,3
10642,Retry,2.3052039770217305e-06,1.8979287041356905e-06,3,1,2
10643,Return,0.00016366948236854273,0.0001347529379936339,168,82,86
10644,Returned,2.3052039770217305e-06,1.2250267090330355e-05,8,1,7
10645,Returning,8.592123914353715e-06,5.348708166200577e-06,9,4,5
10646,Retweet,4.400843956132392e-06,8.79948762826546e-06,7,2,5
10647,Reunification,6.496483935243052e-06,1.7253897310324457e-07,3,3,0
10648,Reunion,6.496483935243052e-06,3.6233184351681345e-06,6,4,2
10649,Reunite,2.116596378901769e-05,1.570104655239525e-05,19,10,9
10650,Reunited,6.496483935243052e-06,5.348708166200577e-06,7,3,4
10651,Reuter,0.0002055822819507562,0.00017271151207634748,216,106,110
10652,Rev,1.48790438516857e-05,7.074097897233022e-06,13,8,5
10653,Revamped,4.400843956132392e-06,1.8979287041356905e-06,3,2,1
10654,Reveal,0.00016576512234765329,0.00017788768126944505,195,82,113
10655,Revealed,5.4696203454788295e-05,5.3659620635109e-05,63,28,35
10656,Revealing,1.6974683830796368e-05,8.79948762826546e-06,14,8,6
10657,Revelation,2.5357243747239038e-05,2.087721574549256e-05,27,12,15
10658,Revenge,1.278340387257504e-05,1.570104655239525e-05,17,6,11
10659,Revenue,8.592123914353715e-06,1.3975656821362803e-05,13,5,8
10660,Reverend,2.095639979110664e-07,7.074097897233022e-06,4,0,4
10661,Reversal,6.496483935243052e-06,1.052487735929791e-05,9,3,6
10662,Reverse,2.326160376812834e-05,4.6758061710979285e-05,44,15,29
10663,Reversing,4.400843956132392e-06,5.348708166200577e-06,5,2,3
10664,Review,7.774824322500554e-05,7.608968713853079e-05,89,40,49
10665,Reviewing,6.496483935243052e-06,1.7253897310324457e-07,4,3,1
10666,Reviled,2.3052039770217305e-06,1.8979287041356905e-06,3,2,1
10667,Revise,2.3052039770217305e-06,5.348708166200577e-06,5,1,4
10668,Revised,4.400843956132392e-06,1.2250267090330355e-05,13,5,8
10669,Revision,2.095639979110664e-07,8.79948762826546e-06,6,0,6
10670,Revisit,4.400843956132392e-06,3.6233184351681345e-06,4,2,2
10671,Revisited,2.3052039770217305e-06,7.074097897233022e-06,5,1,4
10672,Revive,1.9070323809907035e-05,1.742643628342769e-05,21,9,12
10673,Revoke,6.496483935243052e-06,1.8979287041356905e-06,5,4,1
10674,Revoking,6.496483935243052e-06,1.8979287041356905e-06,4,3,1
10675,Revolt,1.6974683830796368e-05,1.570104655239525e-05,17,8,9
10676,Revolution,7.565260324589493e-05,6.056117955923882e-05,80,38,42
10677,Revolutionary,1.9070323809907035e-05,3.122955413168725e-05,29,10,19
10678,Revolving,2.3052039770217305e-06,3.6233184351681345e-06,4,1,3
10679,Reward,2.326160376812834e-05,2.777877466962238e-05,29,11,18
10680,Rewrite,1.0687763893464371e-05,1.052487735929791e-05,13,6,7
10681,Rewriting,2.3052039770217305e-06,3.6233184351681345e-06,3,1,2
10682,Rex,5.4696203454788295e-05,4.50326719799468e-05,57,27,30
10683,Reynold,4.400843956132392e-06,3.6233184351681345e-06,5,2,3
10684,Rezaian,4.400843956132392e-06,1.7253897310324457e-07,3,3,0
10685,Rhetoric,2.326160376812834e-05,2.2602605476525032e-05,26,12,14
10686,Rhino,4.002672360101368e-05,3.2954943862719716e-05,43,21,22
10687,Rhode,1.278340387257504e-05,1.052487735929791e-05,14,7,7
10688,Rhyme,2.095639979110664e-07,3.6233184351681345e-06,3,0,3
10689,Ric,4.400843956132392e-06,1.8979287041356905e-06,3,2,1
10690,Rica,2.326160376812834e-05,3.2954943862719716e-05,30,11,19
10691,Rican,1.0687763893464371e-05,2.087721574549256e-05,22,8,14
10692,Ricardo,2.3052039770217305e-06,3.6233184351681345e-06,3,1,2
10693,Rice,4.002672360101368e-05,3.985650278684949e-05,44,21,23
10694,Rich,9.870464301611217e-05,0.00010714670229711469,122,52,70
10695,Richard,0.00013013924270277222,0.00011922443041434203,149,70,79
10696,Richer,1.48790438516857e-05,7.074097897233022e-06,11,7,4
10697,Richest,1.278340387257504e-05,1.742643628342769e-05,19,7,12
10698,Richmond,4.400843956132392e-06,3.6233184351681345e-06,4,2,2
10699,Rick,9.660900303700153e-05,0.0001347529379936339,144,61,83
10700,Rico,7.355696326678427e-05,9.679436391092026e-05,112,48,64
10701,Rid,2.116596378901769e-05,2.4327995207557487e-05,25,10,15
10702,Ride,3.3739803663681634e-05,2.2602605476525032e-05,32,18,14
10703,Rider,8.592123914353715e-06,7.074097897233022e-06,9,4,5
10704,Ridge,2.3052039770217305e-06,3.6233184351681345e-06,3,1,2
10705,Ridicule,4.400843956132392e-06,5.348708166200577e-06,6,2,4
10706,Ridiculed,1.0687763893464371e-05,1.7253897310324457e-07,5,5,0
10707,Ridiculou,1.278340387257504e-05,2.2602605476525032e-05,23,9,14
10708,Ridiculous,2.3052039770217305e-06,3.6233184351681345e-06,3,1,2
10709,Ridiculously,2.095639979110664e-07,7.074097897233022e-06,4,0,4
10710,Riding,6.496483935243052e-06,3.6233184351681345e-06,5,3,2
10711,Rifle,1.0687763893464371e-05,3.2954943862719716e-05,25,5,20
10712,Rift,8.592123914353715e-06,1.742643628342769e-05,17,5,12
10713,Rig,6.496483935243052e-06,5.348708166200577e-06,6,3,3
10714,Rigged,2.954852370546031e-05,2.087721574549256e-05,28,14,14
10715,Rigging,6.496483935243052e-06,3.6233184351681345e-06,6,3,3
10716,Right,0.0007190140768328685,0.0007886756460549303,889,379,510
10717,RightToWork,4.400843956132392e-06,1.8979287041356905e-06,4,3,1
10718,RightWing,2.326160376812834e-05,3.2954943862719716e-05,34,13,21
10719,Righteou,4.400843956132392e-06,1.8979287041356905e-06,4,3,1
10720,Rightwing,1.0687763893464371e-05,1.2250267090330355e-05,14,7,7
10721,Riker,4.400843956132392e-06,5.348708166200577e-06,6,2,4
10722,Rim,6.496483935243052e-06,1.8979287041356905e-06,4,3,1
10723,Ring,2.5357243747239038e-05,3.985650278684949e-05,37,13,24
10724,Ringing,2.3052039770217305e-06,3.6233184351681345e-06,3,1,2
10725,Rio,5.6791843433898893e-05,5.883578982820635e-05,72,34,38
10726,Riot,0.00012804360272366158,0.0001295767688005365,150,65,85
10727,Rioter,8.592123914353715e-06,1.742643628342769e-05,14,4,10
10728,Rioting,6.496483935243052e-06,5.348708166200577e-06,6,3,3
10729,Rip,7.565260324589493e-05,6.746273848336857e-05,78,38,40
10730,Ripe,4.400843956132392e-06,1.8979287041356905e-06,3,2,1
10731,Ripoff,1.0687763893464371e-05,5.348708166200577e-06,9,5,4
10732,Ripped,1.278340387257504e-05,1.052487735929791e-05,14,6,8
10733,Ripping,4.400843956132392e-06,1.3975656821362803e-05,10,2,8
10734,Ripple,1.0687763893464371e-05,1.7253897310324457e-07,6,6,0
10735,Rise,0.0004423895995902609,0.0004677531560828957,550,241,309
10736,Risen,4.400843956132392e-06,1.8979287041356905e-06,3,2,1
10737,Rising,5.888748341300963e-05,6.746273848336857e-05,74,30,44
10738,Risk,8.822644312055891e-05,9.506897417988779e-05,107,46,61
10739,Risky,1.48790438516857e-05,3.6233184351681345e-06,11,9,2
10740,Risperdal,4.400843956132392e-06,1.8979287041356905e-06,3,2,1
10741,Ritchie,4.400843956132392e-06,1.8979287041356905e-06,4,3,1
10742,Rite,6.496483935243052e-06,1.7253897310324457e-07,3,3,0
10743,Rittenhouse,6.496483935243052e-06,3.6233184351681345e-06,5,3,2
10744,Ritual,6.496483935243052e-06,5.348708166200577e-06,6,3,3
10745,Rival,5.4696203454788295e-05,3.8131113055817005e-05,54,28,26
10746,River,2.5357243747239038e-05,4.50326719799468e-05,46,17,29
10747,Rivera,2.095639979110664e-07,7.074097897233022e-06,5,0,5
10748,Riviera,2.3052039770217305e-06,5.348708166200577e-06,4,1,3
10749,Rivlin,2.3052039770217305e-06,5.348708166200577e-06,4,1,3
10750,Riyadh,2.095639979110664e-07,2.087721574549256e-05,12,0,12
10751,Ro,4.400843956132392e-06,3.6233184351681345e-06,4,2,2
10752,Road,9.870464301611217e-05,6.746273848336857e-05,96,52,44
10753,Roadblock,8.592123914353715e-06,3.6233184351681345e-06,6,4,2
10754,Roadside,2.095639979110664e-07,5.348708166200577e-06,3,0,3
10755,Roast,2.3052039770217305e-06,8.79948762826546e-06,7,1,6
10756,Roasted,6.496483935243052e-06,1.8979287041356905e-06,4,3,1
10757,Rob,4.4218003559234974e-05,6.228656929027126e-05,64,23,41
10758,Robb,4.400843956132392e-06,1.7253897310324457e-07,3,2,1
10759,Robbed,1.0687763893464371e-05,1.7253897310324457e-07,5,5,0
10760,Robber,1.278340387257504e-05,3.6233184351681345e-06,8,6,2
10761,Robbery,2.3052039770217305e-06,3.6233184351681345e-06,3,1,2
10762,Robby,2.3052039770217305e-06,3.6233184351681345e-06,3,1,2
10763,Robert,0.00019929536201342395,0.00020376852723493182,253,114,139
10764,Robertson,8.592123914353715e-06,1.3975656821362803e-05,12,4,8
10765,Robin,2.954852370546031e-05,3.2954943862719716e-05,35,15,20
10766,Robinson,6.496483935243052e-06,8.79948762826546e-06,8,3,5
10767,Robocall,8.592123914353715e-06,5.348708166200577e-06,7,4,3
10768,Robot,2.5357243747239038e-05,3.985650278684949e-05,38,13,25
10769,Robotic,6.496483935243052e-06,1.8979287041356905e-06,5,4,1
10770,Rochelle,4.400843956132392e-06,1.8979287041356905e-06,4,2,2
10771,Rock,5.4696203454788295e-05,6.746273848336857e-05,73,30,43
10772,Rockefeller,4.400843956132392e-06,5.348708166200577e-06,6,2,4
10773,Rocket,5.4696203454788295e-05,4.50326719799468e-05,58,28,30
10774,Rocky,8.592123914353715e-06,1.3975656821362803e-05,12,4,8
10775,Rod,1.6974683830796368e-05,2.2602605476525032e-05,21,8,13
10776,Rode,2.3052039770217305e-06,1.8979287041356905e-06,3,1,2
10777,Rodger,4.400843956132392e-06,7.074097897233022e-06,7,2,5
10778,Rodham,1.0687763893464371e-05,3.6233184351681345e-06,8,5,3
10779,Rodman,4.400843956132392e-06,5.348708166200577e-06,6,2,4
10780,Rodney,6.496483935243052e-06,8.79948762826546e-06,8,3,5
10781,Rodrigo,6.496483935243052e-06,1.052487735929791e-05,9,3,6
10782,Rodriguez,4.400843956132392e-06,3.6233184351681345e-06,4,2,2
10783,Roe,2.7452883726349685e-05,2.4327995207557487e-05,32,16,16
10784,Rogen,2.3052039770217305e-06,5.348708166200577e-06,4,1,3
10785,Roger,5.888748341300963e-05,3.8131113055817005e-05,51,28,23
10786,Rogozin,2.3052039770217305e-06,1.8979287041356905e-06,3,2,1
10787,Rogue,1.9070323809907035e-05,1.9151826014460126e-05,23,10,13
10788,Rohingya,8.592123914353715e-06,1.052487735929791e-05,11,4,7
10789,Rohrabacher,2.3052039770217305e-06,1.8979287041356905e-06,3,1,2
10790,Roil,2.3052039770217305e-06,3.6233184351681345e-06,3,1,2
10791,Role,8.193952318322689e-05,7.608968713853079e-05,95,45,50
10792,Roll,4.212236358012434e-05,4.6758061710979285e-05,56,23,33
10793,Rollback,6.496483935243052e-06,8.79948762826546e-06,8,3,5
10794,Rollin,2.3052039770217305e-06,5.348708166200577e-06,4,1,3
10795,Rolling,1.278340387257504e-05,1.742643628342769e-05,18,8,10
10796,Rollout,6.496483935243052e-06,3.6233184351681345e-06,5,3,2
10797,Rom,5.050492349656699e-05,3.122955413168725e-05,46,24,22
10798,Roman,7.565260324589493e-05,5.1934230904076595e-05,73,38,35
10799,Romania,5.6791843433898893e-05,4.330728224891437e-05,54,29,25
10800,Romanian,3.3739803663681634e-05,3.2954943862719716e-05,37,17,20
10801,Rome,4.840928351745632e-05,3.640572332478458e-05,51,26,25
10802,Romeo,2.095639979110664e-07,3.6233184351681345e-06,4,1,3
10803,Romero,2.095639979110664e-07,5.348708166200577e-06,3,0,3
10804,Romney,0.00013223488268188294,0.00012440059960743937,149,67,82
10805,Rompuy,8.592123914353715e-06,1.8979287041356905e-06,5,4,1
10806,Ron,7.355696326678427e-05,3.985650278684949e-05,60,37,23
10807,Ronald,2.954852370546031e-05,2.6053384938589907e-05,30,14,16
10808,Ronny,1.278340387257504e-05,8.79948762826546e-06,11,6,5
10809,Roof,1.278340387257504e-05,2.087721574549256e-05,20,7,13
10810,Rooftop,2.095639979110664e-07,5.348708166200577e-06,3,0,3
10811,Room,3.583544364279237e-05,2.777877466962238e-05,42,20,22
10812,Roommate,6.496483935243052e-06,1.7253897310324457e-07,4,4,0
10813,Roosevelt,1.0687763893464371e-05,8.79948762826546e-06,11,6,5
10814,Roost,4.400843956132392e-06,1.8979287041356905e-06,3,2,1
10815,Root,1.278340387257504e-05,1.742643628342769e-05,18,7,11
10816,Rooting,4.400843956132392e-06,1.8979287041356905e-06,3,2,1
10817,Rope,4.400843956132392e-06,3.6233184351681345e-06,5,2,3
10818,Ros,1.48790438516857e-05,1.9151826014460126e-05,25,11,14
10819,RosLehtinen,4.400843956132392e-06,1.7253897310324457e-07,3,2,1
10820,Rosa,1.278340387257504e-05,1.8979287041356905e-06,8,6,2
10821,Roscosmo,2.3052039770217305e-06,1.8979287041356905e-06,4,3,1
10822,Rose,2.7452883726349685e-05,3.122955413168725e-05,33,14,19
10823,Rosen,2.095639979110664e-07,5.348708166200577e-06,3,0,3
10824,Rosenberg,4.400843956132392e-06,1.8979287041356905e-06,4,2,2
10825,Rosenstein,1.48790438516857e-05,1.9151826014460126e-05,18,7,11
10826,Rosenthal,2.3052039770217305e-06,5.348708166200577e-06,4,1,3
10827,Rosetta,6.496483935243052e-06,1.570104655239525e-05,12,3,9
10828,Rosie,6.496483935243052e-06,5.348708166200577e-06,6,3,3
10829,Rosling,4.400843956132392e-06,1.8979287041356905e-06,3,2,1
10830,Rosneft,6.496483935243052e-06,1.7253897310324457e-07,4,4,0
10831,Roth,6.496483935243052e-06,1.8979287041356905e-06,4,3,1
10832,Rotherham,6.496483935243052e-06,3.6233184351681345e-06,5,3,2
10833,Rothschild,1.48790438516857e-05,1.8979287041356905e-06,11,9,2
10834,Rotten,2.3052039770217305e-06,5.348708166200577e-06,4,1,3
10835,Rotterdam,8.592123914353715e-06,1.7253897310324457e-07,4,4,0
10836,Roubini,2.3052039770217305e-06,3.6233184351681345e-06,5,1,4
10837,Rouge,1.0687763893464371e-05,8.79948762826546e-06,12,5,7
10838,Rough,4.400843956132392e-06,1.2250267090330355e-05,9,2,7
10839,Roughly,1.278340387257504e-05,5.348708166200577e-06,11,7,4
10840,Rouhani,1.6974683830796368e-05,8.79948762826546e-06,16,9,7
10841,Roulette,4.400843956132392e-06,1.8979287041356905e-06,3,2,1
10842,Round,1.278340387257504e-05,2.2602605476525032e-05,20,6,14
10843,Roundup,5.888748341300963e-05,6.918812821440096e-05,76,30,46
10844,Rousseff,1.278340387257504e-05,2.9504164400654783e-05,23,6,17
10845,Rout,2.3052039770217305e-06,5.348708166200577e-06,4,1,3
10846,Route,8.592123914353715e-06,1.742643628342769e-05,16,4,12
10847,Routine,8.592123914353715e-06,1.3975656821362803e-05,13,4,9
10848,Rove,8.592123914353715e-06,8.79948762826546e-06,11,4,7
10849,Rover,1.278340387257504e-05,7.074097897233022e-06,14,10,4
10850,Row,2.5357243747239038e-05,3.122955413168725e-05,32,12,20
10851,Rowan,6.496483935243052e-06,1.8979287041356905e-06,4,3,1
10852,Rowling,8.592123914353715e-06,1.8979287041356905e-06,7,6,1
10853,Roxana,4.400843956132392e-06,1.8979287041356905e-06,3,2,1
10854,Roy,0.0001154697628489974,0.0001554576147660233,164,68,96
10855,Royal,6.72700433294523e-05,5.883578982820635e-05,70,34,36
10856,Rubber,4.400843956132392e-06,3.6233184351681345e-06,4,2,2
10857,Rubble,4.400843956132392e-06,1.8979287041356905e-06,5,3,2
10858,Ruben,1.0687763893464371e-05,3.6233184351681345e-06,7,5,2
10859,Rubin,2.3052039770217305e-06,7.074097897233022e-06,5,1,4
10860,Rubio,0.00031036428090628937,0.0002382763218555804,328,167,161
10861,Ruble,8.592123914353715e-06,1.052487735929791e-05,15,9,6
10862,Rudd,1.0687763893464371e-05,1.2250267090330355e-05,18,8,10
10863,Rude,6.496483935243052e-06,1.7253897310324457e-07,3,3,0
10864,Rudy,4.4218003559234974e-05,4.6758061710979285e-05,54,21,33
10865,Ruffalo,2.3052039770217305e-06,3.6233184351681345e-06,5,3,2
10866,Ruin,2.116596378901769e-05,1.3975656821362803e-05,19,11,8
10867,Ruined,6.496483935243052e-06,7.074097897233022e-06,9,3,6
10868,Ruining,2.3052039770217305e-06,7.074097897233022e-06,5,1,4
10869,Rule,0.0002684514813240757,0.0003003903521727485,329,137,192
10870,Ruled,1.48790438516857e-05,1.3975656821362803e-05,17,9,8
10871,Ruler,6.496483935243052e-06,1.8979287041356905e-06,4,3,1
10872,Ruling,6.72700433294523e-05,8.644202552472544e-05,89,35,54
10873,Rumble,2.095639979110664e-07,5.348708166200577e-06,5,2,3
10874,Rumor,2.5357243747239038e-05,1.742643628342769e-05,24,13,11
10875,Rumored,2.3052039770217305e-06,3.6233184351681345e-06,4,2,2
10876,Rumsfeld,4.400843956132392e-06,5.348708166200577e-06,5,2,3
10877,Run,0.00018462588215964923,0.00022274781427628854,248,102,146
10878,Runaway,2.095639979110664e-07,8.79948762826546e-06,6,1,5
10879,Rundown,4.400843956132392e-06,1.7253897310324457e-07,3,2,1
10880,Runner,1.0687763893464371e-05,1.052487735929791e-05,11,5,6
10881,Running,0.00014480872255654665,0.0001295767688005365,156,74,82
10882,Runoff,1.9070323809907035e-05,1.3975656821362803e-05,17,9,8
10883,Rupee,4.400843956132392e-06,1.8979287041356905e-06,3,2,1
10884,Rupert,7.984388320411623e-05,7.091351794543343e-05,88,44,44
10885,Rural,1.9070323809907035e-05,4.8483451442011706e-05,44,11,33
10886,Rus,8.592123914353715e-06,5.348708166200577e-06,9,5,4
10887,Rush,2.954852370546031e-05,4.330728224891437e-05,39,14,25
10888,Rushdie,4.400843956132392e-06,5.348708166200577e-06,5,2,3
10889,Rushed,2.095639979110664e-07,1.8979287041356905e-06,3,0,3
10890,Rushing,6.496483935243052e-06,7.074097897233022e-06,8,3,5
10891,Russell,1.0687763893464371e-05,1.742643628342769e-05,15,5,10
10892,Russia,0.001938676544675274,0.0018394379922536896,2194,996,1198
10893,RussiaGeorgia,4.400843956132392e-06,1.8979287041356905e-06,3,2,1
10894,RussiaLinked,2.095639979110664e-07,5.348708166200577e-06,3,0,3
10895,Russiagate,2.3052039770217305e-06,1.8979287041356905e-06,3,1,2
10896,Russian,0.0013959057900856124,0.0012873132783233065,1557,718,839
10897,Russianbacked,4.400843956132392e-06,1.8979287041356905e-06,6,3,3
10898,RussoGeorgian,4.400843956132392e-06,1.7253897310324457e-07,3,3,0
10899,Rust,4.400843956132392e-06,1.052487735929791e-05,10,3,7
10900,Ruth,2.954852370546031e-05,4.1581892517881935e-05,41,14,27
10901,Rutte,6.496483935243052e-06,1.7253897310324457e-07,3,3,0
10902,Rwanda,2.326160376812834e-05,2.9504164400654783e-05,30,12,18
10903,Rwandan,2.116596378901769e-05,1.2250267090330355e-05,21,11,10
10904,Ryan,0.0003271294007391747,0.00035387743383475447,407,174,233
10905,Ryanair,6.496483935243052e-06,1.052487735929791e-05,9,3,6
10906,S300,6.496483935243052e-06,1.3975656821362803e-05,14,4,10
10907,SA,1.278340387257504e-05,2.6053384938589907e-05,23,7,16
10908,SAN,6.496483935243052e-06,5.348708166200577e-06,8,4,4
10909,SAP,6.496483935243052e-06,1.7253897310324457e-07,4,3,1
10910,SAR,8.592123914353715e-06,3.6233184351681345e-06,7,4,3
10911,SAT,4.400843956132392e-06,8.79948762826546e-06,7,2,5
10912,SAUDI,2.3052039770217305e-06,3.6233184351681345e-06,3,1,2
10913,SAfrica,4.400843956132392e-06,3.6233184351681345e-06,4,2,2
10914,SB,6.496483935243052e-06,8.79948762826546e-06,8,3,5
10915,SC,8.592123914353715e-06,1.2250267090330355e-05,13,5,8
10916,SCOTU,3.1644163684570994e-05,4.8483451442011706e-05,46,15,31
10917,SD,4.400843956132392e-06,7.074097897233022e-06,6,2,4
10918,SDG,2.3052039770217305e-06,5.348708166200577e-06,4,1,3
10919,SE,1.0687763893464371e-05,1.052487735929791e-05,11,5,6
10920,SEAL,2.326160376812834e-05,1.570104655239525e-05,22,12,10
10921,SEC,2.326160376812834e-05,2.777877466962238e-05,28,12,16
10922,SEO,4.400843956132392e-06,3.6233184351681345e-06,4,2,2
10923,SF,4.400843956132392e-06,3.6233184351681345e-06,4,2,2
10924,SIM,2.3052039770217305e-06,7.074097897233022e-06,6,1,5
10925,SK,2.3052039770217305e-06,5.348708166200577e-06,5,1,4
10926,SKorea,8.592123914353715e-06,5.348708166200577e-06,8,4,4
10927,SKorean,4.400843956132392e-06,1.8979287041356905e-06,4,2,2
10928,SM,2.3052039770217305e-06,1.8979287041356905e-06,3,2,1
10929,SNAP,4.400843956132392e-06,3.6233184351681345e-06,4,2,2
10930,SO,6.496483935243052e-06,7.074097897233022e-06,7,3,4
10931,SOPA,1.48790438516857e-05,5.348708166200577e-06,13,8,5
10932,SOTU,2.5357243747239038e-05,8.79948762826546e-06,17,12,5
10933,SP,4.400843956132392e-06,3.6233184351681345e-06,5,3,2
10934,SPIEGEL,2.116596378901769e-05,1.052487735929791e-05,19,12,7
10935,SSL,6.496483935243052e-06,3.6233184351681345e-06,5,3,2
10936,STD,6.496483935243052e-06,1.8979287041356905e-06,4,3,1
10937,STEM,1.48790438516857e-05,8.79948762826546e-06,13,8,5
10938,STILL,2.095639979110664e-07,3.6233184351681345e-06,3,1,2
10939,STOP,4.400843956132392e-06,3.6233184351681345e-06,4,2,2
10940,STORY,1.278340387257504e-05,5.348708166200577e-06,11,7,4
10941,STRATFOR,2.3052039770217305e-06,1.8979287041356905e-06,3,2,1
10942,SUV,1.6974683830796368e-05,8.79948762826546e-06,15,9,6
10943,SWAT,4.400843956132392e-06,1.7253897310324457e-07,3,3,0
10944,SWIFT,4.400843956132392e-06,1.052487735929791e-05,9,2,7
10945,SXSW,4.400843956132392e-06,1.2250267090330355e-05,10,2,8
10946,Saab,8.592123914353715e-06,1.7253897310324457e-07,6,4,2
10947,Saad,2.095639979110664e-07,3.6233184351681345e-06,3,0,3
10948,Saakashvili,1.0687763893464371e-05,1.8979287041356905e-06,7,6,1
10949,Sabbath,2.3052039770217305e-06,1.8979287041356905e-06,3,2,1
10950,Saberi,4.400843956132392e-06,1.8979287041356905e-06,3,2,1
10951,Sabotage,1.0687763893464371e-05,2.2602605476525032e-05,21,6,15
10952,Sabotaging,2.3052039770217305e-06,7.074097897233022e-06,5,1,4
10953,Sabri,4.400843956132392e-06,3.6233184351681345e-06,4,2,2
10954,Saccone,6.496483935243052e-06,5.348708166200577e-06,6,3,3
10955,Sach,5.888748341300963e-05,6.573734875233614e-05,76,32,44
10956,Sack,4.400843956132392e-06,3.6233184351681345e-06,5,3,2
10957,Sacked,6.496483935243052e-06,5.348708166200577e-06,6,3,3
10958,Sackler,2.3052039770217305e-06,1.8979287041356905e-06,3,1,2
10959,Sacramento,8.592123914353715e-06,5.348708166200577e-06,7,4,3
10960,Sacred,6.496483935243052e-06,3.6233184351681345e-06,5,3,2
10961,Sacrifice,1.0687763893464371e-05,1.3975656821362803e-05,13,5,8
10962,Sacrificed,6.496483935243052e-06,1.8979287041356905e-06,4,3,1
10963,Sad,4.4218003559234974e-05,3.8131113055817005e-05,48,23,25
10964,Saddam,5.888748341300963e-05,4.50326719799468e-05,61,32,29
10965,Saddest,4.400843956132392e-06,1.7253897310324457e-07,3,3,0
10966,Sadiq,4.400843956132392e-06,7.074097897233022e-06,6,2,4
10967,Sadly,1.0687763893464371e-05,1.9151826014460126e-05,17,5,12
10968,Sadnes,2.3052039770217305e-06,3.6233184351681345e-06,3,1,2
10969,Sadr,2.3052039770217305e-06,3.6233184351681345e-06,4,2,2
10970,Saeed,2.3052039770217305e-06,5.348708166200577e-06,4,1,3
10971,Safari,4.400843956132392e-06,5.348708166200577e-06,7,3,4
10972,Safe,6.517440335034157e-05,6.056117955923882e-05,77,36,41
10973,Safeguarding,2.3052039770217305e-06,3.6233184351681345e-06,3,1,2
10974,Safely,4.400843956132392e-06,1.8979287041356905e-06,3,2,1
10975,Safer,1.278340387257504e-05,7.074097897233022e-06,10,6,4
10976,Safest,1.0687763893464371e-05,7.074097897233022e-06,9,5,4
10977,Safety,8.193952318322689e-05,9.334358444885519e-05,104,44,60
10978,Saffron,2.3052039770217305e-06,3.6233184351681345e-06,3,1,2
10979,Saga,2.3052039770217305e-06,5.348708166200577e-06,5,1,4
10980,Sagan,4.400843956132392e-06,1.8979287041356905e-06,3,2,1
10981,Sahara,8.592123914353715e-06,1.052487735929791e-05,11,5,6
10982,Said,0.0001343305226609934,0.00010542131256608228,140,72,68
10983,Saif,4.400843956132392e-06,7.074097897233022e-06,7,2,5
10984,Sail,2.095639979110664e-07,5.348708166200577e-06,3,0,3
10985,Saint,1.0687763893464371e-05,8.79948762826546e-06,10,5,5
10986,Sake,6.496483935243052e-06,3.6233184351681345e-06,6,3,3
10987,Sakharov,2.3052039770217305e-06,3.6233184351681345e-06,3,1,2
10988,Sakowin,2.3052039770217305e-06,3.6233184351681345e-06,3,1,2
10989,Sakurajima,2.3052039770217305e-06,1.8979287041356905e-06,3,1,2
10990,Salad,2.3052039770217305e-06,5.348708166200577e-06,4,1,3
10991,Salafi,2.095639979110664e-07,7.074097897233022e-06,4,0,4
10992,Salafist,4.400843956132392e-06,8.79948762826546e-06,8,3,5
10993,Salah,6.496483935243052e-06,3.6233184351681345e-06,6,3,3
10994,Salary,1.9070323809907035e-05,1.570104655239525e-05,19,10,9
10995,Sale,0.00010289592297433347,0.00012267520987640663,135,58,77
10996,Saleh,8.592123914353715e-06,8.79948762826546e-06,10,4,6
10997,Salem,2.3052039770217305e-06,3.6233184351681345e-06,5,1,4
10998,Salesforce,1.278340387257504e-05,8.79948762826546e-06,11,6,5
10999,Sallie,8.592123914353715e-06,3.6233184351681345e-06,7,4,3
11000,Sally,2.954852370546031e-05,1.9151826014460126e-05,25,14,11
11001,Salman,1.278340387257504e-05,1.9151826014460126e-05,17,6,11
11002,Salmon,6.496483935243052e-06,3.6233184351681345e-06,5,3,2
11003,Salmond,4.400843956132392e-06,1.8979287041356905e-06,3,2,1
11004,Salmonella,4.400843956132392e-06,7.074097897233022e-06,6,2,4
11005,Salt,6.496483935243052e-06,7.074097897233022e-06,8,3,5
11006,Salute,8.592123914353715e-06,8.79948762826546e-06,11,6,5
11007,Salvador,2.116596378901769e-05,2.9504164400654783e-05,29,11,18
11008,Salvadoran,6.496483935243052e-06,3.6233184351681345e-06,6,3,3
11009,Salvation,8.592123914353715e-06,7.074097897233022e-06,9,5,4
11010,Sam,2.5357243747239038e-05,3.640572332478458e-05,41,15,26
11011,Samantha,8.592123914353715e-06,1.3975656821362803e-05,12,4,8
11012,Samaritan,2.095639979110664e-07,3.6233184351681345e-06,3,1,2
11013,SameDay,4.400843956132392e-06,1.8979287041356905e-06,4,2,2
11014,SameSex,4.4218003559234974e-05,3.640572332478458e-05,48,25,23
11015,Samesex,2.095639979110664e-07,7.074097897233022e-06,6,1,5
11016,Samoa,1.278340387257504e-05,8.79948762826546e-06,14,9,5
11017,SampP,1.6974683830796368e-05,1.3975656821362803e-05,17,8,9
11018,Samsung,4.840928351745632e-05,4.50326719799468e-05,51,24,27
11019,Samuel,8.592123914353715e-06,8.79948762826546e-06,10,4,6
11020,San,0.00014271308257743603,0.00019341618884873702,208,86,122
11021,Sanaa,2.3052039770217305e-06,1.2250267090330355e-05,9,1,8
11022,Sanchez,8.592123914353715e-06,7.074097897233022e-06,10,5,5
11023,Sanction,9.24177230787802e-05,7.436429740749831e-05,93,46,47
11024,Sanctuary,4.002672360101368e-05,5.711040009717395e-05,57,20,37
11025,Sand,1.9070323809907035e-05,2.087721574549256e-05,22,9,13
11026,Sandberg,8.592123914353715e-06,5.348708166200577e-06,9,6,3
11027,Sander,0.0007693094363315244,0.0005868050475241346,776,390,386
11028,Sanders,1.48790438516857e-05,2.4327995207557487e-05,22,7,15
11029,Sandford,6.496483935243052e-06,1.8979287041356905e-06,4,3,1
11030,Sandoval,2.095639979110664e-07,8.79948762826546e-06,5,0,5
11031,Sandra,1.48790438516857e-05,1.9151826014460126e-05,21,7,14
11032,Sandwich,4.400843956132392e-06,7.074097897233022e-06,7,3,4
11033,Sandy,3.583544364279237e-05,5.1934230904076595e-05,53,21,32
11034,Sanity,4.400843956132392e-06,3.6233184351681345e-06,4,2,2
11035,Santa,3.7931083621902995e-05,5.711040009717395e-05,60,23,37
11036,Santiago,4.400843956132392e-06,8.79948762826546e-06,7,2,5
11037,Santo,2.3052039770217305e-06,7.074097897233022e-06,7,2,5
11038,Santorum,2.326160376812834e-05,2.4327995207557487e-05,28,14,14
11039,Sao,8.592123914353715e-06,1.3975656821362803e-05,16,8,8
11040,Sara,1.0687763893464371e-05,7.074097897233022e-06,9,5,4
11041,Sarah,8.193952318322689e-05,8.816741525575797e-05,96,41,55
11042,Sarajevo,2.3052039770217305e-06,3.6233184351681345e-06,4,1,3
11043,Sarin,2.095639979110664e-07,3.6233184351681345e-06,4,1,3
11044,Sarkozy,7.565260324589493e-05,8.816741525575797e-05,98,41,57
11045,SaroWiwa,4.400843956132392e-06,1.8979287041356905e-06,3,2,1
11046,Sasha,6.496483935243052e-06,5.348708166200577e-06,8,3,5
11047,Sasse,4.400843956132392e-06,7.074097897233022e-06,6,2,4
11048,Sassy,6.496483935243052e-06,5.348708166200577e-06,6,3,3
11049,Sat,2.3052039770217305e-06,5.348708166200577e-06,4,1,3
11050,Satan,1.0687763893464371e-05,5.348708166200577e-06,8,5,3
11051,Satanic,8.592123914353715e-06,7.074097897233022e-06,8,4,4
11052,Satanist,4.400843956132392e-06,1.8979287041356905e-06,3,2,1
11053,Satellite,3.583544364279237e-05,2.777877466962238e-05,41,19,22
11054,Satire,2.3052039770217305e-06,3.6233184351681345e-06,3,1,2
11055,Saturday,0.00010289592297433347,0.0001019705331040174,121,56,65
11056,Saturn,1.48790438516857e-05,8.79948762826546e-06,14,7,7
11057,Saud,6.496483935243052e-06,7.074097897233022e-06,7,3,4
11058,Saudi,0.0008154135158719588,0.0007179346670825999,893,415,478
11059,Saudia,2.3052039770217305e-06,3.6233184351681345e-06,3,1,2
11060,Saudiled,2.116596378901769e-05,7.074097897233022e-06,17,10,7
11061,Savage,2.116596378901769e-05,1.052487735929791e-05,16,10,6
11062,Savannah,2.095639979110664e-07,5.348708166200577e-06,3,0,3
11063,Save,0.00024959072151208,0.0002192970348142235,274,136,138
11064,Saved,4.840928351745632e-05,3.640572332478458e-05,53,29,24
11065,Savile,4.400843956132392e-06,7.074097897233022e-06,6,2,4
11066,Saving,9.451336305789087e-05,5.3659620635109e-05,81,46,35
11067,Savvy,4.400843956132392e-06,1.8979287041356905e-06,4,2,2
11068,Saw,1.9070323809907035e-05,7.074097897233022e-06,14,9,5
11069,Sawyer,2.095639979110664e-07,3.6233184351681345e-06,3,0,3
11070,Say,0.0016641477074117777,0.001653095901302185,1952,883,1069
11071,Saying,6.098312339212028e-05,7.781507686956326e-05,81,33,48
11072,Scale,2.116596378901769e-05,1.3975656821362803e-05,20,10,10
11073,Scaled,2.095639979110664e-07,5.348708166200577e-06,4,0,4
11074,Scalia,4.840928351745632e-05,6.228656929027126e-05,63,24,39
11075,Scaling,2.3052039770217305e-06,1.8979287041356905e-06,3,2,1
11076,Scalise,2.116596378901769e-05,1.3975656821362803e-05,20,10,10
11077,Scam,4.002672360101368e-05,5.020884117304414e-05,51,20,31
11078,Scammer,4.400843956132392e-06,3.6233184351681345e-06,4,2,2
11079,Scan,6.496483935243052e-06,7.074097897233022e-06,7,3,4
11080,Scandal,0.00016576512234765329,0.00011922443041434203,166,87,79
11081,Scandalou,4.400843956132392e-06,1.8979287041356905e-06,3,2,1
11082,Scandinavia,6.496483935243052e-06,8.79948762826546e-06,10,4,6
11083,Scandinavian,1.0687763893464371e-05,8.79948762826546e-06,10,5,5
11084,Scanner,6.496483935243052e-06,3.6233184351681345e-06,5,3,2
11085,Scapegoat,2.095639979110664e-07,5.348708166200577e-06,3,0,3
11086,Scaramucci,3.583544364279237e-05,2.777877466962238e-05,38,17,21
11087,Scarborough,1.6974683830796368e-05,1.742643628342769e-05,18,8,10
11088,Scare,1.9070323809907035e-05,1.052487735929791e-05,17,11,6
11089,Scared,1.0687763893464371e-05,1.3975656821362803e-05,18,7,11
11090,Scarf,4.400843956132392e-06,3.6233184351681345e-06,4,2,2
11091,Scariest,2.095639979110664e-07,3.6233184351681345e-06,4,0,4
11092,Scarlett,4.400843956132392e-06,1.7253897310324457e-07,3,2,1
11093,Scary,6.496483935243052e-06,2.2602605476525032e-05,18,3,15
11094,Scathing,2.326160376812834e-05,5.348708166200577e-06,16,12,4
11095,Scenario,4.400843956132392e-06,8.79948762826546e-06,7,2,5
11096,Scene,3.3739803663681634e-05,2.777877466962238e-05,35,17,18
11097,Schatz,2.095639979110664e-07,5.348708166200577e-06,4,1,3
11098,Schedule,1.278340387257504e-05,1.742643628342769e-05,17,6,11
11099,Scheduled,4.400843956132392e-06,3.6233184351681345e-06,5,3,2
11100,Scheme,3.583544364279237e-05,2.4327995207557487e-05,34,17,17
11101,Schengen,8.592123914353715e-06,7.074097897233022e-06,8,4,4
11102,Schiff,1.6974683830796368e-05,2.4327995207557487e-05,23,8,15
11103,Schilling,6.496483935243052e-06,1.7253897310324457e-07,3,3,0
11104,Schindler,2.3052039770217305e-06,1.2250267090330355e-05,9,2,7
11105,Schism,4.400843956132392e-06,1.8979287041356905e-06,4,2,2
11106,Schizophrenia,2.3052039770217305e-06,5.348708166200577e-06,5,2,3
11107,Schmidt,1.278340387257504e-05,1.2250267090330355e-05,16,7,9
11108,Schmitt,2.3052039770217305e-06,3.6233184351681345e-06,3,1,2
11109,Schneiderman,2.3052039770217305e-06,1.9151826014460126e-05,12,1,11
11110,Schneier,4.400843956132392e-06,1.8979287041356905e-06,3,2,1
11111,Schock,4.400843956132392e-06,8.79948762826546e-06,7,2,5
11112,Scholar,1.6974683830796368e-05,1.3975656821362803e-05,18,8,10
11113,Scholarship,4.400843956132392e-06,8.79948762826546e-06,8,3,5
11114,School,0.00043819831963203963,0.00046602776635186325,540,231,309
11115,Schoolboy,2.3052039770217305e-06,3.6233184351681345e-06,3,1,2
11116,Schoolchildren,6.496483935243052e-06,1.7253897310324457e-07,5,4,1
11117,Schooler,8.592123914353715e-06,7.074097897233022e-06,8,4,4
11118,Schoolgirl,1.48790438516857e-05,7.074097897233022e-06,13,8,5
11119,Schroeder,4.400843956132392e-06,3.6233184351681345e-06,4,2,2
11120,Schuble,4.400843956132392e-06,1.8979287041356905e-06,5,4,1
11121,Schultz,2.5357243747239038e-05,2.777877466962238e-05,31,14,17
11122,Schumer,5.260056347567764e-05,7.263890767646595e-05,82,31,51
11123,Schwab,6.496483935243052e-06,3.6233184351681345e-06,5,3,2
11124,Schwartz,4.400843956132392e-06,5.348708166200577e-06,5,2,3
11125,Schwarzenegger,4.400843956132392e-06,8.79948762826546e-06,9,4,5
11126,Science,0.00010918284291166549,0.00016235917369015308,165,65,100
11127,Scientific,1.48790438516857e-05,2.6053384938589907e-05,24,8,16
11128,Scientist,0.00036065964040494494,0.00026588255755210003,362,190,172
11129,Scientologist,8.592123914353715e-06,1.052487735929791e-05,10,4,6
11130,Scientology,5.050492349656699e-05,6.573734875233614e-05,66,26,40
11131,Scion,2.095639979110664e-07,7.074097897233022e-06,5,0,5
11132,Scoff,2.3052039770217305e-06,1.8979287041356905e-06,3,1,2
11133,Scold,4.400843956132392e-06,3.6233184351681345e-06,4,2,2
11134,Scoop,2.3052039770217305e-06,5.348708166200577e-06,4,1,3
11135,Scooter,2.3052039770217305e-06,7.074097897233022e-06,5,1,4
11136,Scope,2.3052039770217305e-06,5.348708166200577e-06,4,1,3
11137,Scorch,2.3052039770217305e-06,5.348708166200577e-06,4,1,3
11138,Scorched,4.400843956132392e-06,7.074097897233022e-06,6,2,4
11139,Score,7.565260324589493e-05,6.056117955923882e-05,80,42,38
11140,Scot,6.496483935243052e-06,1.052487735929791e-05,11,4,7
11141,Scotch,6.496483935243052e-06,1.7253897310324457e-07,3,3,0
11142,Scotia,8.592123914353715e-06,1.8979287041356905e-06,6,4,2
11143,Scotland,0.00011127848289077625,0.00012612598933847184,144,61,83
11144,Scotsman,2.3052039770217305e-06,3.6233184351681345e-06,3,1,2
11145,Scott,0.0001825302421805385,0.0002469032705107427,278,109,169
11146,Scottish,7.146132328767358e-05,5.020884117304414e-05,74,37,37
11147,Scout,3.3739803663681634e-05,3.468033359375216e-05,37,16,21
11148,Scramble,1.48790438516857e-05,7.074097897233022e-06,12,8,4
11149,Scrambling,4.400843956132392e-06,5.348708166200577e-06,5,2,3
11150,Scrap,8.592123914353715e-06,2.6053384938589907e-05,22,6,16
11151,Scrapped,6.496483935243052e-06,3.6233184351681345e-06,5,3,2
11152,Scrapping,2.095639979110664e-07,5.348708166200577e-06,4,0,4
11153,Scratching,2.095639979110664e-07,3.6233184351681345e-06,3,1,2
11154,Scream,1.278340387257504e-05,3.6233184351681345e-06,8,6,2
11155,Screaming,8.592123914353715e-06,1.8979287041356905e-06,6,4,2
11156,Screen,1.6974683830796368e-05,8.79948762826546e-06,13,8,5
11157,Screening,6.496483935243052e-06,1.9151826014460126e-05,16,4,12
11158,Screw,1.278340387257504e-05,1.742643628342769e-05,17,7,10
11159,Screwed,4.400843956132392e-06,8.79948762826546e-06,8,3,5
11160,Screwing,6.496483935243052e-06,5.348708166200577e-06,7,3,4
11161,Script,2.3052039770217305e-06,8.79948762826546e-06,6,1,5
11162,Scroll,1.0687763893464371e-05,5.348708166200577e-06,8,5,3
11163,Scrooge,4.400843956132392e-06,1.7253897310324457e-07,3,2,1
11164,Scrutiny,1.0687763893464371e-05,1.3975656821362803e-05,16,7,9
11165,Scud,4.400843956132392e-06,3.6233184351681345e-06,4,2,2
11166,Sculpture,4.400843956132392e-06,1.8979287041356905e-06,3,2,1
11167,Sea,0.00019091280209698145,0.0002192970348142235,244,103,141
11168,SeaWorld,2.3052039770217305e-06,1.2250267090330355e-05,10,3,7
11169,Seahawk,2.095639979110664e-07,5.348708166200577e-06,3,0,3
11170,Seal,1.0687763893464371e-05,2.4327995207557487e-05,23,7,16
11171,Sealed,8.592123914353715e-06,5.348708166200577e-06,7,4,3
11172,Sean,0.00012175668278632962,8.644202552472544e-05,120,59,61
11173,Sear,6.496483935243052e-06,3.6233184351681345e-06,5,3,2
11174,Search,7.355696326678427e-05,5.883578982820635e-05,80,42,38
11175,Searching,1.278340387257504e-05,2.087721574549256e-05,18,6,12
11176,Searing,2.3052039770217305e-06,7.074097897233022e-06,5,1,4
11177,Season,5.260056347567764e-05,6.056117955923882e-05,68,28,40
11178,Seat,5.4696203454788295e-05,7.608968713853079e-05,81,31,50
11179,Seattle,4.212236358012434e-05,4.8483451442011706e-05,56,24,32
11180,Sebastian,1.0687763893464371e-05,3.6233184351681345e-06,7,5,2
11181,Sec,6.496483935243052e-06,1.7253897310324457e-07,4,3,1
11182,Secession,6.496483935243052e-06,3.6233184351681345e-06,5,3,2
11183,Second,0.00016366948236854273,0.00015373222503499084,194,90,104
11184,SecondClas,4.400843956132392e-06,1.8979287041356905e-06,4,2,2
11185,Secrecy,1.6974683830796368e-05,1.570104655239525e-05,17,8,9
11186,Secret,0.0002726427612822975,0.0002607063883590024,324,150,174
11187,Secretary,0.00028521660115696105,0.0003072919110968788,359,157,202
11188,SecretaryGeneral,1.48790438516857e-05,3.6233184351681345e-06,12,9,3
11189,Secretive,8.592123914353715e-06,5.348708166200577e-06,10,5,5
11190,Secretly,1.0687763893464371e-05,1.2250267090330355e-05,13,5,8
11191,Sectarian,2.3052039770217305e-06,3.6233184351681345e-06,3,1,2
11192,Section,4.400843956132392e-06,1.052487735929791e-05,12,3,9
11193,Sector,1.0687763893464371e-05,1.2250267090330355e-05,12,5,7
11194,Secular,1.278340387257504e-05,1.3975656821362803e-05,17,6,11
11195,Secularism,2.3052039770217305e-06,3.6233184351681345e-06,3,1,2
11196,Secure,1.48790438516857e-05,2.087721574549256e-05,21,9,12
11197,Security,0.00039838116002893705,0.00047810549446909034,535,220,315
11198,Sedol,2.3052039770217305e-06,3.6233184351681345e-06,4,1,3
11199,See,0.00020139100199253443,0.00020721930669699654,244,108,136
11200,Seed,2.116596378901769e-05,1.8979287041356905e-06,14,10,4
11201,Seeing,1.278340387257504e-05,1.3975656821362803e-05,17,7,10
11202,Seek,0.0001154697628489974,0.00011922443041434203,135,62,73
11203,Seeker,1.0687763893464371e-05,7.074097897233022e-06,9,5,4
11204,Seeking,2.954852370546031e-05,3.468033359375216e-05,35,14,21
11205,Seem,6.936568330856297e-05,9.161819471782287e-05,96,39,57
11206,Seemingly,6.496483935243052e-06,3.6233184351681345e-06,6,4,2
11207,Seen,2.954852370546031e-05,5.5385010366141504e-05,51,17,34
11208,Segment,2.3052039770217305e-06,1.8979287041356905e-06,3,1,2
11209,Segregation,6.496483935243052e-06,3.6233184351681345e-06,6,3,3
11210,Seif,2.3052039770217305e-06,3.6233184351681345e-06,3,1,2
11211,Seinfeld,2.3052039770217305e-06,3.6233184351681345e-06,4,2,2
11212,Seismic,4.400843956132392e-06,3.6233184351681345e-06,5,2,3
11213,Seize,2.954852370546031e-05,2.9504164400654783e-05,33,15,18
11214,Seized,2.326160376812834e-05,1.742643628342769e-05,25,14,11
11215,Seizure,6.496483935243052e-06,5.348708166200577e-06,8,4,4
11216,Sekulow,6.496483935243052e-06,3.6233184351681345e-06,5,3,2
11217,Select,1.48790438516857e-05,1.742643628342769e-05,18,8,10
11218,Selection,6.496483935243052e-06,1.052487735929791e-05,9,3,6
11219,Self,1.48790438516857e-05,1.052487735929791e-05,15,7,8
11220,SelfDriving,2.7452883726349685e-05,2.087721574549256e-05,31,16,15
11221,SelfOwn,6.496483935243052e-06,1.8979287041356905e-06,4,3,1
11222,Selfie,1.0687763893464371e-05,1.3975656821362803e-05,14,5,9
11223,Selfish,4.400843956132392e-06,5.348708166200577e-06,6,2,4
11224,Selfles,4.400843956132392e-06,5.348708166200577e-06,6,2,4
11225,Selfy,6.496483935243052e-06,8.79948762826546e-06,8,3,5
11226,Sell,6.098312339212028e-05,6.056117955923882e-05,70,31,39
11227,Sellafield,4.400843956132392e-06,1.8979287041356905e-06,3,2,1
11228,Seller,8.592123914353715e-06,1.8979287041356905e-06,6,5,1
11229,Selling,3.3739803663681634e-05,6.056117955923882e-05,54,16,38
11230,Selma,4.400843956132392e-06,3.6233184351681345e-06,4,2,2
11231,Semenya,2.3052039770217305e-06,1.8979287041356905e-06,4,1,3
11232,Sen,0.0003438945205720597,0.0003814836695312734,425,178,247
11233,Senate,0.0009977341940545868,0.0011268520333372895,1265,520,745
11234,Senator,0.0004277201197364861,0.0004435976998484416,509,228,281
11235,Send,9.870464301611217e-05,0.0001036959228350498,118,54,64
11236,SendOff,2.3052039770217305e-06,3.6233184351681345e-06,3,1,2
11237,Sending,2.326160376812834e-05,3.640572332478458e-05,34,12,22
11238,Senegal,1.0687763893464371e-05,1.052487735929791e-05,11,5,6
11239,Senior,9.451336305789087e-05,6.918812821440096e-05,95,49,46
11240,Senkaku,4.400843956132392e-06,5.348708166200577e-06,5,2,3
11241,Sense,4.212236358012434e-05,2.6053384938589907e-05,40,21,19
11242,Senseles,4.400843956132392e-06,1.8979287041356905e-06,4,2,2
11243,Sensible,2.3052039770217305e-06,3.6233184351681345e-06,3,1,2
11244,Sensitive,1.0687763893464371e-05,7.074097897233022e-06,11,5,6
11245,Sent,2.954852370546031e-05,2.777877466962238e-05,32,14,18
11246,Sentence,5.4696203454788295e-05,4.6758061710979285e-05,59,26,33
11247,Sentenced,4.002672360101368e-05,4.1581892517881935e-05,50,22,28
11248,Sentencing,1.0687763893464371e-05,1.570104655239525e-05,19,6,13
11249,Sentiment,2.3052039770217305e-06,7.074097897233022e-06,6,1,5
11250,Seoul,3.3739803663681634e-05,3.2954943862719716e-05,40,19,21
11251,Sep,6.496483935243052e-06,1.8979287041356905e-06,4,3,1
11252,Separate,6.496483935243052e-06,7.074097897233022e-06,9,5,4
11253,Separated,2.3052039770217305e-06,5.348708166200577e-06,4,1,3
11254,Separating,4.400843956132392e-06,3.6233184351681345e-06,4,2,2
11255,Separation,1.278340387257504e-05,1.052487735929791e-05,13,6,7
11256,Separatist,2.095639979110664e-07,8.79948762826546e-06,6,0,6
11257,Sepp,1.0687763893464371e-05,1.3975656821362803e-05,15,5,10
11258,Sept,6.098312339212028e-05,3.2954943862719716e-05,53,32,21
11259,September,9.24177230787802e-05,0.00011404826122124471,122,49,73
11260,Sequel,2.095639979110664e-07,5.348708166200577e-06,3,0,3
11261,Serb,8.592123914353715e-06,1.052487735929791e-05,13,5,8
11262,Serbia,2.326160376812834e-05,2.4327995207557487e-05,26,11,15
11263,Serbian,6.496483935243052e-06,8.79948762826546e-06,13,5,8
11264,Serena,6.496483935243052e-06,1.7253897310324457e-07,4,3,1
11265,Sergeant,2.095639979110664e-07,3.6233184351681345e-06,4,1,3
11266,Sergei,8.592123914353715e-06,5.348708166200577e-06,7,4,3
11267,Sergey,8.592123914353715e-06,5.348708166200577e-06,7,4,3
11268,Sergio,4.400843956132392e-06,1.8979287041356905e-06,3,2,1
11269,Serial,1.0687763893464371e-05,7.074097897233022e-06,9,5,4
11270,Series,2.326160376812834e-05,2.4327995207557487e-05,27,11,16
11271,Seriou,4.002672360101368e-05,4.8483451442011706e-05,55,21,34
11272,Seriously,5.4696203454788295e-05,4.50326719799468e-05,58,30,28
11273,Sermon,2.3052039770217305e-06,3.6233184351681345e-06,3,1,2
11274,Serve,4.002672360101368e-05,4.1581892517881935e-05,44,19,25
11275,Server,1.278340387257504e-05,1.9151826014460126e-05,20,7,13
11276,Service,0.0002244430417627521,0.0002313747629314509,273,125,148
11277,Servile,2.3052039770217305e-06,3.6233184351681345e-06,3,1,2
11278,Serving,1.278340387257504e-05,8.79948762826546e-06,12,7,5
11279,Sesame,2.3052039770217305e-06,8.79948762826546e-06,9,2,7
11280,Session,0.00018672152213876006,0.00022102242454525643,235,93,142
11281,Sessions,2.3052039770217305e-06,7.074097897233022e-06,6,1,5
11282,Set,0.0001741476822640959,0.0001554576147660233,194,94,100
11283,Setback,8.592123914353715e-06,1.570104655239525e-05,13,4,9
11284,Seth,8.592123914353715e-06,1.9151826014460126e-05,16,5,11
11285,Setting,2.116596378901769e-05,2.087721574549256e-05,22,10,12
11286,Settle,2.116596378901769e-05,3.468033359375216e-05,31,10,21
11287,Settled,2.3052039770217305e-06,5.348708166200577e-06,5,2,3
11288,Settlement,5.4696203454788295e-05,7.091351794543343e-05,76,31,45
11289,Settler,2.5357243747239038e-05,2.4327995207557487e-05,29,15,14
11290,Sevastopol,4.400843956132392e-06,5.348708166200577e-06,5,2,3
11291,Seven,4.6313643538345614e-05,5.1934230904076595e-05,58,24,34
11292,Sever,6.496483935243052e-06,1.7253897310324457e-07,3,3,0
11293,Several,6.517440335034157e-05,6.573734875233614e-05,83,40,43
11294,Severance,4.400843956132392e-06,1.8979287041356905e-06,3,2,1
11295,Severe,1.48790438516857e-05,1.9151826014460126e-05,19,7,12
11296,Severed,2.3052039770217305e-06,1.8979287041356905e-06,3,1,2
11297,Severely,4.400843956132392e-06,1.2250267090330355e-05,9,2,7
11298,Sewage,6.496483935243052e-06,5.348708166200577e-06,6,3,3
11299,Sex,0.00015109564249387862,0.00014683066611086105,176,77,99
11300,Sexism,1.9070323809907035e-05,2.2602605476525032e-05,23,10,13
11301,Sexist,2.7452883726349685e-05,1.2250267090330355e-05,23,13,10
11302,Sexting,6.496483935243052e-06,3.6233184351681345e-06,6,4,2
11303,Sexual,0.00020767792192986646,0.00016580995315221804,217,109,108
11304,Sexually,2.7452883726349685e-05,1.2250267090330355e-05,23,15,8
11305,Sexy,6.496483935243052e-06,7.074097897233022e-06,7,3,4
11306,Seychelle,6.496483935243052e-06,7.074097897233022e-06,7,3,4
11307,Seymour,2.3052039770217305e-06,3.6233184351681345e-06,3,1,2
11308,Sgt,8.592123914353715e-06,8.79948762826546e-06,10,5,5
11309,Shabaab,8.592123914353715e-06,1.8979287041356905e-06,7,5,2
11310,Shabab,4.400843956132392e-06,3.6233184351681345e-06,4,2,2
11311,Shack,2.3052039770217305e-06,5.348708166200577e-06,4,1,3
11312,Shade,2.116596378901769e-05,5.348708166200577e-06,13,10,3
11313,Shadow,1.0687763893464371e-05,2.6053384938589907e-05,21,6,15
11314,Shadowy,8.592123914353715e-06,3.6233184351681345e-06,7,5,2
11315,Shady,4.400843956132392e-06,7.074097897233022e-06,6,2,4
11316,Shah,4.400843956132392e-06,1.8979287041356905e-06,3,2,1
11317,Shake,2.326160376812834e-05,2.777877466962238e-05,31,14,17
11318,ShakeUp,4.400843956132392e-06,3.6233184351681345e-06,5,3,2
11319,Shakedown,2.095639979110664e-07,5.348708166200577e-06,3,0,3
11320,Shaken,6.496483935243052e-06,3.6233184351681345e-06,5,3,2
11321,Shakespeare,4.400843956132392e-06,1.3975656821362803e-05,11,2,9
11322,Shakespearean,6.496483935243052e-06,1.7253897310324457e-07,3,3,0
11323,Shakil,4.400843956132392e-06,3.6233184351681345e-06,4,2,2
11324,Shaking,6.496483935243052e-06,5.348708166200577e-06,8,3,5
11325,Shaky,6.496483935243052e-06,5.348708166200577e-06,6,3,3
11326,Shale,4.400843956132392e-06,3.6233184351681345e-06,4,2,2
11327,Shalit,6.496483935243052e-06,8.79948762826546e-06,9,4,5
11328,Shall,8.592123914353715e-06,3.6233184351681345e-06,7,4,3
11329,Sham,1.0687763893464371e-05,8.79948762826546e-06,11,6,5
11330,Shame,3.583544364279237e-05,3.640572332478458e-05,42,17,25
11331,Shameful,2.3052039770217305e-06,1.2250267090330355e-05,10,1,9
11332,Shameles,2.095639979110664e-07,7.074097897233022e-06,4,0,4
11333,Shamelessly,4.400843956132392e-06,1.8979287041356905e-06,3,2,1
11334,Shaming,4.400843956132392e-06,5.348708166200577e-06,7,3,4
11335,Shanghai,2.326160376812834e-05,2.2602605476525032e-05,26,12,14
11336,Shannon,2.3052039770217305e-06,8.79948762826546e-06,8,2,6
11337,Shape,1.0687763893464371e-05,8.79948762826546e-06,11,5,6
11338,Shaping,6.496483935243052e-06,3.6233184351681345e-06,10,6,4
11339,Shapiro,2.3052039770217305e-06,7.074097897233022e-06,5,1,4
11340,Share,7.984388320411623e-05,7.608968713853079e-05,95,43,52
11341,Shared,1.278340387257504e-05,1.9151826014460126e-05,20,8,12
11342,Shareholder,1.9070323809907035e-05,8.79948762826546e-06,14,9,5
11343,Sharia,4.4218003559234974e-05,2.9504164400654783e-05,45,23,22
11344,Shariah,6.496483935243052e-06,1.8979287041356905e-06,5,3,2
11345,Sharif,2.3052039770217305e-06,5.348708166200577e-06,6,1,5
11346,Sharing,2.326160376812834e-05,1.9151826014460126e-05,28,12,16
11347,Shark,2.954852370546031e-05,5.3659620635109e-05,50,17,33
11348,Sharon,8.592123914353715e-06,1.8979287041356905e-06,5,4,1
11349,Sharp,2.3052039770217305e-06,1.052487735929791e-05,7,1,6
11350,Sharpie,2.095639979110664e-07,5.348708166200577e-06,3,0,3
11351,Sharply,6.496483935243052e-06,8.79948762826546e-06,8,3,5
11352,Sharpton,2.3052039770217305e-06,7.074097897233022e-06,5,1,4
11353,Shatter,2.3052039770217305e-06,1.052487735929791e-05,8,2,6
11354,Shattered,2.3052039770217305e-06,8.79948762826546e-06,8,2,6
11355,Shaub,4.400843956132392e-06,1.8979287041356905e-06,5,2,3
11356,Shaun,2.095639979110664e-07,1.8979287041356905e-06,3,1,2
11357,Shave,4.400843956132392e-06,1.8979287041356905e-06,3,2,1
11358,Shaw,4.400843956132392e-06,8.79948762826546e-06,7,2,5
11359,She,8.592123914353715e-06,2.2602605476525032e-05,18,4,14
11360,Shed,1.0687763893464371e-05,1.3975656821362803e-05,15,7,8
11361,Sheep,8.592123914353715e-06,7.074097897233022e-06,8,4,4
11362,Sheet,2.3052039770217305e-06,7.074097897233022e-06,5,1,4
11363,Sheik,4.400843956132392e-06,3.6233184351681345e-06,4,2,2
11364,Sheikh,8.592123914353715e-06,1.570104655239525e-05,15,5,10
11365,Sheila,6.496483935243052e-06,8.79948762826546e-06,8,3,5
11366,Shelby,2.3052039770217305e-06,1.8979287041356905e-06,3,1,2
11367,Sheldon,1.6974683830796368e-05,1.2250267090330355e-05,22,8,14
11368,Shelf,1.0687763893464371e-05,5.348708166200577e-06,8,5,3
11369,Shell,0.00010080028299522283,9.334358444885519e-05,110,51,59
11370,Shelley,4.400843956132392e-06,3.6233184351681345e-06,4,2,2
11371,Shelling,2.3052039770217305e-06,1.8979287041356905e-06,3,1,2
11372,Shelter,4.6313643538345614e-05,5.5385010366141504e-05,58,23,35
11373,Shenyang,2.095639979110664e-07,7.074097897233022e-06,4,0,4
11374,Shenzhen,6.496483935243052e-06,1.8979287041356905e-06,4,3,1
11375,Shepard,4.400843956132392e-06,3.6233184351681345e-06,4,2,2
11376,Shepherd,3.1644163684570994e-05,1.742643628342769e-05,28,16,12
11377,Sheriff,5.050492349656699e-05,6.918812821440096e-05,69,26,43
11378,Sherpa,6.496483935243052e-06,1.052487735929791e-05,9,3,6
11379,Sherrod,2.095639979110664e-07,1.2250267090330355e-05,7,0,7
11380,Sheryl,8.592123914353715e-06,5.348708166200577e-06,9,6,3
11381,Shetland,6.496483935243052e-06,1.8979287041356905e-06,5,3,2
11382,Shia,2.7452883726349685e-05,2.2602605476525032e-05,29,13,16
11383,Shield,1.6974683830796368e-05,1.052487735929791e-05,16,9,7
11384,Shielding,2.3052039770217305e-06,3.6233184351681345e-06,4,1,3
11385,Shift,4.002672360101368e-05,3.8131113055817005e-05,46,23,23
11386,Shifting,1.278340387257504e-05,5.348708166200577e-06,9,6,3
11387,Shiite,2.954852370546031e-05,3.640572332478458e-05,38,15,23
11388,Shimon,4.400843956132392e-06,3.6233184351681345e-06,4,2,2
11389,Shin,1.48790438516857e-05,3.6233184351681345e-06,12,8,4
11390,Shinawatra,4.400843956132392e-06,5.348708166200577e-06,5,2,3
11391,Shine,1.278340387257504e-05,1.052487735929791e-05,12,6,6
11392,Shining,2.3052039770217305e-06,3.6233184351681345e-06,3,1,2
11393,Shinzo,1.0687763893464371e-05,7.074097897233022e-06,10,5,5
11394,Ship,6.307876337123095e-05,5.3659620635109e-05,69,34,35
11395,Shipment,4.400843956132392e-06,5.348708166200577e-06,5,2,3
11396,Shipped,2.3052039770217305e-06,3.6233184351681345e-06,3,1,2
11397,Shipping,1.0687763893464371e-05,1.052487735929791e-05,12,6,6
11398,Shipwreck,4.400843956132392e-06,1.052487735929791e-05,9,2,7
11399,Shirin,8.592123914353715e-06,3.6233184351681345e-06,6,4,2
11400,Shirley,2.3052039770217305e-06,3.6233184351681345e-06,3,1,2
11401,Shirt,1.278340387257504e-05,1.052487735929791e-05,12,6,6
11402,Shit,1.0687763893464371e-05,5.348708166200577e-06,9,5,4
11403,Shithole,1.9070323809907035e-05,1.3975656821362803e-05,18,9,9
11404,Shkreli,1.48790438516857e-05,1.742643628342769e-05,17,7,10
11405,Shock,2.326160376812834e-05,3.468033359375216e-05,35,14,21
11406,Shocked,1.0687763893464371e-05,1.3975656821362803e-05,13,5,8
11407,Shocking,2.954852370546031e-05,2.777877466962238e-05,37,19,18
11408,Shockingly,1.0687763893464371e-05,5.348708166200577e-06,8,5,3
11409,Shoe,2.326160376812834e-05,1.3975656821362803e-05,21,13,8
11410,Shoethrower,4.400843956132392e-06,1.8979287041356905e-06,3,2,1
11411,Shook,4.400843956132392e-06,5.348708166200577e-06,5,2,3
11412,Shoot,3.583544364279237e-05,4.50326719799468e-05,50,22,28
11413,Shooter,2.954852370546031e-05,3.122955413168725e-05,37,18,19
11414,Shooting,0.00028940788111518276,0.0003072919110968788,362,157,205
11415,Shootout,2.3052039770217305e-06,3.6233184351681345e-06,4,1,3
11416,Shop,3.1644163684570994e-05,3.8131113055817005e-05,45,17,28
11417,Shoplifting,2.3052039770217305e-06,1.2250267090330355e-05,8,1,7
11418,Shopper,2.116596378901769e-05,2.4327995207557487e-05,28,11,17
11419,Shopping,4.840928351745632e-05,3.122955413168725e-05,42,23,19
11420,Shore,1.0687763893464371e-05,7.074097897233022e-06,9,5,4
11421,Short,3.583544364279237e-05,4.1581892517881935e-05,46,19,27
11422,ShortTerm,4.400843956132392e-06,1.8979287041356905e-06,4,2,2
11423,Shortage,1.9070323809907035e-05,1.9151826014460126e-05,22,9,13
11424,Shorted,4.400843956132392e-06,1.8979287041356905e-06,4,3,1
11425,Shorten,4.400843956132392e-06,3.6233184351681345e-06,5,2,3
11426,Shorter,2.3052039770217305e-06,1.7253897310324457e-07,3,1,2
11427,Shortly,2.3052039770217305e-06,1.8979287041356905e-06,3,1,2
11428,Shot,9.451336305789087e-05,0.00012440059960743937,127,48,79
11429,Should,2.3052039770217305e-06,1.8979287041356905e-06,3,1,2
11430,Shoulder,2.3052039770217305e-06,3.6233184351681345e-06,3,1,2
11431,Shouldn,6.496483935243052e-06,1.052487735929791e-05,9,3,6
11432,Shout,2.3052039770217305e-06,8.79948762826546e-06,6,1,5
11433,Shouting,6.496483935243052e-06,1.8979287041356905e-06,4,3,1
11434,Shoutout,6.496483935243052e-06,1.8979287041356905e-06,4,3,1
11435,Shoved,2.3052039770217305e-06,5.348708166200577e-06,4,1,3
11436,Shovel,4.400843956132392e-06,3.6233184351681345e-06,4,2,2
11437,Show,0.0004947805990680274,0.0004246184128070847,532,255,277
11438,Showdown,1.48790438516857e-05,2.087721574549256e-05,20,7,13
11439,Showed,2.116596378901769e-05,1.052487735929791e-05,17,10,7
11440,Shower,1.6974683830796368e-05,1.052487735929791e-05,15,9,6
11441,Showing,2.5357243747239038e-05,2.2602605476525032e-05,27,12,15
11442,Shown,8.592123914353715e-06,3.6233184351681345e-06,6,4,2
11443,Shred,8.592123914353715e-06,1.2250267090330355e-05,13,6,7
11444,Shrimp,2.3052039770217305e-06,5.348708166200577e-06,4,1,3
11445,Shrink,2.3052039770217305e-06,1.2250267090330355e-05,8,1,7
11446,Shrinking,6.496483935243052e-06,1.2250267090330355e-05,10,3,7
11447,Shroud,6.496483935243052e-06,1.7253897310324457e-07,3,3,0
11448,Shrug,1.0687763893464371e-05,1.052487735929791e-05,12,5,7
11449,Shuffle,6.496483935243052e-06,1.8979287041356905e-06,4,3,1
11450,Shulkin,4.400843956132392e-06,1.052487735929791e-05,8,2,6
11451,Shun,6.496483935243052e-06,1.8979287041356905e-06,4,3,1
11452,Shunning,4.400843956132392e-06,1.8979287041356905e-06,3,2,1
11453,Shut,8.193952318322689e-05,7.263890767646595e-05,89,42,47
11454,Shutdown,6.098312339212028e-05,8.816741525575797e-05,93,32,61
11455,Shutter,2.3052039770217305e-06,3.6233184351681345e-06,3,1,2
11456,Shutting,1.0687763893464371e-05,8.79948762826546e-06,11,5,6
11457,Shuttle,6.496483935243052e-06,1.7253897310324457e-07,3,3,0
11458,Shy,1.278340387257504e-05,5.348708166200577e-06,10,7,3
11459,Siberia,2.116596378901769e-05,1.570104655239525e-05,22,13,9
11460,Siberian,1.48790438516857e-05,2.2602605476525032e-05,23,7,16
11461,Sibling,8.592123914353715e-06,1.8979287041356905e-06,6,5,1
11462,Sichuan,1.0687763893464371e-05,5.348708166200577e-06,8,5,3
11463,Sicilian,2.095639979110664e-07,7.074097897233022e-06,4,0,4
11464,Sicily,6.496483935243052e-06,7.074097897233022e-06,7,3,4
11465,Sick,5.4696203454788295e-05,5.1934230904076595e-05,60,27,33
11466,Sickened,2.3052039770217305e-06,3.6233184351681345e-06,3,1,2
11467,Sicknes,2.3052039770217305e-06,1.7253897310324457e-07,3,1,2
11468,Side,8.403516316233764e-05,9.506897417988779e-05,101,44,57
11469,Sideline,2.095639979110664e-07,5.348708166200577e-06,3,0,3
11470,Sidestep,6.496483935243052e-06,3.6233184351681345e-06,5,3,2
11471,Sidewalk,4.400843956132392e-06,3.6233184351681345e-06,4,2,2
11472,Siding,4.400843956132392e-06,1.8979287041356905e-06,3,2,1
11473,Sidney,4.400843956132392e-06,3.6233184351681345e-06,4,2,2
11474,Siege,4.400843956132392e-06,1.3975656821362803e-05,11,2,9
11475,Siemens,4.400843956132392e-06,1.8979287041356905e-06,5,3,2
11476,Sierra,3.7931083621902995e-05,3.8131113055817005e-05,43,20,23
11477,Sigh,8.592123914353715e-06,7.074097897233022e-06,9,5,4
11478,Sight,6.496483935243052e-06,1.9151826014460126e-05,19,4,15
11479,Sighting,2.3052039770217305e-06,3.6233184351681345e-06,3,1,2
11480,Sigmar,4.400843956132392e-06,1.8979287041356905e-06,4,2,2
11481,Sign,0.00027683404124051843,0.00024172710131764556,303,145,158
11482,SignUp,2.3052039770217305e-06,5.348708166200577e-06,5,2,3
11483,Signal,1.9070323809907035e-05,1.3975656821362803e-05,21,11,10
11484,Signaling,2.3052039770217305e-06,5.348708166200577e-06,4,1,3
11485,Signature,1.0687763893464371e-05,8.79948762826546e-06,11,6,5
11486,Signed,1.9070323809907035e-05,1.570104655239525e-05,20,9,11
11487,Significant,1.0687763893464371e-05,7.074097897233022e-06,12,6,6
11488,Significantly,2.3052039770217305e-06,1.052487735929791e-05,9,2,7
11489,Signing,8.592123914353715e-06,1.742643628342769e-05,17,5,12
11490,Sikh,2.5357243747239038e-05,2.2602605476525032e-05,35,16,19
11491,Silence,4.002672360101368e-05,6.228656929027126e-05,62,22,40
11492,Silenced,6.496483935243052e-06,7.074097897233022e-06,7,3,4
11493,Silencer,2.095639979110664e-07,7.074097897233022e-06,5,1,4
11494,Silencing,2.3052039770217305e-06,8.79948762826546e-06,7,1,6
11495,Silent,3.583544364279237e-05,3.640572332478458e-05,44,21,23
11496,Silicon,5.888748341300963e-05,3.985650278684949e-05,59,30,29
11497,Silk,2.326160376812834e-05,1.9151826014460126e-05,25,13,12
11498,Silly,6.496483935243052e-06,3.6233184351681345e-06,5,3,2
11499,Silva,6.496483935243052e-06,3.6233184351681345e-06,7,3,4
11500,Silver,1.9070323809907035e-05,2.2602605476525032e-05,24,9,15
11501,Silvio,2.7452883726349685e-05,4.8483451442011706e-05,45,16,29
11502,Similar,1.0687763893464371e-05,1.2250267090330355e-05,12,5,7
11503,Simmon,2.3052039770217305e-06,7.074097897233022e-06,5,1,4
11504,Simon,1.6974683830796368e-05,1.742643628342769e-05,19,8,11
11505,Simone,4.400843956132392e-06,7.074097897233022e-06,9,2,7
11506,Simple,6.517440335034157e-05,6.056117955923882e-05,74,35,39
11507,Simpler,4.400843956132392e-06,1.8979287041356905e-06,3,2,1
11508,Simply,1.48790438516857e-05,1.052487735929791e-05,16,8,8
11509,Simpson,1.0687763893464371e-05,1.570104655239525e-05,18,6,12
11510,Simulation,1.0687763893464371e-05,3.6233184351681345e-06,7,5,2
11511,Sin,8.592123914353715e-06,3.6233184351681345e-06,7,5,2
11512,Sinai,1.48790438516857e-05,3.468033359375216e-05,30,9,21
11513,Sinaloa,2.3052039770217305e-06,7.074097897233022e-06,6,2,4
11514,Since,0.00016995640230587486,0.0002106700861590614,233,92,141
11515,Sinclair,2.095639979110664e-07,5.348708166200577e-06,6,0,6
11516,Sing,1.278340387257504e-05,1.742643628342769e-05,20,10,10
11517,Singapore,6.098312339212028e-05,5.020884117304414e-05,64,30,34
11518,Singaporean,2.3052039770217305e-06,3.6233184351681345e-06,5,1,4
11519,Singer,2.3052039770217305e-06,1.570104655239525e-05,10,1,9
11520,Singh,1.0687763893464371e-05,8.79948762826546e-06,11,5,6
11521,Singing,2.095639979110664e-07,8.79948762826546e-06,7,1,6
11522,Single,6.307876337123095e-05,4.6758061710979285e-05,64,33,31
11523,SinglePayer,1.48790438516857e-05,1.3975656821362803e-05,17,7,10
11524,Sinjar,6.496483935243052e-06,8.79948762826546e-06,8,3,5
11525,Sink,1.48790438516857e-05,2.4327995207557487e-05,22,8,14
11526,Sinking,1.0687763893464371e-05,1.3975656821362803e-05,14,5,9
11527,Sinn,8.592123914353715e-06,3.6233184351681345e-06,6,4,2
11528,Sioux,6.496483935243052e-06,5.348708166200577e-06,8,3,5
11529,Sir,3.7931083621902995e-05,1.742643628342769e-05,35,19,16
11530,Siren,2.3052039770217305e-06,3.6233184351681345e-06,3,1,2
11531,Siri,4.400843956132392e-06,7.074097897233022e-06,6,2,4
11532,Sirte,2.3052039770217305e-06,8.79948762826546e-06,7,1,6
11533,Sisi,8.592123914353715e-06,7.074097897233022e-06,8,4,4
11534,Sister,2.326160376812834e-05,1.742643628342769e-05,23,12,11
11535,Sisterhood,4.400843956132392e-06,1.8979287041356905e-06,3,2,1
11536,Sit,2.326160376812834e-05,1.570104655239525e-05,22,12,10
11537,SitIn,1.48790438516857e-05,7.074097897233022e-06,12,7,5
11538,Site,0.00010080028299522283,6.056117955923882e-05,97,54,43
11539,Sitting,1.9070323809907035e-05,8.79948762826546e-06,20,14,6
11540,Situation,1.9070323809907035e-05,2.2602605476525032e-05,25,10,15
11541,Six,0.00010289592297433347,0.0001036959228350498,122,55,67
11542,Sixteen,8.592123914353715e-06,8.79948762826546e-06,9,4,5
11543,Sixth,6.496483935243052e-06,7.074097897233022e-06,7,3,4
11544,Sixty,2.3052039770217305e-06,5.348708166200577e-06,4,1,3
11545,Size,2.5357243747239038e-05,1.052487735929791e-05,21,14,7
11546,Skeleton,1.0687763893464371e-05,1.7253897310324457e-07,5,5,0
11547,Skeptic,1.278340387257504e-05,1.8979287041356905e-06,7,6,1
11548,Skeptical,8.592123914353715e-06,1.2250267090330355e-05,11,4,7
11549,Skepticism,1.48790438516857e-05,3.6233184351681345e-06,10,7,3
11550,Sketch,4.400843956132392e-06,5.348708166200577e-06,5,2,3
11551,Skewed,2.3052039770217305e-06,1.7253897310324457e-07,3,2,1
11552,Skewer,1.0687763893464371e-05,7.074097897233022e-06,12,7,5
11553,Skier,2.3052039770217305e-06,1.8979287041356905e-06,3,2,1
11554,Skill,1.6974683830796368e-05,2.4327995207557487e-05,23,8,15
11555,Skilled,2.3052039770217305e-06,5.348708166200577e-06,4,1,3
11556,Skin,4.400843956132392e-06,1.052487735929791e-05,11,4,7
11557,Skinhead,4.400843956132392e-06,3.6233184351681345e-06,4,2,2
11558,Skinny,1.48790438516857e-05,1.7253897310324457e-07,7,7,0
11559,Skip,1.9070323809907035e-05,1.2250267090330355e-05,19,10,9
11560,Skipped,6.496483935243052e-06,1.8979287041356905e-06,4,3,1
11561,Skipping,8.592123914353715e-06,8.79948762826546e-06,11,5,6
11562,Skirt,2.3052039770217305e-06,3.6233184351681345e-06,3,1,2
11563,Skittle,2.095639979110664e-07,7.074097897233022e-06,4,0,4
11564,Skull,1.0687763893464371e-05,1.052487735929791e-05,11,5,6
11565,Sky,5.4696203454788295e-05,3.985650278684949e-05,51,26,25
11566,Skype,2.116596378901769e-05,2.6053384938589907e-05,25,10,15
11567,Skyrocket,2.3052039770217305e-06,1.8979287041356905e-06,3,1,2
11568,Skyrocketing,2.3052039770217305e-06,5.348708166200577e-06,4,1,3
11569,Skywalker,4.400843956132392e-06,1.8979287041356905e-06,3,2,1
11570,Slack,4.400843956132392e-06,1.8979287041356905e-06,3,2,1
11571,Slager,6.496483935243052e-06,3.6233184351681345e-06,7,3,4
11572,Slain,1.278340387257504e-05,3.468033359375216e-05,28,8,20
11573,Slam,0.00013223488268188294,0.00015028144557292604,162,69,93
11574,Slammed,1.9070323809907035e-05,1.9151826014460126e-05,22,11,11
11575,Slamming,4.400843956132392e-06,1.2250267090330355e-05,10,3,7
11576,Slant,6.496483935243052e-06,3.6233184351681345e-06,5,3,2
11577,Slap,2.326160376812834e-05,1.3975656821362803e-05,23,12,11
11578,Slapped,6.496483935243052e-06,5.348708166200577e-06,6,3,3
11579,Slash,1.9070323809907035e-05,1.052487735929791e-05,16,10,6
11580,Slashed,4.400843956132392e-06,7.074097897233022e-06,7,2,5
11581,Slashing,6.496483935243052e-06,1.7253897310324457e-07,4,3,1
11582,Slate,4.400843956132392e-06,5.348708166200577e-06,6,3,3
11583,Slaughter,1.9070323809907035e-05,1.9151826014460126e-05,21,9,12
11584,Slaughtered,1.278340387257504e-05,8.79948762826546e-06,13,7,6
11585,Slave,1.48790438516857e-05,2.9504164400654783e-05,26,9,17
11586,Slavery,2.5357243747239038e-05,2.6053384938589907e-05,32,15,17
11587,Slay,6.496483935243052e-06,1.8979287041356905e-06,6,5,1
11588,Sleep,2.5357243747239038e-05,3.640572332478458e-05,33,12,21
11589,Sleeping,1.278340387257504e-05,8.79948762826546e-06,12,6,6
11590,Sleepy,2.3052039770217305e-06,1.7253897310324457e-07,4,3,1
11591,Sleeve,2.3052039770217305e-06,3.6233184351681345e-06,3,1,2
11592,Slice,6.496483935243052e-06,1.8979287041356905e-06,4,3,1
11593,Slick,4.400843956132392e-06,1.8979287041356905e-06,3,2,1
11594,Slide,2.116596378901769e-05,8.79948762826546e-06,16,11,5
11595,Slightly,6.496483935243052e-06,1.052487735929791e-05,9,3,6
11596,Slim,1.48790438516857e-05,1.052487735929791e-05,14,8,6
11597,Slip,1.9070323809907035e-05,7.074097897233022e-06,13,9,4
11598,Slit,8.592123914353715e-06,1.7253897310324457e-07,4,4,0
11599,Sloot,2.3052039770217305e-06,1.8979287041356905e-06,3,1,2
11600,Slot,4.400843956132392e-06,1.8979287041356905e-06,3,2,1
11601,Slovak,2.3052039770217305e-06,3.6233184351681345e-06,4,1,3
11602,Slovakia,8.592123914353715e-06,3.6233184351681345e-06,8,4,4
11603,Slovakian,6.496483935243052e-06,1.7253897310324457e-07,3,3,0
11604,Slovenia,1.278340387257504e-05,5.348708166200577e-06,12,6,6
11605,Slovenian,2.3052039770217305e-06,1.8979287041356905e-06,3,1,2
11606,Slow,3.7931083621902995e-05,2.6053384938589907e-05,37,20,17
11607,Slowdown,4.400843956132392e-06,3.6233184351681345e-06,5,3,2
11608,Slowed,2.3052039770217305e-06,3.6233184351681345e-06,3,1,2
11609,Slowing,1.0687763893464371e-05,3.6233184351681345e-06,8,5,3
11610,Slowly,1.0687763893464371e-05,1.3975656821362803e-05,15,6,9
11611,Slug,2.095639979110664e-07,1.8979287041356905e-06,3,1,2
11612,Slum,8.592123914353715e-06,3.6233184351681345e-06,7,5,2
11613,Slumdog,8.592123914353715e-06,1.8979287041356905e-06,5,4,1
11614,Slump,4.400843956132392e-06,1.7253897310324457e-07,4,2,2
11615,Slur,4.400843956132392e-06,1.052487735929791e-05,9,2,7
11616,Smack,2.3052039770217305e-06,7.074097897233022e-06,6,1,5
11617,Small,7.984388320411623e-05,7.781507686956326e-05,90,42,48
11618,Smaller,8.592123914353715e-06,1.052487735929791e-05,10,4,6
11619,Smallest,2.3052039770217305e-06,3.6233184351681345e-06,5,2,3
11620,Smart,6.517440335034157e-05,5.5385010366141504e-05,68,34,34
11621,Smarter,4.400843956132392e-06,5.348708166200577e-06,6,2,4
11622,Smartphone,2.116596378901769e-05,1.570104655239525e-05,25,11,14
11623,Smash,1.48790438516857e-05,1.8979287041356905e-06,8,7,1
11624,Smashed,8.592123914353715e-06,1.7253897310324457e-07,4,4,0
11625,Smear,8.592123914353715e-06,1.2250267090330355e-05,14,6,8
11626,Smell,2.3052039770217305e-06,7.074097897233022e-06,5,1,4
11627,Smile,2.5357243747239038e-05,8.79948762826546e-06,21,15,6
11628,Smiley,2.095639979110664e-07,3.6233184351681345e-06,3,1,2
11629,Smith,4.840928351745632e-05,5.5385010366141504e-05,64,27,37
11630,Smithsonian,2.3052039770217305e-06,1.8979287041356905e-06,3,2,1
11631,Smog,6.496483935243052e-06,8.79948762826546e-06,8,3,5
11632,Smoke,1.9070323809907035e-05,8.79948762826546e-06,15,10,5
11633,Smoker,6.496483935243052e-06,7.074097897233022e-06,9,3,6
11634,Smoking,3.7931083621902995e-05,1.2250267090330355e-05,27,19,8
11635,Smuggling,8.592123914353715e-06,1.052487735929791e-05,11,4,7
11636,Snack,6.496483935243052e-06,7.074097897233022e-06,8,4,4
11637,Snag,8.592123914353715e-06,1.8979287041356905e-06,5,4,1
11638,Snake,8.592123914353715e-06,8.79948762826546e-06,11,5,6
11639,Snap,2.116596378901769e-05,1.052487735929791e-05,16,10,6
11640,Snapchat,2.5357243747239038e-05,2.2602605476525032e-05,28,14,14
11641,Snapshot,2.3052039770217305e-06,5.348708166200577e-06,4,1,3
11642,Sneak,2.3052039770217305e-06,1.052487735929791e-05,9,1,8
11643,Sniper,1.6974683830796368e-05,1.9151826014460126e-05,21,10,11
11644,Snitch,6.496483935243052e-06,5.348708166200577e-06,7,3,4
11645,Snoop,4.400843956132392e-06,7.074097897233022e-06,8,3,5
11646,Snooper,4.400843956132392e-06,1.8979287041356905e-06,3,2,1
11647,Snooping,4.400843956132392e-06,1.8979287041356905e-06,3,2,1
11648,Snow,1.9070323809907035e-05,2.087721574549256e-05,23,10,13
11649,Snowball,4.400843956132392e-06,3.6233184351681345e-06,4,2,2
11650,Snowden,0.0003941898800707157,0.00040391373603469537,473,204,269
11651,Snowflake,2.3052039770217305e-06,3.6233184351681345e-06,3,1,2
11652,Snub,8.592123914353715e-06,3.6233184351681345e-06,6,4,2
11653,Snubbed,2.095639979110664e-07,5.348708166200577e-06,3,0,3
11654,Snyder,2.7452883726349685e-05,2.2602605476525032e-05,29,16,13
11655,So,4.400843956132392e-06,1.052487735929791e-05,9,2,7
11656,SoCalled,8.592123914353715e-06,8.79948762826546e-06,9,4,5
11657,Soap,2.3052039770217305e-06,5.348708166200577e-06,4,1,3
11658,Soar,2.5357243747239038e-05,2.2602605476525032e-05,28,14,14
11659,Soaring,8.592123914353715e-06,5.348708166200577e-06,9,4,5
11660,Sobbing,4.400843956132392e-06,1.7253897310324457e-07,4,3,1
11661,Socalled,2.3052039770217305e-06,3.6233184351681345e-06,3,1,2
11662,Soccer,2.5357243747239038e-05,2.9504164400654783e-05,31,13,18
11663,Sochi,4.212236358012434e-05,2.2602605476525032e-05,41,23,18
11664,Social,0.0002097735619089774,0.00026588255755210003,286,113,173
11665,Socialism,6.496483935243052e-06,3.6233184351681345e-06,7,4,3
11666,Socialist,2.954852370546031e-05,1.9151826014460126e-05,27,14,13
11667,Society,5.4696203454788295e-05,4.6758061710979285e-05,54,27,27
11668,Soda,1.278340387257504e-05,1.052487735929791e-05,12,6,6
11669,Sodomy,2.3052039770217305e-06,3.6233184351681345e-06,3,1,2
11670,Sofia,2.3052039770217305e-06,3.6233184351681345e-06,3,1,2
11671,Soft,1.0687763893464371e-05,8.79948762826546e-06,10,5,5
11672,Softball,4.400843956132392e-06,3.6233184351681345e-06,5,3,2
11673,Soften,2.3052039770217305e-06,5.348708166200577e-06,4,1,3
11674,Software,1.48790438516857e-05,2.087721574549256e-05,21,9,12
11675,Soil,8.592123914353715e-06,3.6233184351681345e-06,7,5,2
11676,Sol,2.3052039770217305e-06,3.6233184351681345e-06,3,1,2
11677,Solar,8.403516316233764e-05,7.608968713853079e-05,92,42,50
11678,SolarCity,6.496483935243052e-06,3.6233184351681345e-06,5,3,2
11679,Sold,3.7931083621902995e-05,3.122955413168725e-05,40,21,19
11680,Soldier,0.00014061744259832545,0.00011749904068330962,155,74,81
11681,Sole,6.496483935243052e-06,5.348708166200577e-06,6,3,3
11682,Solf,4.400843956132392e-06,1.8979287041356905e-06,4,2,2
11683,Solicitor,8.592123914353715e-06,5.348708166200577e-06,7,4,3
11684,Solid,8.592123914353715e-06,7.074097897233022e-06,8,4,4
11685,Solidarity,2.5357243747239038e-05,1.742643628342769e-05,23,13,10
11686,Solitary,8.592123914353715e-06,1.742643628342769e-05,16,4,12
11687,Solo,4.400843956132392e-06,1.8979287041356905e-06,3,2,1
11688,Solomon,6.496483935243052e-06,7.074097897233022e-06,8,3,5
11689,Soltan,2.3052039770217305e-06,3.6233184351681345e-06,3,1,2
11690,Solution,5.6791843433898893e-05,5.3659620635109e-05,64,28,36
11691,Solve,2.5357243747239038e-05,1.052487735929791e-05,21,14,7
11692,Solved,8.592123914353715e-06,5.348708166200577e-06,9,5,4
11693,Solving,8.592123914353715e-06,1.2250267090330355e-05,14,6,8
11694,Soma,6.496483935243052e-06,5.348708166200577e-06,6,3,3
11695,Somali,9.660900303700153e-05,8.989280498679035e-05,112,53,59
11696,SomaliAmerican,4.400843956132392e-06,1.8979287041356905e-06,3,2,1
11697,Somalia,0.00013642616264010403,8.989280498679035e-05,132,72,60
11698,Somalian,1.0687763893464371e-05,3.6233184351681345e-06,7,5,2
11699,Somebody,1.278340387257504e-05,8.79948762826546e-06,11,6,5
11700,Somehow,1.6974683830796368e-05,1.3975656821362803e-05,19,9,10
11701,Someone,6.098312339212028e-05,6.228656929027126e-05,73,29,44
11702,Something,8.613080314144832e-05,0.00010887209202814718,118,46,72
11703,Sometime,6.517440335034157e-05,3.8131113055817005e-05,58,33,25
11704,Somewhere,4.400843956132392e-06,3.6233184351681345e-06,4,2,2
11705,Son,0.00010080028299522283,0.0001019705331040174,117,53,64
11706,SonInLaw,4.400843956132392e-06,1.2250267090330355e-05,10,3,7
11707,Song,1.6974683830796368e-05,2.6053384938589907e-05,29,8,21
11708,Songbird,2.3052039770217305e-06,3.6233184351681345e-06,3,1,2
11709,Sonia,1.0687763893464371e-05,1.052487735929791e-05,12,6,6
11710,Sonny,2.3052039770217305e-06,7.074097897233022e-06,6,1,5
11711,Sony,3.3739803663681634e-05,2.777877466962238e-05,38,19,19
11712,Soon,6.517440335034157e-05,7.954046660059569e-05,88,38,50
11713,Sooner,4.400843956132392e-06,1.2250267090330355e-05,10,2,8
11714,Sophie,4.400843956132392e-06,5.348708166200577e-06,6,3,3
11715,Sophisticated,8.592123914353715e-06,3.6233184351681345e-06,6,4,2
11716,Sorcery,2.3052039770217305e-06,3.6233184351681345e-06,3,1,2
11717,Sore,4.400843956132392e-06,5.348708166200577e-06,5,2,3
11718,Soro,8.592123914353715e-06,8.79948762826546e-06,14,7,7
11719,Sorrow,2.095639979110664e-07,5.348708166200577e-06,3,0,3
11720,Sorry,6.307876337123095e-05,5.3659620635109e-05,70,34,36
11721,Sort,1.6974683830796368e-05,7.074097897233022e-06,13,9,4
11722,Sotloff,4.400843956132392e-06,3.6233184351681345e-06,4,2,2
11723,Sotomayor,1.278340387257504e-05,1.052487735929791e-05,13,7,6
11724,Sought,1.0687763893464371e-05,3.6233184351681345e-06,9,7,2
11725,Soul,1.48790438516857e-05,1.570104655239525e-05,18,7,11
11726,Sound,5.4696203454788295e-05,4.1581892517881935e-05,57,29,28
11727,Sounded,2.3052039770217305e-06,1.8979287041356905e-06,3,2,1
11728,Sounding,4.400843956132392e-06,5.348708166200577e-06,5,2,3
11729,Soup,4.400843956132392e-06,1.8979287041356905e-06,6,3,3
11730,Sour,2.3052039770217305e-06,3.6233184351681345e-06,3,1,2
11731,Source,7.774824322500554e-05,5.1934230904076595e-05,70,37,33
11732,South,0.0010438382735950213,0.0008628674044893257,1097,535,562
11733,Southeast,1.278340387257504e-05,1.3975656821362803e-05,20,9,11
11734,Southern,4.4218003559234974e-05,6.918812821440096e-05,72,27,45
11735,Southwest,6.496483935243052e-06,1.2250267090330355e-05,13,6,7
11736,Souza,4.400843956132392e-06,1.8979287041356905e-06,5,3,2
11737,Sovereignty,1.278340387257504e-05,3.6233184351681345e-06,9,6,3
11738,Soviet,8.822644312055891e-05,8.989280498679035e-05,105,47,58
11739,Sovietera,1.0687763893464371e-05,8.79948762826546e-06,11,5,6
11740,Sow,2.3052039770217305e-06,5.348708166200577e-06,4,1,3
11741,Sox,4.400843956132392e-06,1.7253897310324457e-07,3,2,1
11742,Soyuz,4.400843956132392e-06,3.6233184351681345e-06,4,2,2
11743,Spa,6.496483935243052e-06,3.6233184351681345e-06,5,3,2
11744,Space,0.00015738256243121094,0.00012094982014537423,161,83,78
11745,SpaceX,3.7931083621902995e-05,3.122955413168725e-05,38,18,20
11746,Spacecraft,1.6974683830796368e-05,1.742643628342769e-05,20,8,12
11747,Spacewalk,4.400843956132392e-06,5.348708166200577e-06,5,2,3
11748,Spaghetti,8.592123914353715e-06,5.348708166200577e-06,8,4,4
11749,Spain,0.00029150352109429334,0.0002313747629314509,300,147,153
11750,Spam,4.400843956132392e-06,8.79948762826546e-06,7,2,5
11751,Spaniard,1.9070323809907035e-05,1.570104655239525e-05,20,11,9
11752,Spanish,0.0001385218026192147,0.00016063378395912072,183,74,109
11753,SpanishLanguage,8.592123914353715e-06,1.8979287041356905e-06,5,4,1
11754,Spar,4.400843956132392e-06,1.8979287041356905e-06,3,2,1
11755,Spare,8.592123914353715e-06,3.6233184351681345e-06,10,6,4
11756,Spared,2.3052039770217305e-06,1.7253897310324457e-07,3,1,2
11757,Spark,3.3739803663681634e-05,2.9504164400654783e-05,34,17,17
11758,Sparked,4.400843956132392e-06,1.8979287041356905e-06,5,3,2
11759,Sparking,4.400843956132392e-06,1.8979287041356905e-06,4,2,2
11760,Spawned,2.3052039770217305e-06,1.8979287041356905e-06,3,1,2
11761,Speak,7.355696326678427e-05,9.506897417988779e-05,93,36,57
11762,Speaker,0.00011966104280721883,0.0001036959228350498,130,61,69
11763,Speaking,4.4218003559234974e-05,3.640572332478458e-05,43,21,22
11764,Spear,1.0687763893464371e-05,5.348708166200577e-06,8,5,3
11765,Special,0.00016157384238943198,0.00014510527637982858,185,90,95
11766,Specialist,4.400843956132392e-06,3.6233184351681345e-06,4,2,2
11767,Species,2.7452883726349685e-05,2.2602605476525032e-05,31,14,17
11768,Specific,1.0687763893464371e-05,3.6233184351681345e-06,7,5,2
11769,Specifically,2.3052039770217305e-06,1.8979287041356905e-06,3,2,1
11770,Spectacle,2.3052039770217305e-06,3.6233184351681345e-06,3,1,2
11771,Spectacular,4.400843956132392e-06,1.052487735929791e-05,10,3,7
11772,Spectacularly,8.592123914353715e-06,1.8979287041356905e-06,7,4,3
11773,Specter,4.400843956132392e-06,1.7253897310324457e-07,3,2,1
11774,Speculation,6.496483935243052e-06,1.570104655239525e-05,12,3,9
11775,Speech,0.00025797328142852257,0.00016753534288325053,242,131,111
11776,Speechles,2.3052039770217305e-06,3.6233184351681345e-06,3,1,2
11777,Speed,1.6974683830796368e-05,2.4327995207557487e-05,26,8,18
11778,Speeding,4.400843956132392e-06,1.8979287041356905e-06,4,2,2
11779,Speier,6.496483935243052e-06,5.348708166200577e-06,6,3,3
11780,Spell,2.326160376812834e-05,1.2250267090330355e-05,19,12,7
11781,Spelling,6.496483935243052e-06,3.6233184351681345e-06,5,3,2
11782,Spencer,1.0687763893464371e-05,1.570104655239525e-05,20,7,13
11783,Spend,4.840928351745632e-05,7.091351794543343e-05,68,25,43
11784,Spending,0.00013013924270277222,0.00013130215853156914,152,73,79
11785,Spent,4.212236358012434e-05,2.6053384938589907e-05,42,23,19
11786,Sperm,6.496483935243052e-06,5.348708166200577e-06,9,5,4
11787,Spew,6.496483935243052e-06,3.6233184351681345e-06,5,3,2
11788,Spice,2.3052039770217305e-06,3.6233184351681345e-06,4,2,2
11789,Spicer,0.00010499156295344414,6.056117955923882e-05,91,51,40
11790,Spider,6.496483935243052e-06,3.6233184351681345e-06,5,3,2
11791,Spied,8.592123914353715e-06,8.79948762826546e-06,12,5,7
11792,Spiegel,8.592123914353715e-06,5.348708166200577e-06,7,4,3
11793,Spike,2.116596378901769e-05,1.9151826014460126e-05,23,11,12
11794,Spill,5.050492349656699e-05,2.2602605476525032e-05,45,29,16
11795,Spin,1.278340387257504e-05,2.087721574549256e-05,21,7,14
11796,Spine,2.095639979110664e-07,7.074097897233022e-06,4,0,4
11797,Spinning,2.3052039770217305e-06,1.8979287041356905e-06,3,2,1
11798,Spiral,4.400843956132392e-06,7.074097897233022e-06,8,2,6
11799,Spirit,1.48790438516857e-05,2.4327995207557487e-05,22,7,15
11800,Spit,4.400843956132392e-06,7.074097897233022e-06,6,2,4
11801,Spitfire,2.3052039770217305e-06,3.6233184351681345e-06,3,1,2
11802,Split,2.326160376812834e-05,2.9504164400654783e-05,29,12,17
11803,Splitting,2.3052039770217305e-06,7.074097897233022e-06,5,1,4
11804,Spoil,6.496483935243052e-06,5.348708166200577e-06,6,3,3
11805,Spoiler,1.0687763893464371e-05,1.3975656821362803e-05,13,5,8
11806,Spoke,1.0687763893464371e-05,1.2250267090330355e-05,12,5,7
11807,Spoken,4.400843956132392e-06,3.6233184351681345e-06,5,2,3
11808,Spokesman,1.0687763893464371e-05,1.9151826014460126e-05,19,6,13
11809,Spokesperson,6.496483935243052e-06,1.7253897310324457e-07,3,3,0
11810,Spokeswoman,1.0687763893464371e-05,7.074097897233022e-06,9,5,4
11811,Sponsor,1.48790438516857e-05,3.6233184351681345e-06,9,7,2
11812,Spoof,2.095639979110664e-07,5.348708166200577e-06,3,0,3
11813,Spooky,2.3052039770217305e-06,5.348708166200577e-06,4,1,3
11814,Sport,4.6313643538345614e-05,3.985650278684949e-05,51,24,27
11815,Spot,4.4218003559234974e-05,4.6758061710979285e-05,53,25,28
11816,Spotify,6.496483935243052e-06,1.052487735929791e-05,12,5,7
11817,Spotlight,2.116596378901769e-05,7.074097897233022e-06,18,13,5
11818,Spotted,6.496483935243052e-06,1.8979287041356905e-06,4,3,1
11819,Spouse,6.496483935243052e-06,1.2250267090330355e-05,10,3,7
11820,Spray,8.592123914353715e-06,1.052487735929791e-05,10,4,6
11821,Spread,5.260056347567764e-05,5.020884117304414e-05,59,26,33
11822,Spreading,1.0687763893464371e-05,2.087721574549256e-05,19,7,12
11823,Spree,4.400843956132392e-06,7.074097897233022e-06,8,2,6
11824,Spring,2.954852370546031e-05,3.8131113055817005e-05,41,18,23
11825,Springsteen,4.400843956132392e-06,7.074097897233022e-06,6,2,4
11826,Sprint,4.400843956132392e-06,3.6233184351681345e-06,4,2,2
11827,Spur,8.592123914353715e-06,2.087721574549256e-05,17,5,12
11828,Spurred,6.496483935243052e-06,1.8979287041356905e-06,4,3,1
11829,Spy,6.936568330856297e-05,7.954046660059569e-05,89,37,52
11830,Spying,3.7931083621902995e-05,3.985650278684949e-05,48,20,28
11831,Spyware,2.095639979110664e-07,3.6233184351681345e-06,3,0,3
11832,Squad,1.48790438516857e-05,1.742643628342769e-05,20,10,10
11833,Square,0.00010289592297433347,0.00011059748175917965,125,54,71
11834,Squatter,4.400843956132392e-06,3.6233184351681345e-06,4,2,2
11835,Squeeze,2.3052039770217305e-06,7.074097897233022e-06,5,1,4
11836,Squid,2.3052039770217305e-06,1.8979287041356905e-06,3,2,1
11837,Sr,6.496483935243052e-06,1.7253897310324457e-07,3,3,0
11838,Srebrenica,8.592123914353715e-06,8.79948762826546e-06,10,4,6
11839,Sri,9.660900303700153e-05,9.851975364195259e-05,128,61,67
11840,St,7.565260324589493e-05,9.851975364195259e-05,110,43,67
11841,Stab,2.095639979110664e-07,5.348708166200577e-06,4,1,3
11842,Stabbed,2.3052039770217305e-06,8.79948762826546e-06,6,1,5
11843,Stabbing,2.095639979110664e-07,1.2250267090330355e-05,9,2,7
11844,Stability,6.496483935243052e-06,5.348708166200577e-06,7,4,3
11845,Stable,4.400843956132392e-06,8.79948762826546e-06,8,2,6
11846,Stacey,4.400843956132392e-06,1.3975656821362803e-05,13,3,10
11847,Stadium,1.278340387257504e-05,3.6233184351681345e-06,11,6,5
11848,Staff,7.146132328767358e-05,0.00011577365095227703,109,38,71
11849,Staffer,4.002672360101368e-05,3.468033359375216e-05,47,22,25
11850,Stage,5.888748341300963e-05,2.087721574549256e-05,46,31,15
11851,Staged,6.496483935243052e-06,1.8979287041356905e-06,4,3,1
11852,Staggering,8.592123914353715e-06,8.79948762826546e-06,10,4,6
11853,Stain,6.496483935243052e-06,3.6233184351681345e-06,5,3,2
11854,Stair,6.496483935243052e-06,1.8979287041356905e-06,4,3,1
11855,Stake,2.954852370546031e-05,2.2602605476525032e-05,31,15,16
11856,Stalin,3.1644163684570994e-05,1.9151826014460126e-05,27,16,11
11857,Stall,1.278340387257504e-05,1.3975656821362803e-05,16,7,9
11858,Stalled,8.592123914353715e-06,5.348708166200577e-06,9,5,4
11859,Stalling,2.095639979110664e-07,5.348708166200577e-06,4,0,4
11860,Stamp,4.212236358012434e-05,3.2954943862719716e-05,46,25,21
11861,Stampede,2.3052039770217305e-06,5.348708166200577e-06,4,1,3
11862,Stan,2.095639979110664e-07,5.348708166200577e-06,4,0,4
11863,Stance,3.3739803663681634e-05,2.4327995207557487e-05,33,17,16
11864,Stand,0.00013642616264010403,0.00012267520987640663,157,74,83
11865,Standard,4.212236358012434e-05,5.5385010366141504e-05,63,25,38
11866,Standardized,6.496483935243052e-06,1.8979287041356905e-06,4,3,1
11867,Standing,4.840928351745632e-05,2.9504164400654783e-05,47,24,23
11868,Standoff,8.592123914353715e-06,8.79948762826546e-06,9,4,5
11869,Standstill,2.095639979110664e-07,3.6233184351681345e-06,3,1,2
11870,Stanford,1.6974683830796368e-05,7.074097897233022e-06,13,9,4
11871,Stanley,1.278340387257504e-05,1.3975656821362803e-05,15,7,8
11872,Staple,2.3052039770217305e-06,3.6233184351681345e-06,5,1,4
11873,Star,0.00011966104280721883,0.00012267520987640663,144,60,84
11874,Starbuck,4.6313643538345614e-05,5.020884117304414e-05,56,23,33
11875,Stare,2.095639979110664e-07,3.6233184351681345e-06,3,0,3
11876,Stark,1.0687763893464371e-05,7.074097897233022e-06,10,5,5
11877,Start,0.00011127848289077625,0.0001554576147660233,162,62,100
11878,Started,3.583544364279237e-05,2.9504164400654783e-05,40,19,21
11879,Starter,2.095639979110664e-07,5.348708166200577e-06,3,0,3
11880,Starting,4.212236358012434e-05,4.1581892517881935e-05,48,21,27
11881,Startup,3.1644163684570994e-05,2.777877466962238e-05,39,20,19
11882,Starving,1.48790438516857e-05,1.3975656821362803e-05,18,7,11
11883,Starwood,4.400843956132392e-06,3.6233184351681345e-06,4,2,2
11884,Stasi,1.278340387257504e-05,1.052487735929791e-05,12,6,6
11885,Stat,4.400843956132392e-06,5.348708166200577e-06,5,2,3
11886,State,0.001794077386116638,0.0018083809770951045,2154,957,1197
11887,Statehood,8.592123914353715e-06,1.3975656821362803e-05,12,4,8
11888,Statehouse,8.592123914353715e-06,1.2250267090330355e-05,11,4,7
11889,Stateline,1.6974683830796368e-05,8.79948762826546e-06,16,10,6
11890,Statement,3.3739803663681634e-05,4.1581892517881935e-05,43,18,25
11891,States,4.400843956132392e-06,1.742643628342769e-05,12,2,10
11892,Statesman,4.400843956132392e-06,3.6233184351681345e-06,4,2,2
11893,Station,5.6791843433898893e-05,4.8483451442011706e-05,67,33,34
11894,Statistic,6.496483935243052e-06,1.570104655239525e-05,13,3,10
11895,Statoil,4.400843956132392e-06,3.6233184351681345e-06,4,2,2
11896,Statue,2.116596378901769e-05,3.8131113055817005e-05,38,13,25
11897,Status,1.9070323809907035e-05,2.777877466962238e-05,27,10,17
11898,Statute,2.3052039770217305e-06,3.6233184351681345e-06,4,2,2
11899,Stay,8.403516316233764e-05,8.816741525575797e-05,108,47,61
11900,Stayed,2.3052039770217305e-06,7.074097897233022e-06,6,2,4
11901,Staying,6.496483935243052e-06,1.3975656821362803e-05,11,3,8
11902,Steady,2.095639979110664e-07,5.348708166200577e-06,5,2,3
11903,Steal,3.583544364279237e-05,1.570104655239525e-05,29,18,11
11904,Stealing,1.278340387257504e-05,1.2250267090330355e-05,13,6,7
11905,Stealth,6.496483935243052e-06,1.2250267090330355e-05,12,4,8
11906,Steam,4.400843956132392e-06,1.052487735929791e-05,8,2,6
11907,Steel,1.48790438516857e-05,8.79948762826546e-06,14,7,7
11908,Steele,8.592123914353715e-06,5.348708166200577e-06,8,5,3
11909,Steelworker,2.095639979110664e-07,8.79948762826546e-06,5,0,5
11910,Steep,2.3052039770217305e-06,1.7253897310324457e-07,3,3,0
11911,Stefan,2.3052039770217305e-06,3.6233184351681345e-06,3,1,2
11912,Stein,1.9070323809907035e-05,2.2602605476525032e-05,26,10,16
11913,Stella,2.3052039770217305e-06,5.348708166200577e-06,4,1,3
11914,Stellar,6.496483935243052e-06,1.7253897310324457e-07,3,3,0
11915,Stem,1.48790438516857e-05,1.570104655239525e-05,20,9,11
11916,Steny,2.3052039770217305e-06,3.6233184351681345e-06,3,1,2
11917,Step,0.00016366948236854273,0.00016926073261428268,195,88,107
11918,Steph,2.095639979110664e-07,3.6233184351681345e-06,3,0,3
11919,Stephanie,1.0687763893464371e-05,8.79948762826546e-06,10,5,5
11920,Stephen,0.00011337412286988677,0.00010714670229711469,130,57,73
11921,Stepped,2.3052039770217305e-06,3.6233184351681345e-06,6,2,4
11922,Stepping,1.48790438516857e-05,1.2250267090330355e-05,16,7,9
11923,Stereotype,4.400843956132392e-06,1.2250267090330355e-05,12,2,10
11924,Sterling,8.592123914353715e-06,2.4327995207557487e-05,21,6,15
11925,Stern,2.3052039770217305e-06,1.052487735929791e-05,8,1,7
11926,Steroid,4.400843956132392e-06,3.6233184351681345e-06,4,2,2
11927,Steve,0.00013642616264010403,0.0002089446964280291,210,74,136
11928,Steven,3.583544364279237e-05,4.1581892517881935e-05,50,23,27
11929,Stewart,3.583544364279237e-05,3.122955413168725e-05,36,18,18
11930,Steyer,6.496483935243052e-06,1.570104655239525e-05,12,3,9
11931,Stick,2.5357243747239038e-05,1.9151826014460126e-05,26,13,13
11932,Sticker,4.400843956132392e-06,7.074097897233022e-06,7,3,4
11933,Sticking,6.496483935243052e-06,8.79948762826546e-06,8,3,5
11934,Sticky,4.400843956132392e-06,1.8979287041356905e-06,4,3,1
11935,Stiffed,4.400843956132392e-06,1.8979287041356905e-06,3,2,1
11936,Stigma,6.496483935243052e-06,3.6233184351681345e-06,5,3,2
11937,Still,0.0004235288397782649,0.00042634380253811694,495,222,273
11938,Stimulu,8.592123914353715e-06,8.79948762826546e-06,9,4,5
11939,Sting,1.6974683830796368e-05,1.052487735929791e-05,14,8,6
11940,Stinging,2.3052039770217305e-06,7.074097897233022e-06,5,1,4
11941,Stingray,2.095639979110664e-07,7.074097897233022e-06,4,0,4
11942,Stinkin,4.400843956132392e-06,1.8979287041356905e-06,3,2,1
11943,Stir,8.592123914353715e-06,5.348708166200577e-06,8,4,4
11944,Stirring,4.400843956132392e-06,7.074097897233022e-06,6,2,4
11945,Stock,0.00012385232276544028,0.00011404826122124471,142,70,72
11946,Stockholm,2.5357243747239038e-05,2.6053384938589907e-05,29,12,17
11947,Stockpile,6.496483935243052e-06,3.6233184351681345e-06,5,3,2
11948,Stoke,6.496483935243052e-06,1.570104655239525e-05,12,3,9
11949,Stoking,4.400843956132392e-06,5.348708166200577e-06,5,2,3
11950,Stole,1.278340387257504e-05,1.570104655239525e-05,16,6,10
11951,Stolen,2.326160376812834e-05,2.9504164400654783e-05,33,16,17
11952,Stoltenberg,6.496483935243052e-06,1.8979287041356905e-06,4,3,1
11953,Stomach,2.3052039770217305e-06,3.6233184351681345e-06,3,1,2
11954,Stomping,4.400843956132392e-06,1.8979287041356905e-06,3,2,1
11955,Stone,4.002672360101368e-05,4.1581892517881935e-05,46,19,27
11956,Stoned,4.400843956132392e-06,7.074097897233022e-06,7,3,4
11957,Stonehenge,1.278340387257504e-05,1.052487735929791e-05,13,7,6
11958,Stoneman,1.0687763893464371e-05,8.79948762826546e-06,11,5,6
11959,Stoner,6.496483935243052e-06,5.348708166200577e-06,6,3,3
11960,Stonewall,4.400843956132392e-06,1.052487735929791e-05,8,2,6
11961,Stonewalling,2.095639979110664e-07,3.6233184351681345e-06,3,0,3
11962,Stood,4.400843956132392e-06,1.2250267090330355e-05,9,2,7
11963,Stooge,2.095639979110664e-07,5.348708166200577e-06,3,0,3
11964,Stop,0.0003229381207809529,0.0003901106181864356,432,168,264
11965,StopAndFrisk,8.592123914353715e-06,3.6233184351681345e-06,6,4,2
11966,Stopgap,2.3052039770217305e-06,3.6233184351681345e-06,3,1,2
11967,Stopped,1.6974683830796368e-05,2.087721574549256e-05,22,10,12
11968,Stopping,1.6974683830796368e-05,3.6233184351681345e-06,12,8,4
11969,Storage,6.496483935243052e-06,1.8979287041356905e-06,5,4,1
11970,Store,5.6791843433898893e-05,8.989280498679035e-05,83,28,55
11971,Stored,6.496483935243052e-06,3.6233184351681345e-06,5,3,2
11972,Storm,5.888748341300963e-05,5.883578982820635e-05,74,38,36
11973,Stormer,2.095639979110664e-07,5.348708166200577e-06,3,0,3
11974,Stormfront,2.3052039770217305e-06,3.6233184351681345e-06,4,1,3
11975,Stormy,5.050492349656699e-05,5.020884117304414e-05,55,25,30
11976,Story,0.00015947820241032126,0.00017443690180738014,196,86,110
11977,Storytelling,6.496483935243052e-06,5.348708166200577e-06,6,3,3
11978,Stradivariu,6.496483935243052e-06,1.8979287041356905e-06,4,3,1
11979,Straight,3.1644163684570994e-05,2.777877466962238e-05,35,16,19
11980,Strain,8.592123914353715e-06,7.074097897233022e-06,8,4,4
11981,Strait,2.5357243747239038e-05,7.074097897233022e-06,17,13,4
11982,Stranded,1.6974683830796368e-05,5.348708166200577e-06,14,8,6
11983,Strange,2.954852370546031e-05,2.9504164400654783e-05,34,15,19
11984,Strangely,2.3052039770217305e-06,7.074097897233022e-06,5,1,4
11985,Stranger,3.583544364279237e-05,3.122955413168725e-05,40,19,21
11986,Strap,2.3052039770217305e-06,1.8979287041356905e-06,3,1,2
11987,Strasbourg,4.400843956132392e-06,1.8979287041356905e-06,3,2,1
11988,Strategic,1.48790438516857e-05,1.2250267090330355e-05,17,9,8
11989,Strategist,1.48790438516857e-05,1.3975656821362803e-05,17,7,10
11990,Strategy,8.613080314144832e-05,9.161819471782287e-05,106,46,60
11991,Stratfor,8.592123914353715e-06,5.348708166200577e-06,10,5,5
11992,StraussKahn,6.496483935243052e-06,1.742643628342769e-05,13,3,10
11993,Straw,1.0687763893464371e-05,1.052487735929791e-05,13,6,7
11994,Stray,6.496483935243052e-06,7.074097897233022e-06,7,3,4
11995,Streak,4.400843956132392e-06,5.348708166200577e-06,7,2,5
11996,Stream,1.278340387257504e-05,3.6233184351681345e-06,9,6,3
11997,Streaming,1.278340387257504e-05,1.052487735929791e-05,12,6,6
11998,Street,0.00028731224113607147,0.0003141934700210085,356,161,195
11999,Strength,1.278340387257504e-05,8.79948762826546e-06,12,6,6
12000,Strengthen,1.48790438516857e-05,1.2250267090330355e-05,15,8,7
12001,Strengthening,2.095639979110664e-07,5.348708166200577e-06,3,0,3
12002,Stres,1.9070323809907035e-05,1.3975656821362803e-05,18,10,8
12003,Stress,2.3052039770217305e-06,5.348708166200577e-06,5,2,3
12004,Stressed,4.400843956132392e-06,3.6233184351681345e-06,4,2,2
12005,Stretch,6.496483935243052e-06,7.074097897233022e-06,8,3,5
12006,Stricken,2.3052039770217305e-06,7.074097897233022e-06,5,1,4
12007,Strickland,2.095639979110664e-07,7.074097897233022e-06,6,0,6
12008,Strict,4.400843956132392e-06,7.074097897233022e-06,6,2,4
12009,Stricter,1.0687763893464371e-05,3.6233184351681345e-06,8,6,2
12010,Strictest,4.400843956132392e-06,5.348708166200577e-06,6,2,4
12011,Strike,0.00018462588215964923,0.0001847892401935746,220,100,120
12012,Striker,4.400843956132392e-06,1.8979287041356905e-06,3,2,1
12013,Striking,1.6974683830796368e-05,1.2250267090330355e-05,21,10,11
12014,String,2.095639979110664e-07,7.074097897233022e-06,4,0,4
12015,Strip,8.403516316233764e-05,6.573734875233614e-05,83,41,42
12016,Stripped,4.400843956132392e-06,5.348708166200577e-06,5,2,3
12017,Stroke,1.278340387257504e-05,5.348708166200577e-06,9,6,3
12018,Stroll,2.3052039770217305e-06,5.348708166200577e-06,4,1,3
12019,Strong,6.936568330856297e-05,4.1581892517881935e-05,62,34,28
12020,Stronger,2.116596378901769e-05,1.3975656821362803e-05,19,10,9
12021,Strongest,6.496483935243052e-06,1.052487735929791e-05,9,3,6
12022,Stronghold,2.095639979110664e-07,3.6233184351681345e-06,4,1,3
12023,Strongly,1.278340387257504e-05,1.8979287041356905e-06,9,7,2
12024,Struck,1.278340387257504e-05,8.79948762826546e-06,13,7,6
12025,Struggle,3.7931083621902995e-05,6.401195902130366e-05,59,21,38
12026,Struggling,3.1644163684570994e-05,2.6053384938589907e-05,36,16,20
12027,Stuart,2.095639979110664e-07,7.074097897233022e-06,5,0,5
12028,Stuck,1.6974683830796368e-05,1.570104655239525e-05,18,9,9
12029,Student,0.00040466807996626886,0.00035215204410372187,441,215,226
12030,Studio,4.400843956132392e-06,5.348708166200577e-06,5,2,3
12031,Study,0.0001783389622223174,0.00018133846073150993,221,105,116
12032,Studying,8.592123914353715e-06,3.6233184351681345e-06,7,4,3
12033,Stuff,2.7452883726349685e-05,1.742643628342769e-05,27,16,11
12034,Stumble,2.3052039770217305e-06,3.6233184351681345e-06,3,1,2
12035,Stump,2.3052039770217305e-06,1.8979287041356905e-06,3,1,2
12036,Stumpf,4.400843956132392e-06,3.6233184351681345e-06,4,2,2
12037,Stun,4.400843956132392e-06,1.052487735929791e-05,9,2,7
12038,Stung,2.3052039770217305e-06,1.8979287041356905e-06,3,2,1
12039,Stunned,4.400843956132392e-06,1.052487735929791e-05,11,3,8
12040,Stunning,3.583544364279237e-05,2.2602605476525032e-05,34,20,14
12041,Stunt,6.496483935243052e-06,1.052487735929791e-05,10,4,6
12042,Stupid,1.9070323809907035e-05,2.777877466962238e-05,27,10,17
12043,Stupidest,4.400843956132392e-06,1.8979287041356905e-06,3,2,1
12044,Stupidity,4.400843956132392e-06,3.6233184351681345e-06,4,2,2
12045,Sturgeon,4.400843956132392e-06,5.348708166200577e-06,5,2,3
12046,Stuxnet,1.6974683830796368e-05,7.074097897233022e-06,12,8,4
12047,Style,2.116596378901769e-05,1.3975656821362803e-05,20,11,9
12048,Styrofoam,6.496483935243052e-06,1.8979287041356905e-06,4,3,1
12049,Su24,4.400843956132392e-06,1.8979287041356905e-06,3,2,1
12050,Sub,2.3052039770217305e-06,7.074097897233022e-06,5,1,4
12051,Subcommittee,4.400843956132392e-06,3.6233184351681345e-06,4,2,2
12052,Subject,1.0687763893464371e-05,1.570104655239525e-05,14,5,9
12053,Submarine,1.48790438516857e-05,8.79948762826546e-06,13,8,5
12054,Submit,4.400843956132392e-06,1.052487735929791e-05,10,2,8
12055,Subpoena,3.1644163684570994e-05,3.122955413168725e-05,34,15,19
12056,Subpoenaed,6.496483935243052e-06,1.8979287041356905e-06,4,3,1
12057,Subprime,2.3052039770217305e-06,1.8979287041356905e-06,3,2,1
12058,Subscribe,4.400843956132392e-06,7.074097897233022e-06,6,2,4
12059,Subscriber,2.3052039770217305e-06,5.348708166200577e-06,4,1,3
12060,Subsidiary,2.095639979110664e-07,5.348708166200577e-06,4,1,3
12061,Subsidy,1.48790438516857e-05,1.2250267090330355e-05,15,7,8
12062,Substance,1.278340387257504e-05,7.074097897233022e-06,10,6,4
12063,Substantial,8.592123914353715e-06,1.8979287041356905e-06,5,4,1
12064,Subtle,1.0687763893464371e-05,3.6233184351681345e-06,7,5,2
12065,Suburb,8.592123914353715e-06,5.348708166200577e-06,7,4,3
12066,Suburban,4.400843956132392e-06,3.6233184351681345e-06,4,2,2
12067,Subway,2.5357243747239038e-05,1.9151826014460126e-05,25,13,12
12068,Succeed,1.278340387257504e-05,1.052487735929791e-05,12,6,6
12069,Succes,5.6791843433898893e-05,8.126585633162811e-05,85,31,54
12070,Successful,2.7452883726349685e-05,2.9504164400654783e-05,31,14,17
12071,Successfully,1.0687763893464371e-05,7.074097897233022e-06,9,5,4
12072,Successor,2.095639979110664e-07,1.3975656821362803e-05,8,0,8
12073,Suck,1.48790438516857e-05,1.052487735929791e-05,14,7,7
12074,Sucker,6.496483935243052e-06,1.8979287041356905e-06,5,3,2
12075,Sudan,0.00010499156295344414,0.00014683066611086105,151,58,93
12076,Sudanese,4.212236358012434e-05,2.087721574549256e-05,36,22,14
12077,Sudden,2.3052039770217305e-06,1.052487735929791e-05,8,1,7
12078,Suddenly,2.116596378901769e-05,2.777877466962238e-05,29,10,19
12079,Sue,0.0001531912824729893,0.00015028144557292604,182,81,101
12080,Sued,4.002672360101368e-05,3.985650278684949e-05,46,20,26
12081,Suez,8.592123914353715e-06,1.2250267090330355e-05,12,4,8
12082,Suffer,2.326160376812834e-05,3.8131113055817005e-05,34,11,23
12083,Suffered,4.400843956132392e-06,1.2250267090330355e-05,9,2,7
12084,Suffering,1.48790438516857e-05,7.074097897233022e-06,11,7,4
12085,Sufi,1.278340387257504e-05,7.074097897233022e-06,11,6,5
12086,Sugar,6.496483935243052e-06,7.074097897233022e-06,9,5,4
12087,Suggest,9.03220830996695e-05,0.0001019705331040174,116,47,69
12088,Suggested,8.592123914353715e-06,1.2250267090330355e-05,11,4,7
12089,Suggesting,6.496483935243052e-06,1.052487735929791e-05,9,3,6
12090,Suggestion,8.592123914353715e-06,1.3975656821362803e-05,13,5,8
12091,Sui,4.400843956132392e-06,3.6233184351681345e-06,4,2,2
12092,Suicide,0.00010289592297433347,0.00011749904068330962,129,51,78
12093,Suing,2.5357243747239038e-05,2.6053384938589907e-05,33,15,18
12094,Suisse,6.496483935243052e-06,1.052487735929791e-05,10,3,7
12095,Suit,4.002672360101368e-05,4.6758061710979285e-05,50,22,28
12096,Suitcase,6.496483935243052e-06,3.6233184351681345e-06,5,3,2
12097,Sukhoi,4.400843956132392e-06,1.8979287041356905e-06,3,2,1
12098,Suleiman,4.400843956132392e-06,1.2250267090330355e-05,11,3,8
12099,Sullivan,4.400843956132392e-06,7.074097897233022e-06,7,2,5
12100,Sully,2.3052039770217305e-06,3.6233184351681345e-06,3,1,2
12101,Sultan,8.592123914353715e-06,5.348708166200577e-06,8,4,4
12102,Sum,1.0687763893464371e-05,1.2250267090330355e-05,12,5,7
12103,Sumatra,8.592123914353715e-06,7.074097897233022e-06,8,4,4
12104,Sumatran,1.0687763893464371e-05,1.8979287041356905e-06,7,5,2
12105,Summary,2.3052039770217305e-06,3.6233184351681345e-06,3,1,2
12106,Summer,6.307876337123095e-05,5.5385010366141504e-05,69,34,35
12107,Summertime,2.3052039770217305e-06,3.6233184351681345e-06,4,2,2
12108,Summit,5.050492349656699e-05,5.711040009717395e-05,62,27,35
12109,Sun,3.3739803663681634e-05,2.6053384938589907e-05,37,19,18
12110,Sundarban,2.3052039770217305e-06,3.6233184351681345e-06,3,1,2
12111,Sunday,0.0002181561218254202,0.0002175716450831913,255,116,139
12112,Sunde,8.592123914353715e-06,3.6233184351681345e-06,6,4,2
12113,Sunk,2.3052039770217305e-06,5.348708166200577e-06,5,2,3
12114,Sunni,2.954852370546031e-05,3.2954943862719716e-05,39,15,24
12115,SunniShiite,4.400843956132392e-06,1.7253897310324457e-07,3,2,1
12116,Sunny,4.400843956132392e-06,1.8979287041356905e-06,5,4,1
12117,Sunrise,2.3052039770217305e-06,3.6233184351681345e-06,3,1,2
12118,Sunshine,2.095639979110664e-07,5.348708166200577e-06,4,1,3
12119,Super,0.00015109564249387862,0.00014337988664879628,189,78,111
12120,SuperEarth,8.592123914353715e-06,1.7253897310324457e-07,4,4,0
12121,SuperRich,4.400843956132392e-06,3.6233184351681345e-06,6,3,3
12122,Superbug,8.592123914353715e-06,1.7253897310324457e-07,5,4,1
12123,Supercomputer,2.3052039770217305e-06,3.6233184351681345e-06,3,1,2
12124,Supercut,6.496483935243052e-06,7.074097897233022e-06,7,3,4
12125,Superdelegate,2.3052039770217305e-06,3.6233184351681345e-06,3,1,2
12126,Superhero,1.0687763893464371e-05,1.3975656821362803e-05,14,5,9
12127,Superintendent,2.3052039770217305e-06,5.348708166200577e-06,4,1,3
12128,Superior,4.400843956132392e-06,3.6233184351681345e-06,5,3,2
12129,Supermarket,8.592123914353715e-06,1.9151826014460126e-05,15,4,11
12130,Supermoon,2.3052039770217305e-06,1.8979287041356905e-06,3,2,1
12131,Supernovum,2.3052039770217305e-06,3.6233184351681345e-06,3,1,2
12132,Superpower,1.0687763893464371e-05,3.6233184351681345e-06,7,5,2
12133,Superstar,2.3052039770217305e-06,3.6233184351681345e-06,3,1,2
12134,Supervised,4.400843956132392e-06,1.8979287041356905e-06,3,2,1
12135,Supervisor,2.3052039770217305e-06,3.6233184351681345e-06,3,1,2
12136,Supplier,4.400843956132392e-06,8.79948762826546e-06,7,2,5
12137,Supply,4.6313643538345614e-05,3.468033359375216e-05,45,24,21
12138,Support,0.00028521660115696105,0.0003003903521727485,344,146,198
12139,Supported,8.592123914353715e-06,8.79948762826546e-06,11,5,6
12140,Supporter,0.0002160604818463093,0.00013992910718673112,203,110,93
12141,Supporting,3.3739803663681634e-05,1.570104655239525e-05,31,21,10
12142,Supportive,2.3052039770217305e-06,7.074097897233022e-06,5,1,4
12143,Suppose,2.3052039770217305e-06,3.6233184351681345e-06,3,1,2
12144,Supposed,2.3052039770217305e-06,7.074097897233022e-06,7,1,6
12145,Supposedly,2.3052039770217305e-06,3.6233184351681345e-06,3,1,2
12146,Suppres,6.496483935243052e-06,1.8979287041356905e-06,4,3,1
12147,Suppressed,2.3052039770217305e-06,8.79948762826546e-06,6,1,5
12148,Suppression,1.0687763893464371e-05,1.9151826014460126e-05,17,6,11
12149,Supremacist,3.3739803663681634e-05,4.6758061710979285e-05,45,17,28
12150,Supremacy,1.278340387257504e-05,1.9151826014460126e-05,18,7,11
12151,Supreme,0.0008552306754750611,0.0007265616157377627,925,446,479
12152,Surcharge,2.3052039770217305e-06,3.6233184351681345e-06,3,1,2
12153,Sure,9.451336305789087e-05,7.091351794543343e-05,94,49,45
12154,Surely,4.400843956132392e-06,1.8979287041356905e-06,3,2,1
12155,Surface,4.400843956132392e-06,1.3975656821362803e-05,12,3,9
12156,Surge,5.4696203454788295e-05,3.2954943862719716e-05,53,29,24
12157,Surgeon,8.592123914353715e-06,1.2250267090330355e-05,12,4,8
12158,Surgery,3.1644163684570994e-05,1.2250267090330355e-05,24,15,9
12159,Surging,8.592123914353715e-06,5.348708166200577e-06,8,4,4
12160,Surpass,2.095639979110664e-07,3.6233184351681345e-06,3,0,3
12161,Surplu,6.496483935243052e-06,1.8979287041356905e-06,4,3,1
12162,Surprise,7.146132328767358e-05,5.883578982820635e-05,81,40,41
12163,Surprised,8.592123914353715e-06,1.570104655239525e-05,14,4,10
12164,Surprising,2.326160376812834e-05,2.2602605476525032e-05,27,12,15
12165,Surprisingly,1.278340387257504e-05,1.052487735929791e-05,12,6,6
12166,Surreal,1.0687763893464371e-05,5.348708166200577e-06,9,6,3
12167,Surrender,8.592123914353715e-06,1.2250267090330355e-05,14,5,9
12168,Surrey,6.496483935243052e-06,1.8979287041356905e-06,5,3,2
12169,Surrogate,1.9070323809907035e-05,1.3975656821362803e-05,19,10,9
12170,Surrounded,2.3052039770217305e-06,3.6233184351681345e-06,3,1,2
12171,Surrounding,4.400843956132392e-06,1.8979287041356905e-06,3,2,1
12172,Surveillance,6.517440335034157e-05,6.401195902130366e-05,74,35,39
12173,Survey,5.888748341300963e-05,7.608968713853079e-05,83,37,46
12174,Survival,1.278340387257504e-05,7.074097897233022e-06,10,6,4
12175,Survive,2.5357243747239038e-05,3.468033359375216e-05,37,15,22
12176,Survived,2.3052039770217305e-06,1.052487735929791e-05,8,1,7
12177,Surviving,1.48790438516857e-05,7.074097897233022e-06,11,7,4
12178,Survivor,8.193952318322689e-05,9.334358444885519e-05,100,46,54
12179,Susan,4.840928351745632e-05,4.6758061710979285e-05,55,27,28
12180,Suspect,4.840928351745632e-05,8.644202552472544e-05,85,30,55
12181,Suspected,6.517440335034157e-05,3.985650278684949e-05,58,33,25
12182,Suspend,3.1644163684570994e-05,3.640572332478458e-05,38,16,22
12183,Suspended,1.278340387257504e-05,1.742643628342769e-05,19,8,11
12184,Suspending,2.3052039770217305e-06,3.6233184351681345e-06,3,1,2
12185,Suspension,6.496483935243052e-06,7.074097897233022e-06,7,3,4
12186,Suspicion,1.278340387257504e-05,7.074097897233022e-06,11,6,5
12187,Suspiciou,1.278340387257504e-05,5.348708166200577e-06,11,6,5
12188,Sussex,4.400843956132392e-06,1.8979287041356905e-06,3,2,1
12189,Sustainability,6.496483935243052e-06,1.2250267090330355e-05,11,3,8
12190,Sustainable,2.5357243747239038e-05,1.742643628342769e-05,27,15,12
12191,Sutton,2.3052039770217305e-06,3.6233184351681345e-06,3,1,2
12192,Suu,3.583544364279237e-05,1.570104655239525e-05,32,18,14
12193,Suzanne,4.400843956132392e-06,1.7253897310324457e-07,3,2,1
12194,Svalbard,6.496483935243052e-06,3.6233184351681345e-06,5,3,2
12195,Svartholm,6.496483935243052e-06,5.348708166200577e-06,6,3,3
12196,Swallow,4.400843956132392e-06,7.074097897233022e-06,6,2,4
12197,Swamp,6.496483935243052e-06,2.777877466962238e-05,28,8,20
12198,Swamped,2.3052039770217305e-06,3.6233184351681345e-06,3,1,2
12199,Swan,2.3052039770217305e-06,3.6233184351681345e-06,3,1,2
12200,Swann,4.400843956132392e-06,3.6233184351681345e-06,4,2,2
12201,Swap,8.592123914353715e-06,1.8979287041356905e-06,8,5,3
12202,Swarm,1.278340387257504e-05,3.6233184351681345e-06,10,7,3
12203,Swartz,2.3052039770217305e-06,3.6233184351681345e-06,4,2,2
12204,Swastika,6.496483935243052e-06,1.2250267090330355e-05,11,4,7
12205,Swat,1.48790438516857e-05,7.074097897233022e-06,12,7,5
12206,Sway,6.496483935243052e-06,3.6233184351681345e-06,6,4,2
12207,Swaziland,1.278340387257504e-05,3.6233184351681345e-06,10,6,4
12208,Swear,8.592123914353715e-06,1.3975656821362803e-05,12,4,8
12209,Swearing,6.496483935243052e-06,5.348708166200577e-06,6,3,3
12210,Sweater,4.400843956132392e-06,1.8979287041356905e-06,3,2,1
12211,Sweating,2.3052039770217305e-06,3.6233184351681345e-06,3,1,2
12212,Sweatshop,2.3052039770217305e-06,3.6233184351681345e-06,3,1,2
12213,Swede,1.9070323809907035e-05,1.9151826014460126e-05,21,9,12
12214,Sweden,0.00024539944155385846,0.0002106700861590614,270,127,143
12215,Swedish,0.0001825302421805385,0.00018996540938667205,218,97,121
12216,Sweep,6.496483935243052e-06,5.348708166200577e-06,8,4,4
12217,Sweeping,2.5357243747239038e-05,7.074097897233022e-06,19,13,6
12218,Sweet,2.116596378901769e-05,3.122955413168725e-05,33,15,18
12219,Sweetest,6.496483935243052e-06,7.074097897233022e-06,7,3,4
12220,Swell,2.3052039770217305e-06,5.348708166200577e-06,4,1,3
12221,Swept,4.400843956132392e-06,1.8979287041356905e-06,3,2,1
12222,Swift,8.592123914353715e-06,1.052487735929791e-05,12,6,6
12223,Swim,2.095639979110664e-07,7.074097897233022e-06,5,1,4
12224,Swimmer,4.400843956132392e-06,3.6233184351681345e-06,4,2,2
12225,Swimming,2.095639979110664e-07,7.074097897233022e-06,4,0,4
12226,Swine,1.0687763893464371e-05,1.9151826014460126e-05,26,12,14
12227,Swing,1.48790438516857e-05,1.2250267090330355e-05,18,8,10
12228,Swipe,2.116596378901769e-05,1.3975656821362803e-05,20,10,10
12229,Swis,0.0001343305226609934,0.0001347529379936339,162,70,92
12230,Switch,1.278340387257504e-05,1.742643628342769e-05,17,7,10
12231,Switching,2.3052039770217305e-06,5.348708166200577e-06,5,1,4
12232,Switzerland,0.00011127848289077625,9.506897417988779e-05,119,57,62
12233,Sword,4.400843956132392e-06,7.074097897233022e-06,7,3,4
12234,Swore,4.400843956132392e-06,1.8979287041356905e-06,3,2,1
12235,Sworn,1.0687763893464371e-05,7.074097897233022e-06,13,7,6
12236,Sydney,4.212236358012434e-05,3.985650278684949e-05,51,25,26
12237,Syke,6.496483935243052e-06,1.7253897310324457e-07,3,3,0
12238,Symantec,8.592123914353715e-06,1.8979287041356905e-06,5,4,1
12239,Symbol,8.592123914353715e-06,5.348708166200577e-06,8,5,3
12240,Symbolic,2.3052039770217305e-06,5.348708166200577e-06,4,1,3
12241,Sympathetic,4.400843956132392e-06,1.7253897310324457e-07,4,4,0
12242,Sympathy,4.400843956132392e-06,3.6233184351681345e-06,4,2,2
12243,Symphony,2.3052039770217305e-06,1.7253897310324457e-07,3,2,1
12244,Symptom,2.3052039770217305e-06,3.6233184351681345e-06,4,1,3
12245,Synagogue,8.592123914353715e-06,8.79948762826546e-06,9,4,5
12246,Syndrome,2.116596378901769e-05,2.2602605476525032e-05,25,11,14
12247,Syntagma,2.095639979110664e-07,7.074097897233022e-06,4,0,4
12248,Synthetic,6.496483935243052e-06,5.348708166200577e-06,6,3,3
12249,Syracuse,4.400843956132392e-06,1.8979287041356905e-06,3,2,1
12250,Syria,0.0009432475545977088,0.0009215306553444285,1084,485,599
12251,Syrian,0.0006687187173342125,0.0006126858934896211,750,355,395
12252,Syriza,2.3052039770217305e-06,7.074097897233022e-06,5,1,4
12253,Syrup,4.400843956132392e-06,1.8979287041356905e-06,3,2,1
12254,System,0.00015947820241032126,0.00013302754826260141,171,84,87
12255,Systematic,4.400843956132392e-06,1.8979287041356905e-06,3,2,1
12256,Systemic,2.3052039770217305e-06,1.3975656821362803e-05,9,1,8
12257,TB,1.48790438516857e-05,7.074097897233022e-06,13,7,6
12258,TBT,2.3052039770217305e-06,1.8979287041356905e-06,3,2,1
12259,TD,4.400843956132392e-06,5.348708166200577e-06,6,2,4
12260,TED,6.496483935243052e-06,1.8979287041356905e-06,5,4,1
12261,TEDx,2.095639979110664e-07,5.348708166200577e-06,3,0,3
12262,TEPCO,2.954852370546031e-05,3.2954943862719716e-05,34,15,19
12263,THAT,4.400843956132392e-06,1.8979287041356905e-06,3,2,1
12264,THREE,4.400843956132392e-06,1.8979287041356905e-06,3,2,1
12265,TIL,6.496483935243052e-06,7.074097897233022e-06,8,3,5
12266,TIME,2.116596378901769e-05,5.348708166200577e-06,14,11,3
12267,TISA,2.3052039770217305e-06,5.348708166200577e-06,4,1,3
12268,TMZ,4.400843956132392e-06,3.6233184351681345e-06,4,2,2
12269,TMobile,6.496483935243052e-06,8.79948762826546e-06,11,6,5
12270,TNT,2.3052039770217305e-06,1.8979287041356905e-06,3,1,2
12271,TODAY,4.400843956132392e-06,3.6233184351681345e-06,4,2,2
12272,TOP,1.0687763893464371e-05,7.074097897233022e-06,11,6,5
12273,TPP,0.00010499156295344414,7.436429740749831e-05,104,52,52
12274,TPPA,4.400843956132392e-06,1.8979287041356905e-06,4,2,2
12275,TSA,2.116596378901769e-05,8.79948762826546e-06,18,12,6
12276,TShirt,6.496483935243052e-06,3.6233184351681345e-06,6,4,2
12277,TTIP,5.260056347567764e-05,2.9504164400654783e-05,50,25,25
12278,TV,0.0003397032406138383,0.0003400743159864947,398,177,221
12279,TYT,2.095639979110664e-07,3.6233184351681345e-06,3,1,2
12280,TaNehisi,6.496483935243052e-06,1.8979287041356905e-06,5,3,2
12281,Table,2.5357243747239038e-05,1.570104655239525e-05,22,12,10
12282,Tablet,6.496483935243052e-06,3.6233184351681345e-06,5,3,2
12283,Tabloid,2.095639979110664e-07,7.074097897233022e-06,4,0,4
12284,Taboo,4.400843956132392e-06,7.074097897233022e-06,6,2,4
12285,Tack,4.400843956132392e-06,1.8979287041356905e-06,3,2,1
12286,Tackle,2.326160376812834e-05,2.087721574549256e-05,26,12,14
12287,Tackling,1.0687763893464371e-05,8.79948762826546e-06,12,7,5
12288,Taco,1.278340387257504e-05,5.348708166200577e-06,11,6,5
12289,Tactic,2.326160376812834e-05,2.777877466962238e-05,30,14,16
12290,Tactical,2.3052039770217305e-06,5.348708166200577e-06,4,1,3
12291,Tag,2.3052039770217305e-06,8.79948762826546e-06,6,1,5
12292,Tahir,2.3052039770217305e-06,5.348708166200577e-06,4,1,3
12293,Tahrir,4.002672360101368e-05,4.330728224891437e-05,48,21,27
12294,Taibbi,6.496483935243052e-06,1.7253897310324457e-07,3,3,0
12295,Taiji,4.400843956132392e-06,7.074097897233022e-06,7,3,4
12296,Tail,2.095639979110664e-07,7.074097897233022e-06,6,0,6
12297,Taint,2.3052039770217305e-06,3.6233184351681345e-06,3,1,2
12298,Tainted,4.400843956132392e-06,1.2250267090330355e-05,10,2,8
12299,Taipei,2.3052039770217305e-06,7.074097897233022e-06,6,1,5
12300,Taiwan,8.613080314144832e-05,6.918812821440096e-05,94,50,44
12301,Taiwanese,8.592123914353715e-06,1.570104655239525e-05,14,5,9
12302,Taj,2.095639979110664e-07,8.79948762826546e-06,6,1,5
12303,Tajikistan,8.592123914353715e-06,3.6233184351681345e-06,7,5,2
12304,Takata,8.592123914353715e-06,3.6233184351681345e-06,6,4,2
12305,Take,0.0004151462798618222,0.0004539500382346362,527,226,301
12306,Takeaway,6.496483935243052e-06,7.074097897233022e-06,7,3,4
12307,Takedown,6.496483935243052e-06,1.8979287041356905e-06,5,4,1
12308,Takei,4.400843956132392e-06,7.074097897233022e-06,6,2,4
12309,Taken,2.7452883726349685e-05,2.6053384938589907e-05,29,14,15
12310,Takeover,6.496483935243052e-06,1.052487735929791e-05,12,5,7
12311,Taking,0.00011127848289077625,0.0001036959228350498,131,62,69
12312,Taksim,4.400843956132392e-06,1.052487735929791e-05,8,2,6
12313,Talal,4.400843956132392e-06,1.8979287041356905e-06,3,2,1
12314,Tale,2.326160376812834e-05,1.742643628342769e-05,25,14,11
12315,Taleban,6.496483935243052e-06,1.7253897310324457e-07,4,4,0
12316,Talent,2.116596378901769e-05,1.570104655239525e-05,21,11,10
12317,Taliban,0.0003292250407182847,0.00028141106513139157,354,173,181
12318,Talk,0.00023282560167919462,0.0002451778807797103,273,122,151
12319,Talked,6.496483935243052e-06,1.3975656821362803e-05,12,3,9
12320,Talking,7.565260324589493e-05,7.781507686956326e-05,88,37,51
12321,Tall,6.496483935243052e-06,5.348708166200577e-06,7,4,3
12322,Talley,6.496483935243052e-06,1.7253897310324457e-07,4,4,0
12323,Tally,2.095639979110664e-07,3.6233184351681345e-06,3,0,3
12324,Tamil,2.5357243747239038e-05,3.640572332478458e-05,37,13,24
12325,Tamir,2.3052039770217305e-06,7.074097897233022e-06,7,3,4
12326,Tammy,2.326160376812834e-05,2.9504164400654783e-05,31,13,18
12327,Tampa,2.3052039770217305e-06,7.074097897233022e-06,6,2,4
12328,Tampon,1.48790438516857e-05,7.074097897233022e-06,12,7,5
12329,Tangled,2.095639979110664e-07,5.348708166200577e-06,4,0,4
12330,Tango,2.095639979110664e-07,5.348708166200577e-06,3,0,3
12331,Tank,4.002672360101368e-05,4.6758061710979285e-05,53,24,29
12332,Tanker,1.0687763893464371e-05,5.348708166200577e-06,9,5,4
12333,Tantrum,2.095639979110664e-07,5.348708166200577e-06,4,1,3
12334,Tanya,2.095639979110664e-07,5.348708166200577e-06,3,0,3
12335,Tanzania,2.954852370546031e-05,3.468033359375216e-05,38,16,22
12336,Tanzanian,2.095639979110664e-07,5.348708166200577e-06,3,0,3
12337,Taoiseach,4.400843956132392e-06,1.8979287041356905e-06,3,2,1
12338,Tap,2.326160376812834e-05,3.8131113055817005e-05,36,11,25
12339,Tape,3.1644163684570994e-05,3.468033359375216e-05,38,16,22
12340,Taped,2.095639979110664e-07,7.074097897233022e-06,4,0,4
12341,Tapped,6.496483935243052e-06,3.6233184351681345e-06,6,4,2
12342,Tapper,2.3052039770217305e-06,1.2250267090330355e-05,12,4,8
12343,Tar,8.592123914353715e-06,1.2250267090330355e-05,11,4,7
12344,Tara,4.400843956132392e-06,1.8979287041356905e-06,3,2,1
12345,Target,7.984388320411623e-05,0.00011749904068330962,115,41,74
12346,Targeted,2.7452883726349685e-05,3.122955413168725e-05,35,16,19
12347,Targeting,3.1644163684570994e-05,2.4327995207557487e-05,33,17,16
12348,Tariff,1.278340387257504e-05,2.4327995207557487e-05,22,7,15
12349,Tariq,4.400843956132392e-06,7.074097897233022e-06,6,2,4
12350,Tarnish,4.400843956132392e-06,1.8979287041356905e-06,3,2,1
12351,Taseer,4.400843956132392e-06,5.348708166200577e-06,5,2,3
12352,Taser,1.278340387257504e-05,2.6053384938589907e-05,28,10,18
12353,Tasered,6.496483935243052e-06,3.6233184351681345e-06,5,3,2
12354,Task,8.592123914353715e-06,1.3975656821362803e-05,13,4,9
12355,Tasmania,1.0687763893464371e-05,7.074097897233022e-06,10,5,5
12356,Tasmanian,1.0687763893464371e-05,1.2250267090330355e-05,12,5,7
12357,Taste,4.400843956132392e-06,5.348708166200577e-06,7,2,5
12358,Tata,4.400843956132392e-06,1.8979287041356905e-06,3,2,1
12359,Tatar,1.0687763893464371e-05,7.074097897233022e-06,9,5,4
12360,Tate,6.496483935243052e-06,1.8979287041356905e-06,4,3,1
12361,Tattoo,6.496483935243052e-06,1.2250267090330355e-05,10,3,7
12362,Tattooed,4.400843956132392e-06,1.8979287041356905e-06,4,2,2
12363,Taught,8.592123914353715e-06,1.742643628342769e-05,14,4,10
12364,Taunt,2.116596378901769e-05,1.2250267090330355e-05,21,11,10
12365,Tax,0.0005765105582533431,0.0006489190778413025,727,299,428
12366,Taxation,4.400843956132392e-06,1.8979287041356905e-06,4,3,1
12367,Taxi,1.48790438516857e-05,1.052487735929791e-05,13,7,6
12368,Taxing,1.48790438516857e-05,8.79948762826546e-06,13,7,6
12369,Taxpayer,2.326160376812834e-05,4.1581892517881935e-05,38,13,25
12370,TaxpayerFunded,4.400843956132392e-06,3.6233184351681345e-06,5,2,3
12371,Taylor,2.954852370546031e-05,5.1934230904076595e-05,49,18,31
12372,Tayyip,2.5357243747239038e-05,1.9151826014460126e-05,29,13,16
12373,Tbilisi,6.496483935243052e-06,1.8979287041356905e-06,4,3,1
12374,Tea,4.4218003559234974e-05,5.020884117304414e-05,55,22,33
12375,Teach,4.6313643538345614e-05,5.1934230904076595e-05,55,23,32
12376,Teacher,0.00015947820241032126,0.00014683066611086105,183,83,100
12377,Teaching,1.9070323809907035e-05,2.087721574549256e-05,23,10,13
12378,Teachout,6.496483935243052e-06,1.052487735929791e-05,10,4,6
12379,Team,0.00014480872255654665,0.0001951415785797695,200,74,126
12380,Tear,3.1644163684570994e-05,4.8483451442011706e-05,45,16,29
12381,Tearga,2.095639979110664e-07,7.074097897233022e-06,4,0,4
12382,Tearing,8.592123914353715e-06,1.7253897310324457e-07,5,4,1
12383,Tease,2.3052039770217305e-06,7.074097897233022e-06,5,1,4
12384,Tebow,2.095639979110664e-07,5.348708166200577e-06,3,0,3
12385,Tech,9.451336305789087e-05,0.00011232287149021227,119,49,70
12386,Technique,6.496483935243052e-06,8.79948762826546e-06,9,3,6
12387,Technology,6.517440335034157e-05,6.401195902130366e-05,74,37,37
12388,Ted,0.0003648509203631662,0.00025898099862796983,376,206,170
12389,Teddy,6.496483935243052e-06,5.348708166200577e-06,6,3,3
12390,Teen,0.0001385218026192147,0.0001295767688005365,155,70,85
12391,Teenage,2.7452883726349685e-05,1.3975656821362803e-05,22,14,8
12392,Teenager,2.326160376812834e-05,2.4327995207557487e-05,30,14,16
12393,Tehran,0.00010708720293255492,8.4716635793693e-05,108,55,53
12394,Tel,2.954852370546031e-05,2.2602605476525032e-05,29,14,15
12395,Telecom,6.496483935243052e-06,1.8979287041356905e-06,4,3,1
12396,Telecommunication,6.496483935243052e-06,1.7253897310324457e-07,3,3,0
12397,Telegraph,4.6313643538345614e-05,6.746273848336857e-05,70,29,41
12398,Telephone,6.496483935243052e-06,1.8979287041356905e-06,4,3,1
12399,Teleprompter,4.400843956132392e-06,1.8979287041356905e-06,3,2,1
12400,Telescope,3.1644163684570994e-05,2.087721574549256e-05,30,17,13
12401,Televised,4.400843956132392e-06,3.6233184351681345e-06,4,2,2
12402,Television,8.592123914353715e-06,1.2250267090330355e-05,12,5,7
12403,Tell,0.0002516863614911905,0.0002831364548624239,319,137,182
12404,TellAll,2.3052039770217305e-06,5.348708166200577e-06,4,1,3
12405,Telling,4.002672360101368e-05,3.122955413168725e-05,41,21,20
12406,Temp,2.3052039770217305e-06,7.074097897233022e-06,5,1,4
12407,Temperament,8.592123914353715e-06,1.8979287041356905e-06,5,4,1
12408,Temperature,1.278340387257504e-05,5.348708166200577e-06,11,8,3
12409,Templar,4.400843956132392e-06,7.074097897233022e-06,6,2,4
12410,Temple,2.7452883726349685e-05,2.2602605476525032e-05,27,14,13
12411,Temporarily,1.9070323809907035e-05,1.742643628342769e-05,20,9,11
12412,Temporary,6.496483935243052e-06,1.3975656821362803e-05,11,3,8
12413,Ten,9.451336305789087e-05,0.00012094982014537423,124,49,75
12414,Tenant,2.3052039770217305e-06,1.8979287041356905e-06,3,2,1
12415,Tennant,2.3052039770217305e-06,5.348708166200577e-06,4,1,3
12416,Tennessee,5.050492349656699e-05,6.918812821440096e-05,67,25,42
12417,Tenney,6.496483935243052e-06,1.8979287041356905e-06,4,3,1
12418,Tension,1.9070323809907035e-05,2.4327995207557487e-05,24,9,15
12419,Tent,8.592123914353715e-06,7.074097897233022e-06,9,5,4
12420,Tentative,4.400843956132392e-06,3.6233184351681345e-06,5,2,3
12421,Tepco,2.326160376812834e-05,1.3975656821362803e-05,21,12,9
12422,Teresa,4.400843956132392e-06,7.074097897233022e-06,8,2,6
12423,Term,3.1644163684570994e-05,5.883578982820635e-05,57,20,37
12424,Terminal,2.3052039770217305e-06,7.074097897233022e-06,6,1,5
12425,Terminally,2.3052039770217305e-06,1.052487735929791e-05,7,1,6
12426,Terrible,5.4696203454788295e-05,6.746273848336857e-05,72,28,44
12427,Terribly,2.095639979110664e-07,5.348708166200577e-06,4,0,4
12428,Terrified,1.0687763893464371e-05,1.052487735929791e-05,13,7,6
12429,Terrifying,2.326160376812834e-05,1.742643628342769e-05,23,12,11
12430,Territory,1.9070323809907035e-05,2.6053384938589907e-05,24,9,15
12431,Terror,9.451336305789087e-05,0.00010024514337298497,112,46,66
12432,Terrorism,9.03220830996695e-05,7.436429740749831e-05,96,49,47
12433,Terrorist,0.00011756540282810809,0.00012094982014537423,133,57,76
12434,Terrorizing,2.3052039770217305e-06,3.6233184351681345e-06,3,1,2
12435,Terry,1.9070323809907035e-05,2.777877466962238e-05,28,10,18
12436,Tesco,4.400843956132392e-06,3.6233184351681345e-06,5,2,3
12437,Tesla,5.888748341300963e-05,7.781507686956326e-05,88,36,52
12438,Test,0.00013642616264010403,0.00016408456342118544,174,70,104
12439,Testament,2.3052039770217305e-06,5.348708166200577e-06,4,1,3
12440,Tested,1.6974683830796368e-05,7.074097897233022e-06,13,9,4
12441,Testify,3.3739803663681634e-05,4.1581892517881935e-05,45,16,29
12442,Testifying,6.496483935243052e-06,3.6233184351681345e-06,5,3,2
12443,Testimony,3.7931083621902995e-05,4.330728224891437e-05,47,20,27
12444,Testing,2.7452883726349685e-05,3.122955413168725e-05,36,15,21
12445,Texa,0.0003271294007391747,0.0004504992587725714,473,179,294
12446,Texan,1.0687763893464371e-05,2.6053384938589907e-05,23,6,17
12447,Texas,2.095639979110664e-07,3.6233184351681345e-06,3,1,2
12448,Text,5.050492349656699e-05,3.2954943862719716e-05,44,24,20
12449,Textbook,2.3052039770217305e-06,7.074097897233022e-06,7,2,5
12450,Texting,2.095639979110664e-07,1.052487735929791e-05,6,0,6
12451,Thad,2.095639979110664e-07,3.6233184351681345e-06,4,2,2
12452,Thai,8.822644312055891e-05,5.711040009717395e-05,82,43,39
12453,Thailand,0.0001154697628489974,8.4716635793693e-05,125,65,60
12454,Thaksin,4.400843956132392e-06,1.8979287041356905e-06,3,2,1
12455,Thank,0.00013223488268188294,0.00012440059960743937,155,72,83
12456,Thankful,8.592123914353715e-06,1.2250267090330355e-05,11,4,7
12457,Thankfully,2.3052039770217305e-06,3.6233184351681345e-06,4,1,3
12458,Thanksgiving,5.050492349656699e-05,8.126585633162811e-05,78,30,48
12459,That,0.0002621645613867441,0.0002296493732004186,282,136,146
12460,Thatcher,2.116596378901769e-05,1.2250267090330355e-05,20,11,9
12461,Thaw,4.400843956132392e-06,1.8979287041356905e-06,3,2,1
12462,The,8.613080314144832e-05,0.0001019705331040174,112,43,69
12463,TheFuturein5,2.095639979110664e-07,7.074097897233022e-06,4,0,4
12464,Theater,1.48790438516857e-05,1.2250267090330355e-05,14,7,7
12465,Theft,3.7931083621902995e-05,2.6053384938589907e-05,37,20,17
12466,Theme,8.592123914353715e-06,8.79948762826546e-06,12,4,8
12467,Theodore,2.3052039770217305e-06,5.348708166200577e-06,4,1,3
12468,Theorist,4.400843956132392e-06,5.348708166200577e-06,6,3,3
12469,Theory,3.3739803663681634e-05,5.711040009717395e-05,53,17,36
12470,Therano,4.400843956132392e-06,1.742643628342769e-05,13,3,10
12471,Therapy,1.6974683830796368e-05,1.742643628342769e-05,19,9,10
12472,There,0.0002935991610734039,0.000302115741903781,346,154,192
12473,Therefore,1.0687763893464371e-05,7.074097897233022e-06,9,5,4
12474,Theresa,1.278340387257504e-05,1.3975656821362803e-05,15,7,8
12475,These,1.278340387257504e-05,3.6233184351681345e-06,8,6,2
12476,They,5.6791843433898893e-05,6.228656929027126e-05,71,30,41
12477,Theyll,8.592123914353715e-06,3.468033359375216e-05,27,6,21
12478,Theyre,0.00017205204228498542,0.00017788768126944505,210,93,117
12479,Theyve,2.5357243747239038e-05,3.985650278684949e-05,41,14,27
12480,Thi,4.4218003559234974e-05,7.436429740749831e-05,70,25,45
12481,Thief,1.0687763893464371e-05,1.3975656821362803e-05,17,7,10
12482,Thiel,2.116596378901769e-05,1.9151826014460126e-05,21,10,11
12483,Thin,8.592123914353715e-06,5.348708166200577e-06,8,5,3
12484,Thing,0.0003501814405093918,0.0002986649624417165,385,188,197
12485,Think,0.0003124599208853996,0.00036768055168301384,407,164,243
12486,Thinker,2.3052039770217305e-06,3.6233184351681345e-06,4,2,2
12487,Thinking,3.583544364279237e-05,2.087721574549256e-05,32,18,14
12488,Third,0.00010499156295344414,8.816741525575797e-05,111,55,56
12489,ThirdParty,8.592123914353715e-06,5.348708166200577e-06,11,8,3
12490,Thirst,4.400843956132392e-06,1.8979287041356905e-06,3,2,1
12491,Thirteen,1.48790438516857e-05,3.6233184351681345e-06,11,8,3
12492,Thirty,1.9070323809907035e-05,1.2250267090330355e-05,19,10,9
12493,Thom,2.095639979110664e-07,7.074097897233022e-06,4,0,4
12494,Thoma,6.72700433294523e-05,8.644202552472544e-05,86,34,52
12495,Thompson,1.278340387257504e-05,1.052487735929791e-05,12,6,6
12496,Thorium,6.496483935243052e-06,1.7253897310324457e-07,3,3,0
12497,Though,2.7452883726349685e-05,5.1934230904076595e-05,51,16,35
12498,Thought,7.355696326678427e-05,8.299124606266055e-05,92,38,54
12499,Thoughtful,2.3052039770217305e-06,5.348708166200577e-06,4,1,3
12500,Thousand,0.0003019817209898466,0.00029521418297965093,346,158,188
12501,Thread,6.496483935243052e-06,5.348708166200577e-06,8,4,4
12502,Threat,0.00018043460220142793,0.00016408456342118544,203,91,112
12503,Threaten,0.0001259479627445509,0.00011404826122124471,141,66,75
12504,Threatened,3.3739803663681634e-05,2.4327995207557487e-05,33,16,17
12505,Threatening,2.954852370546031e-05,2.6053384938589907e-05,30,15,15
12506,Three,0.0002055822819507562,0.0002486286602417749,269,108,161
12507,Threw,1.48790438516857e-05,3.6233184351681345e-06,9,7,2
12508,Thrill,2.3052039770217305e-06,1.7253897310324457e-07,3,2,1
12509,Thrilled,6.496483935243052e-06,5.348708166200577e-06,6,3,3
12510,Thrive,6.496483935243052e-06,3.6233184351681345e-06,5,3,2
12511,Thriving,4.400843956132392e-06,3.6233184351681345e-06,5,3,2
12512,Throat,1.278340387257504e-05,5.348708166200577e-06,9,6,3
12513,Throne,1.48790438516857e-05,1.570104655239525e-05,16,7,9
12514,Throughout,1.48790438516857e-05,8.79948762826546e-06,14,8,6
12515,Throw,5.6791843433898893e-05,3.8131113055817005e-05,55,32,23
12516,Throwback,2.3052039770217305e-06,7.074097897233022e-06,5,1,4
12517,Throwing,1.0687763893464371e-05,8.79948762826546e-06,11,5,6
12518,Thrown,1.48790438516857e-05,1.052487735929791e-05,13,7,6
12519,Thu,2.095639979110664e-07,7.074097897233022e-06,5,1,4
12520,Thug,6.496483935243052e-06,1.052487735929791e-05,10,3,7
12521,Thumb,1.0687763893464371e-05,1.8979287041356905e-06,8,5,3
12522,Thunberg,2.3052039770217305e-06,7.074097897233022e-06,5,1,4
12523,Thunder,2.3052039770217305e-06,3.6233184351681345e-06,3,1,2
12524,Thursday,0.00038790296013338374,0.00041081529495882486,478,209,269
12525,Thwart,4.400843956132392e-06,7.074097897233022e-06,9,2,7
12526,Thwarted,2.3052039770217305e-06,5.348708166200577e-06,4,1,3
12527,Thyroid,2.095639979110664e-07,5.348708166200577e-06,3,0,3
12528,Ti,8.592123914353715e-06,5.348708166200577e-06,7,4,3
12529,TiSA,4.400843956132392e-06,1.8979287041356905e-06,3,2,1
12530,Tiananman,3.583544364279237e-05,4.6758061710979285e-05,48,20,28
12531,Tianjin,1.6974683830796368e-05,8.79948762826546e-06,13,8,5
12532,Tibet,5.260056347567764e-05,2.777877466962238e-05,44,26,18
12533,Tibetan,6.517440335034157e-05,6.401195902130366e-05,78,35,43
12534,Tick,4.400843956132392e-06,5.348708166200577e-06,6,2,4
12535,Ticker,2.095639979110664e-07,5.348708166200577e-06,3,0,3
12536,Ticket,3.3739803663681634e-05,4.330728224891437e-05,46,18,28
12537,Ticking,2.3052039770217305e-06,1.8979287041356905e-06,4,2,2
12538,Tide,2.095639979110664e-07,1.3975656821362803e-05,10,1,9
12539,Tie,8.193952318322689e-05,7.436429740749831e-05,95,43,52
12540,Tied,2.954852370546031e-05,2.9504164400654783e-05,34,15,19
12541,Tiffany,2.095639979110664e-07,1.2250267090330355e-05,7,0,7
12542,Tiger,3.7931083621902995e-05,5.5385010366141504e-05,52,19,33
12543,Tight,1.278340387257504e-05,8.79948762826546e-06,12,6,6
12544,Tighten,2.3052039770217305e-06,1.2250267090330355e-05,9,1,8
12545,Tightening,4.400843956132392e-06,3.6233184351681345e-06,4,2,2
12546,Tijuana,6.496483935243052e-06,1.8979287041356905e-06,4,3,1
12547,TikTok,4.400843956132392e-06,3.6233184351681345e-06,6,4,2
12548,Tikrit,1.278340387257504e-05,5.348708166200577e-06,9,6,3
12549,Till,2.095639979110664e-07,5.348708166200577e-06,4,1,3
12550,Tillerson,7.984388320411623e-05,5.3659620635109e-05,75,40,35
12551,Tilli,2.095639979110664e-07,8.79948762826546e-06,5,0,5
12552,Tim,9.870464301611217e-05,0.00010887209202814718,122,51,71
12553,Timbuktu,2.954852370546031e-05,7.074097897233022e-06,20,15,5
12554,Time,0.0007336835566866429,0.000783499476861833,887,380,507
12555,Timed,2.3052039770217305e-06,3.6233184351681345e-06,3,1,2
12556,Timeline,4.400843956132392e-06,3.6233184351681345e-06,5,2,3
12557,Timid,4.400843956132392e-06,1.8979287041356905e-06,3,2,1
12558,Timing,8.592123914353715e-06,5.348708166200577e-06,7,4,3
12559,Timor,4.400843956132392e-06,7.074097897233022e-06,7,3,4
12560,Timothy,2.3052039770217305e-06,5.348708166200577e-06,4,1,3
12561,Tina,2.095639979110664e-07,5.348708166200577e-06,5,1,4
12562,Tinder,1.9070323809907035e-05,1.742643628342769e-05,22,12,10
12563,Tiny,4.212236358012434e-05,4.50326719799468e-05,50,22,28
12564,Tip,0.00010918284291166549,8.644202552472544e-05,116,58,58
12565,Tipping,1.9070323809907035e-05,7.074097897233022e-06,16,11,5
12566,Tirade,2.3052039770217305e-06,1.052487735929791e-05,7,1,6
12567,Tired,2.5357243747239038e-05,1.3975656821362803e-05,22,14,8
12568,Tissue,6.496483935243052e-06,8.79948762826546e-06,8,3,5
12569,Titan,1.0687763893464371e-05,3.6233184351681345e-06,8,5,3
12570,Titanic,1.48790438516857e-05,1.8979287041356905e-06,9,8,1
12571,Title,1.278340387257504e-05,1.9151826014460126e-05,20,6,14
12572,Tlaib,2.095639979110664e-07,1.8979287041356905e-06,3,2,1
12573,To,1.0687763893464371e-05,7.074097897233022e-06,10,6,4
12574,ToDo,2.3052039770217305e-06,1.8979287041356905e-06,3,1,2
12575,Toast,4.400843956132392e-06,3.6233184351681345e-06,5,2,3
12576,Tobacco,2.5357243747239038e-05,1.742643628342769e-05,27,13,14
12577,Today,0.00021396484186719832,0.00026933333701416437,283,115,168
12578,Todd,1.48790438516857e-05,2.087721574549256e-05,21,7,14
12579,Toddler,1.278340387257504e-05,2.2602605476525032e-05,22,8,14
12580,Together,4.212236358012434e-05,5.883578982820635e-05,66,24,42
12581,Togo,8.592123914353715e-06,1.8979287041356905e-06,6,5,1
12582,Toilet,1.48790438516857e-05,1.2250267090330355e-05,16,8,8
12583,Tokyo,8.613080314144832e-05,7.608968713853079e-05,99,42,57
12584,Told,4.840928351745632e-05,6.401195902130366e-05,63,24,39
12585,Tolerance,1.278340387257504e-05,8.79948762826546e-06,11,6,5
12586,Tolerate,2.095639979110664e-07,1.2250267090330355e-05,7,0,7
12587,Toll,2.326160376812834e-05,3.8131113055817005e-05,34,12,22
12588,Tom,0.00012385232276544028,0.00016926073261428268,179,69,110
12589,TomDispatch,1.0687763893464371e-05,5.348708166200577e-06,8,5,3
12590,TomDispatchcom,5.050492349656699e-05,4.1581892517881935e-05,53,25,28
12591,Tomahawk,2.3052039770217305e-06,5.348708166200577e-06,4,1,3
12592,Tomb,1.9070323809907035e-05,1.052487735929791e-05,16,9,7
12593,Tombstone,6.496483935243052e-06,1.7253897310324457e-07,3,3,0
12594,Tomi,1.278340387257504e-05,5.348708166200577e-06,9,6,3
12595,Tomlinson,1.0687763893464371e-05,1.3975656821362803e-05,17,5,12
12596,Tommy,4.400843956132392e-06,3.6233184351681345e-06,4,2,2
12597,Tomorrow,1.48790438516857e-05,2.6053384938589907e-05,24,9,15
12598,Ton,1.9070323809907035e-05,1.9151826014460126e-05,23,11,12
12599,Tone,6.496483935243052e-06,8.79948762826546e-06,10,5,5
12600,Tongue,6.496483935243052e-06,1.7253897310324457e-07,3,3,0
12601,Toni,4.400843956132392e-06,3.6233184351681345e-06,4,2,2
12602,Tonight,2.954852370546031e-05,2.9504164400654783e-05,35,17,18
12603,Tonne,2.3052039770217305e-06,3.6233184351681345e-06,3,1,2
12604,Tony,0.00014480872255654665,0.00014337988664879628,176,81,95
12605,Took,4.4218003559234974e-05,6.228656929027126e-05,62,24,38
12606,Tool,4.6313643538345614e-05,3.2954943862719716e-05,46,24,22
12607,Toomey,1.48790438516857e-05,8.79948762826546e-06,12,7,5
12608,Tooth,2.3052039770217305e-06,8.79948762826546e-06,9,3,6
12609,Top,0.00036904220032138744,0.00042116763334501973,463,192,271
12610,Topic,4.400843956132392e-06,5.348708166200577e-06,5,2,3
12611,Toples,4.400843956132392e-06,7.074097897233022e-06,7,3,4
12612,Topple,2.095639979110664e-07,5.348708166200577e-06,3,0,3
12613,Toppling,2.095639979110664e-07,5.348708166200577e-06,3,0,3
12614,Topsecret,4.400843956132392e-06,1.8979287041356905e-06,3,2,1
12615,Tor,1.9070323809907035e-05,8.79948762826546e-06,15,9,6
12616,Torah,2.3052039770217305e-06,3.6233184351681345e-06,4,2,2
12617,Torch,1.48790438516857e-05,5.348708166200577e-06,12,8,4
12618,Torched,2.3052039770217305e-06,3.6233184351681345e-06,4,1,3
12619,Tore,2.3052039770217305e-06,3.6233184351681345e-06,3,1,2
12620,Torn,2.095639979110664e-07,8.79948762826546e-06,6,1,5
12621,Tornado,1.6974683830796368e-05,2.2602605476525032e-05,23,10,13
12622,Toronto,0.00010499156295344414,6.228656929027126e-05,95,52,43
12623,Torpedo,4.400843956132392e-06,5.348708166200577e-06,6,2,4
12624,Torrent,2.3052039770217305e-06,1.7253897310324457e-07,3,1,2
12625,Tort,6.496483935243052e-06,1.8979287041356905e-06,4,3,1
12626,Tortoise,8.592123914353715e-06,3.6233184351681345e-06,7,4,3
12627,Torture,9.03220830996695e-05,8.816741525575797e-05,106,48,58
12628,Tortured,1.48790438516857e-05,1.052487735929791e-05,14,7,7
12629,Torturing,2.3052039770217305e-06,5.348708166200577e-06,4,1,3
12630,Tory,3.3739803663681634e-05,2.9504164400654783e-05,36,17,19
12631,Tos,6.496483935243052e-06,8.79948762826546e-06,9,4,5
12632,Toss,1.48790438516857e-05,7.074097897233022e-06,14,9,5
12633,Tossed,6.496483935243052e-06,1.7253897310324457e-07,4,3,1
12634,Tot,2.3052039770217305e-06,5.348708166200577e-06,4,1,3
12635,Total,4.4218003559234974e-05,2.9504164400654783e-05,43,24,19
12636,Totally,4.840928351745632e-05,3.2954943862719716e-05,47,25,22
12637,Tottenham,2.3052039770217305e-06,1.8979287041356905e-06,3,1,2
12638,Touch,2.5357243747239038e-05,1.2250267090330355e-05,23,13,10
12639,Touching,8.592123914353715e-06,1.2250267090330355e-05,12,4,8
12640,Tough,5.888748341300963e-05,5.5385010366141504e-05,65,30,35
12641,Tougher,6.496483935243052e-06,1.742643628342769e-05,15,3,12
12642,Toughest,4.400843956132392e-06,7.074097897233022e-06,7,2,5
12643,Toulouse,8.592123914353715e-06,1.8979287041356905e-06,7,6,1
12644,Tour,2.7452883726349685e-05,1.9151826014460126e-05,26,14,12
12645,Tourism,8.592123914353715e-06,1.2250267090330355e-05,12,4,8
12646,Tourist,3.583544364279237e-05,2.9504164400654783e-05,39,19,20
12647,Tournament,6.496483935243052e-06,1.8979287041356905e-06,5,3,2
12648,Tout,1.48790438516857e-05,2.9504164400654783e-05,29,9,20
12649,Touting,4.400843956132392e-06,1.8979287041356905e-06,3,2,1
12650,Toward,9.03220830996695e-05,8.4716635793693e-05,109,51,58
12651,Tower,4.002672360101368e-05,4.6758061710979285e-05,55,23,32
12652,Town,0.00011127848289077625,0.00010887209202814718,130,58,72
12653,Townsend,4.400843956132392e-06,1.8979287041356905e-06,3,2,1
12654,Toxic,3.7931083621902995e-05,5.711040009717395e-05,57,21,36
12655,Toy,3.1644163684570994e-05,1.9151826014460126e-05,31,16,15
12656,Toyota,1.6974683830796368e-05,2.4327995207557487e-05,25,8,17
12657,Trace,2.3052039770217305e-06,8.79948762826546e-06,6,1,5
12658,Tracey,6.496483935243052e-06,5.348708166200577e-06,6,3,3
12659,Track,4.6313643538345614e-05,4.330728224891437e-05,51,24,27
12660,Tracker,4.400843956132392e-06,1.8979287041356905e-06,4,3,1
12661,Tracking,8.592123914353715e-06,1.3975656821362803e-05,14,4,10
12662,Tractor,6.496483935243052e-06,1.8979287041356905e-06,4,3,1
12663,Trade,0.00014900000251476814,0.00016408456342118544,185,79,106
12664,Trademark,1.48790438516857e-05,1.052487735929791e-05,14,8,6
12665,Trader,8.592123914353715e-06,1.570104655239525e-05,14,4,10
12666,Trading,8.592123914353715e-06,2.4327995207557487e-05,22,6,16
12667,Tradition,1.278340387257504e-05,1.570104655239525e-05,16,6,10
12668,Traditional,1.0687763893464371e-05,1.570104655239525e-05,19,8,11
12669,Traffic,2.326160376812834e-05,3.2954943862719716e-05,33,12,21
12670,Trafficker,8.592123914353715e-06,7.074097897233022e-06,8,4,4
12671,Trafficking,2.954852370546031e-05,3.2954943862719716e-05,38,17,21
12672,Trafigura,2.3052039770217305e-06,3.6233184351681345e-06,5,1,4
12673,Tragedy,2.326160376812834e-05,1.3975656821362803e-05,21,12,9
12674,Tragic,8.592123914353715e-06,8.79948762826546e-06,10,4,6
12675,Tragically,4.400843956132392e-06,3.6233184351681345e-06,4,2,2
12676,Trail,3.7931083621902995e-05,1.3975656821362803e-05,28,18,10
12677,Trailer,4.400843956132392e-06,8.79948762826546e-06,7,2,5
12678,Trailing,4.400843956132392e-06,1.8979287041356905e-06,3,2,1
12679,Train,5.260056347567764e-05,5.3659620635109e-05,61,27,34
12680,Trained,2.3052039770217305e-06,3.6233184351681345e-06,3,1,2
12681,Trainee,6.496483935243052e-06,1.7253897310324457e-07,3,3,0
12682,Training,3.583544364279237e-05,4.6758061710979285e-05,53,21,32
12683,Trait,2.3052039770217305e-06,1.8979287041356905e-06,3,2,1
12684,Traitor,2.3052039770217305e-06,7.074097897233022e-06,6,1,5
12685,Trampled,4.400843956132392e-06,3.6233184351681345e-06,4,2,2
12686,Tran,2.116596378901769e-05,3.2954943862719716e-05,33,10,23
12687,TransCanada,1.48790438516857e-05,1.052487735929791e-05,13,7,6
12688,TransPacific,4.6313643538345614e-05,5.5385010366141504e-05,59,23,36
12689,Transaction,6.496483935243052e-06,3.6233184351681345e-06,5,3,2
12690,Transatlantic,8.592123914353715e-06,1.8979287041356905e-06,5,4,1
12691,Transcript,8.592123914353715e-06,1.052487735929791e-05,11,4,7
12692,Transfer,8.592123914353715e-06,1.3975656821362803e-05,14,5,9
12693,Transform,1.0687763893464371e-05,1.3975656821362803e-05,13,5,8
12694,Transformation,4.400843956132392e-06,7.074097897233022e-06,8,4,4
12695,Transformed,8.592123914353715e-06,3.6233184351681345e-06,7,5,2
12696,Transforming,8.592123914353715e-06,5.348708166200577e-06,8,4,4
12697,Transgender,8.193952318322689e-05,7.608968713853079e-05,94,44,50
12698,Transit,8.592123914353715e-06,1.3975656821362803e-05,13,4,9
12699,Transition,4.4218003559234974e-05,2.6053384938589907e-05,39,22,17
12700,Translate,1.48790438516857e-05,1.7253897310324457e-07,8,7,1
12701,Translated,2.3052039770217305e-06,3.6233184351681345e-06,3,1,2
12702,Translation,4.400843956132392e-06,5.348708166200577e-06,5,2,3
12703,Transparency,2.116596378901769e-05,2.2602605476525032e-05,28,11,17
12704,Transparent,6.496483935243052e-06,1.052487735929791e-05,10,4,6
12705,Transplant,6.496483935243052e-06,1.7253897310324457e-07,4,4,0
12706,Transport,2.3052039770217305e-06,1.3975656821362803e-05,10,2,8
12707,Transportation,3.3739803663681634e-05,1.9151826014460126e-05,30,19,11
12708,Trap,1.48790438516857e-05,1.3975656821362803e-05,19,8,11
12709,TrapWire,2.3052039770217305e-06,3.6233184351681345e-06,3,1,2
12710,Trapped,1.9070323809907035e-05,2.2602605476525032e-05,27,10,17
12711,Trash,2.326160376812834e-05,3.640572332478458e-05,33,11,22
12712,Trashed,6.496483935243052e-06,5.348708166200577e-06,6,3,3
12713,Trashing,8.592123914353715e-06,3.6233184351681345e-06,6,4,2
12714,Trauma,4.400843956132392e-06,1.3975656821362803e-05,10,2,8
12715,Traumatic,2.3052039770217305e-06,1.8979287041356905e-06,3,1,2
12716,Traumatized,2.3052039770217305e-06,3.6233184351681345e-06,4,1,3
12717,Travel,0.00014271308257743603,0.0001520068353039585,170,72,98
12718,Traveled,6.496483935243052e-06,3.6233184351681345e-06,6,4,2
12719,Traveler,1.6974683830796368e-05,1.8979287041356905e-06,15,12,3
12720,Traveling,1.278340387257504e-05,8.79948762826546e-06,11,6,5
12721,Travi,2.7452883726349685e-05,7.074097897233022e-06,17,13,4
12722,Travolta,6.496483935243052e-06,1.7253897310324457e-07,3,3,0
12723,Trayvon,2.095639979110664e-07,3.6233184351681345e-06,3,1,2
12724,Treason,1.9070323809907035e-05,8.79948762826546e-06,14,9,5
12725,Treasonou,2.3052039770217305e-06,3.6233184351681345e-06,3,1,2
12726,Treasure,1.278340387257504e-05,1.3975656821362803e-05,15,7,8
12727,Treasurer,8.592123914353715e-06,7.074097897233022e-06,9,4,5
12728,Treasury,6.098312339212028e-05,6.401195902130366e-05,74,33,41
12729,Treat,2.326160376812834e-05,4.50326719799468e-05,40,12,28
12730,Treated,4.400843956132392e-06,1.3975656821362803e-05,13,3,10
12731,Treating,1.278340387257504e-05,1.052487735929791e-05,14,7,7
12732,Treatment,4.840928351745632e-05,5.020884117304414e-05,55,26,29
12733,Treaty,2.116596378901769e-05,2.087721574549256e-05,26,11,15
12734,Tree,4.4218003559234974e-05,2.087721574549256e-05,37,22,15
12735,Trek,8.592123914353715e-06,5.348708166200577e-06,8,4,4
12736,Tremendou,6.496483935243052e-06,5.348708166200577e-06,6,3,3
12737,Trench,2.3052039770217305e-06,5.348708166200577e-06,6,3,3
12738,Trend,1.278340387257504e-05,2.9504164400654783e-05,24,6,18
12739,Trending,2.3052039770217305e-06,3.6233184351681345e-06,3,1,2
12740,Trent,1.278340387257504e-05,3.6233184351681345e-06,8,6,2
12741,Trevor,8.592123914353715e-06,1.3975656821362803e-05,16,4,12
12742,Trey,2.3052039770217305e-06,2.6053384938589907e-05,21,4,17
12743,Trial,8.193952318322689e-05,0.00011232287149021227,119,49,70
12744,Triangle,2.095639979110664e-07,5.348708166200577e-06,3,0,3
12745,Tribal,1.6974683830796368e-05,1.052487735929791e-05,14,8,6
12746,Tribe,2.954852370546031e-05,2.6053384938589907e-05,31,15,16
12747,Tribunal,4.400843956132392e-06,5.348708166200577e-06,5,2,3
12748,Tribune,4.400843956132392e-06,5.348708166200577e-06,6,2,4
12749,Tribute,3.3739803663681634e-05,3.122955413168725e-05,36,18,18
12750,Trick,2.326160376812834e-05,2.6053384938589907e-05,31,13,18
12751,Tricked,4.400843956132392e-06,5.348708166200577e-06,6,3,3
12752,TrickleDown,4.400843956132392e-06,7.074097897233022e-06,7,3,4
12753,Tricky,2.095639979110664e-07,5.348708166200577e-06,3,0,3
12754,Trident,2.095639979110664e-07,5.348708166200577e-06,4,0,4
12755,Tried,4.840928351745632e-05,7.781507686956326e-05,72,24,48
12756,Trigger,1.0687763893464371e-05,8.79948762826546e-06,13,6,7
12757,Triggered,4.400843956132392e-06,5.348708166200577e-06,5,2,3
12758,Triggering,2.3052039770217305e-06,1.8979287041356905e-06,3,2,1
12759,Trilateral,2.095639979110664e-07,3.6233184351681345e-06,3,0,3
12760,Trillion,3.1644163684570994e-05,4.6758061710979285e-05,45,16,29
12761,Trim,2.3052039770217305e-06,5.348708166200577e-06,4,1,3
12762,Trinidad,4.400843956132392e-06,1.8979287041356905e-06,3,2,1
12763,Trip,5.4696203454788295e-05,5.020884117304414e-05,66,30,36
12764,Triple,1.0687763893464371e-05,1.742643628342769e-05,16,5,11
12765,Tripled,2.095639979110664e-07,5.348708166200577e-06,3,0,3
12766,Tripoli,4.4218003559234974e-05,4.1581892517881935e-05,48,21,27
12767,Triumph,1.6974683830796368e-05,8.79948762826546e-06,13,8,5
12768,Trojan,8.592123914353715e-06,7.074097897233022e-06,8,4,4
12769,Troll,6.517440335034157e-05,6.401195902130366e-05,74,35,39
12770,Trolled,4.400843956132392e-06,1.8979287041356905e-06,3,2,1
12771,Trolling,1.48790438516857e-05,3.6233184351681345e-06,9,7,2
12772,Troop,8.822644312055891e-05,9.334358444885519e-05,105,44,61
12773,Trooper,1.0687763893464371e-05,5.348708166200577e-06,10,6,4
12774,Trophy,6.496483935243052e-06,7.074097897233022e-06,8,3,5
12775,Tropical,1.278340387257504e-05,1.2250267090330355e-05,13,6,7
12776,Trot,2.095639979110664e-07,5.348708166200577e-06,3,0,3
12777,Trouble,4.6313643538345614e-05,6.056117955923882e-05,64,27,37
12778,Troubled,1.48790438516857e-05,1.2250267090330355e-05,15,8,7
12779,Troubling,1.0687763893464371e-05,3.6233184351681345e-06,9,6,3
12780,Trounce,2.095639979110664e-07,5.348708166200577e-06,3,0,3
12781,Trove,1.0687763893464371e-05,1.052487735929791e-05,11,5,6
12782,Troy,2.3052039770217305e-06,5.348708166200577e-06,4,1,3
12783,Truce,4.400843956132392e-06,8.79948762826546e-06,9,2,7
12784,Truck,2.7452883726349685e-05,3.122955413168725e-05,32,14,18
12785,Trucker,2.3052039770217305e-06,7.074097897233022e-06,5,1,4
12786,Trudeau,3.583544364279237e-05,3.2954943862719716e-05,39,19,20
12787,True,6.098312339212028e-05,5.1934230904076595e-05,66,34,32
12788,Truly,1.9070323809907035e-05,2.087721574549256e-05,25,11,14
12789,Truman,4.400843956132392e-06,5.348708166200577e-06,5,2,3
12790,Trump,0.009057565553714196,0.009482914500727415,10928,4734,6194
12791,TrumpComey,2.3052039770217305e-06,3.6233184351681345e-06,3,1,2
12792,TrumpEra,2.3052039770217305e-06,5.348708166200577e-06,4,1,3
12793,TrumpInspired,2.3052039770217305e-06,3.6233184351681345e-06,3,1,2
12794,TrumpLoving,4.400843956132392e-06,3.6233184351681345e-06,4,2,2
12795,TrumpRelated,2.095639979110664e-07,1.8979287041356905e-06,3,1,2
12796,TrumpRussia,2.326160376812834e-05,1.742643628342769e-05,21,11,10
12797,TrumpStyle,1.0687763893464371e-05,1.8979287041356905e-06,7,5,2
12798,TrumpThemed,2.095639979110664e-07,5.348708166200577e-06,3,0,3
12799,Trumpcare,3.7931083621902995e-05,3.640572332478458e-05,44,19,25
12800,Trumper,2.3052039770217305e-06,3.6233184351681345e-06,4,1,3
12801,Trumpera,2.3052039770217305e-06,3.6233184351681345e-06,3,1,2
12802,Trumpian,6.496483935243052e-06,8.79948762826546e-06,10,4,6
12803,Trumpism,6.496483935243052e-06,3.6233184351681345e-06,7,3,4
12804,Trumpland,2.3052039770217305e-06,3.6233184351681345e-06,4,1,3
12805,Trumpster,2.3052039770217305e-06,1.8979287041356905e-06,3,2,1
12806,Trust,7.146132328767358e-05,5.711040009717395e-05,71,37,34
12807,Trusted,1.6974683830796368e-05,8.79948762826546e-06,13,8,5
12808,Trusting,2.095639979110664e-07,8.79948762826546e-06,5,0,5
12809,Trustworthy,4.400843956132392e-06,1.8979287041356905e-06,3,2,1
12810,Truth,8.822644312055891e-05,6.918812821440096e-05,89,48,41
12811,Truthdig,4.400843956132392e-06,1.8979287041356905e-06,3,2,1
12812,Truthdigcom,4.400843956132392e-06,5.348708166200577e-06,5,2,3
12813,Truther,4.400843956132392e-06,5.348708166200577e-06,7,3,4
12814,Try,0.00012804360272366158,0.0001295767688005365,155,71,84
12815,Trying,0.0001154697628489974,0.00014683066611086105,152,59,93
12816,Tsarnaev,8.592123914353715e-06,1.7253897310324457e-07,4,4,0
12817,Tshirt,1.48790438516857e-05,7.074097897233022e-06,11,7,4
12818,Tsipra,4.400843956132392e-06,3.6233184351681345e-06,4,2,2
12819,Tskhinvali,1.0687763893464371e-05,1.7253897310324457e-07,5,5,0
12820,Tsunami,3.3739803663681634e-05,4.6758061710979285e-05,51,21,30
12821,Tsvangirai,6.496483935243052e-06,1.8979287041356905e-06,6,3,3
12822,Tube,2.3052039770217305e-06,7.074097897233022e-06,5,1,4
12823,Tuberculosi,4.400843956132392e-06,1.3975656821362803e-05,12,4,8
12824,Tubman,6.496483935243052e-06,1.8979287041356905e-06,4,3,1
12825,Tucker,2.326160376812834e-05,2.087721574549256e-05,24,11,13
12826,Tuesday,0.0005534585184831261,0.000519514848013869,640,286,354
12827,Tuition,1.278340387257504e-05,1.570104655239525e-05,16,7,9
12828,Tulsi,4.400843956132392e-06,5.348708166200577e-06,6,2,4
12829,Tumble,1.6974683830796368e-05,5.348708166200577e-06,12,9,3
12830,Tumbling,4.400843956132392e-06,1.8979287041356905e-06,3,2,1
12831,Tumblr,4.400843956132392e-06,8.79948762826546e-06,8,2,6
12832,Tumor,1.0687763893464371e-05,5.348708166200577e-06,8,5,3
12833,Tumult,2.3052039770217305e-06,3.6233184351681345e-06,3,1,2
12834,Tumultuou,2.3052039770217305e-06,3.6233184351681345e-06,3,1,2
12835,Tuna,4.400843956132392e-06,1.052487735929791e-05,10,2,8
12836,Tune,2.095639979110664e-07,1.052487735929791e-05,6,0,6
12837,Tuni,4.400843956132392e-06,7.074097897233022e-06,7,2,5
12838,Tunisia,4.6313643538345614e-05,8.816741525575797e-05,77,23,54
12839,Tunisian,3.583544364279237e-05,2.9504164400654783e-05,39,18,21
12840,Tunnel,6.496483935243052e-06,2.2602605476525032e-05,16,3,13
12841,Turing,2.7452883726349685e-05,1.2250267090330355e-05,27,15,12
12842,Turk,3.1644163684570994e-05,2.777877466962238e-05,32,15,17
12843,Turkey,0.0005345977586711301,0.000529867186400064,635,285,350
12844,Turkish,0.0004235288397782649,0.0002900380137865542,409,218,191
12845,Turmoil,1.278340387257504e-05,1.2250267090330355e-05,13,6,7
12846,Turn,0.00016786076232676425,0.0001968669683108019,214,87,127
12847,Turnbull,6.496483935243052e-06,1.8979287041356905e-06,4,3,1
12848,Turned,3.583544364279237e-05,3.2954943862719716e-05,41,18,23
12849,Turner,1.278340387257504e-05,1.9151826014460126e-05,19,6,13
12850,Turning,3.583544364279237e-05,3.8131113055817005e-05,42,18,24
12851,Turnout,2.954852370546031e-05,1.742643628342769e-05,27,16,11
12852,Turtle,1.278340387257504e-05,1.052487735929791e-05,14,6,8
12853,Tuscan,4.400843956132392e-06,3.6233184351681345e-06,4,2,2
12854,Tusk,6.496483935243052e-06,7.074097897233022e-06,8,4,4
12855,Tut,2.3052039770217305e-06,5.348708166200577e-06,4,1,3
12856,Tutankhamun,8.592123914353715e-06,1.7253897310324457e-07,4,4,0
12857,Tutu,1.9070323809907035e-05,1.742643628342769e-05,21,9,12
12858,Tuvalu,6.496483935243052e-06,1.7253897310324457e-07,3,3,0
12859,Tweak,2.3052039770217305e-06,1.2250267090330355e-05,8,1,7
12860,Tweet,0.00016157384238943198,0.00018996540938667205,214,85,129
12861,Tweeted,6.496483935243052e-06,1.8979287041356905e-06,4,3,1
12862,Tweeter,1.9070323809907035e-05,1.2250267090330355e-05,19,10,9
12863,Tweeting,1.278340387257504e-05,2.2602605476525032e-05,21,8,13
12864,Tweetstorm,2.3052039770217305e-06,5.348708166200577e-06,4,1,3
12865,Twelve,4.400843956132392e-06,7.074097897233022e-06,9,4,5
12866,Twenty,1.48790438516857e-05,1.052487735929791e-05,14,8,6
12867,Twice,2.954852370546031e-05,1.9151826014460126e-05,29,15,14
12868,Twin,1.6974683830796368e-05,8.79948762826546e-06,14,9,5
12869,Twist,1.0687763893464371e-05,1.3975656821362803e-05,14,6,8
12870,Twisted,4.400843956132392e-06,5.348708166200577e-06,5,2,3
12871,Twitter,0.0005031631589844702,0.0005868050475241346,638,259,379
12872,Twitterverse,6.496483935243052e-06,1.8979287041356905e-06,4,3,1
12873,Two,0.0004968762390471381,0.000445323089579474,539,255,284
12874,TwoState,2.3052039770217305e-06,1.8979287041356905e-06,3,1,2
12875,TwoThird,6.496483935243052e-06,1.3975656821362803e-05,11,3,8
12876,TwoWay,2.095639979110664e-07,7.074097897233022e-06,4,0,4
12877,Twothird,1.278340387257504e-05,5.348708166200577e-06,10,6,4
12878,Ty,8.592123914353715e-06,1.8979287041356905e-06,5,4,1
12879,Tycoon,1.0687763893464371e-05,5.348708166200577e-06,9,6,3
12880,Tyler,8.592123914353715e-06,3.6233184351681345e-06,7,4,3
12881,Tymoshenko,2.3052039770217305e-06,7.074097897233022e-06,5,1,4
12882,Type,8.592123914353715e-06,8.79948762826546e-06,10,5,5
12883,Typhoon,2.326160376812834e-05,2.087721574549256e-05,25,12,13
12884,Typical,1.278340387257504e-05,5.348708166200577e-06,10,6,4
12885,Typo,1.48790438516857e-05,7.074097897233022e-06,11,7,4
12886,Tyranny,1.278340387257504e-05,1.7253897310324457e-07,6,6,0
12887,Tyrant,2.3052039770217305e-06,3.6233184351681345e-06,3,1,2
12888,Tyson,1.0687763893464371e-05,1.9151826014460126e-05,18,7,11
12889,Tzipi,6.496483935243052e-06,5.348708166200577e-06,6,3,3
12890,UAE,4.4218003559234974e-05,3.2954943862719716e-05,48,22,26
12891,UB,1.48790438516857e-05,1.3975656821362803e-05,18,9,9
12892,UC,4.400843956132392e-06,1.2250267090330355e-05,9,2,7
12893,UCF,6.496483935243052e-06,3.6233184351681345e-06,5,3,2
12894,UCLA,2.3052039770217305e-06,8.79948762826546e-06,6,1,5
12895,UConn,2.3052039770217305e-06,1.8979287041356905e-06,3,1,2
12896,UFO,2.5357243747239038e-05,1.3975656821362803e-05,24,15,9
12897,UK,0.0013267496707749604,0.0012976656167095013,1542,698,844
12898,UKIP,6.496483935243052e-06,3.6233184351681345e-06,5,3,2
12899,UKbased,2.095639979110664e-07,3.6233184351681345e-06,3,0,3
12900,UN,0.0010040211139919185,0.0010336809878615377,1211,541,670
12901,UNC,2.3052039770217305e-06,5.348708166200577e-06,4,1,3
12902,UNESCO,2.954852370546031e-05,2.4327995207557487e-05,29,15,14
12903,UNICEF,1.278340387257504e-05,1.3975656821362803e-05,14,6,8
12904,UNRWA,6.496483935243052e-06,1.7253897310324457e-07,4,4,0
12905,UNbacked,4.400843956132392e-06,3.6233184351681345e-06,7,3,4
12906,UNrun,2.3052039770217305e-06,1.8979287041356905e-06,3,2,1
12907,UPDATE,4.002672360101368e-05,3.8131113055817005e-05,46,19,27
12908,UPDATED,6.496483935243052e-06,1.052487735929791e-05,11,5,6
12909,URGENT,4.400843956132392e-06,1.7253897310324457e-07,3,3,0
12910,URL,2.095639979110664e-07,1.052487735929791e-05,6,0,6
12911,US,2.7452883726349685e-05,2.087721574549256e-05,26,13,13
12912,USA,9.660900303700153e-05,8.4716635793693e-05,109,51,58
12913,USAF,8.592123914353715e-06,1.8979287041356905e-06,5,4,1
12914,USAID,2.3052039770217305e-06,3.6233184351681345e-06,5,1,4
12915,USB,1.0687763893464371e-05,3.6233184351681345e-06,7,5,2
12916,USBacked,4.400843956132392e-06,5.348708166200577e-06,5,2,3
12917,USC,2.3052039770217305e-06,7.074097897233022e-06,8,1,7
12918,USCanada,2.095639979110664e-07,7.074097897233022e-06,4,0,4
12919,USChina,2.3052039770217305e-06,5.348708166200577e-06,4,1,3
12920,USCuba,8.592123914353715e-06,3.6233184351681345e-06,6,4,2
12921,USD,2.5357243747239038e-05,1.742643628342769e-05,22,12,10
12922,USDA,6.496483935243052e-06,1.052487735929791e-05,11,3,8
12923,USEU,4.400843956132392e-06,1.7253897310324457e-07,3,2,1
12924,USG,4.400843956132392e-06,1.8979287041356905e-06,3,2,1
12925,USIran,2.3052039770217305e-06,5.348708166200577e-06,4,1,3
12926,USIsrael,2.3052039770217305e-06,5.348708166200577e-06,4,1,3
12927,USIsraeli,2.3052039770217305e-06,5.348708166200577e-06,4,1,3
12928,USLed,2.3052039770217305e-06,3.6233184351681345e-06,3,1,2
12929,USMade,2.3052039770217305e-06,5.348708166200577e-06,4,1,3
12930,USMexico,2.116596378901769e-05,1.570104655239525e-05,20,11,9
12931,USNATO,4.400843956132392e-06,1.8979287041356905e-06,3,2,1
12932,USRussia,1.48790438516857e-05,1.8979287041356905e-06,8,7,1
12933,USSR,1.278340387257504e-05,5.348708166200577e-06,10,6,4
12934,USSouth,2.095639979110664e-07,7.074097897233022e-06,4,0,4
12935,USW,2.095639979110664e-07,7.074097897233022e-06,4,0,4
12936,USbacked,6.496483935243052e-06,1.3975656821362803e-05,12,4,8
12937,USbased,6.496483935243052e-06,7.074097897233022e-06,8,4,4
12938,USbound,4.400843956132392e-06,5.348708166200577e-06,5,2,3
12939,USled,3.583544364279237e-05,3.640572332478458e-05,38,17,21
12940,USmade,6.496483935243052e-06,5.348708166200577e-06,6,3,3
12941,USowned,2.095639979110664e-07,5.348708166200577e-06,3,0,3
12942,UStrained,6.496483935243052e-06,7.074097897233022e-06,7,3,4
12943,UT,2.3052039770217305e-06,3.6233184351681345e-06,3,1,2
12944,UVA,4.400843956132392e-06,3.6233184351681345e-06,5,3,2
12945,Uber,0.00019510408205520246,0.00020376852723493182,223,99,124
12946,Uboat,2.095639979110664e-07,5.348708166200577e-06,3,0,3
12947,Udall,4.400843956132392e-06,8.79948762826546e-06,7,2,5
12948,Uganda,7.146132328767358e-05,0.00010024514337298497,99,37,62
12949,Ugandan,2.116596378901769e-05,4.8483451442011706e-05,39,10,29
12950,Ugliest,6.496483935243052e-06,1.8979287041356905e-06,4,3,1
12951,Ugly,2.326160376812834e-05,2.2602605476525032e-05,28,13,15
12952,Uh,1.0687763893464371e-05,8.79948762826546e-06,11,5,6
12953,Uighur,1.48790438516857e-05,1.052487735929791e-05,14,7,7
12954,Uk,6.496483935243052e-06,3.6233184351681345e-06,7,5,2
12955,Ukraine,0.0006561448774595484,0.0006454682983792376,777,350,427
12956,Ukrainian,0.00020348664197164515,0.00014683066611086105,208,115,93
12957,Ukranian,2.095639979110664e-07,7.074097897233022e-06,4,0,4
12958,Ultimate,1.6974683830796368e-05,1.742643628342769e-05,19,9,10
12959,Ultimately,2.095639979110664e-07,8.79948762826546e-06,6,0,6
12960,Ultra,4.400843956132392e-06,5.348708166200577e-06,5,2,3
12961,UltraConservative,4.400843956132392e-06,1.8979287041356905e-06,3,2,1
12962,UltraOrthodox,8.592123914353715e-06,7.074097897233022e-06,9,4,5
12963,Ultrasound,2.3052039770217305e-06,3.6233184351681345e-06,3,1,2
12964,Um,2.095639979110664e-07,3.6233184351681345e-06,3,0,3
12965,Umbrella,2.3052039770217305e-06,3.6233184351681345e-06,3,1,2
12966,Umm,4.400843956132392e-06,1.8979287041356905e-06,3,2,1
12967,Un,5.050492349656699e-05,7.608968713853079e-05,72,25,47
12968,UnAmerican,8.592123914353715e-06,3.6233184351681345e-06,6,4,2
12969,Unable,8.592123914353715e-06,3.6233184351681345e-06,7,4,3
12970,Unacceptable,4.400843956132392e-06,5.348708166200577e-06,9,2,7
12971,Unanimously,1.0687763893464371e-05,1.8979287041356905e-06,7,5,2
12972,Unanswered,2.3052039770217305e-06,5.348708166200577e-06,4,1,3
12973,Unaoil,4.400843956132392e-06,1.8979287041356905e-06,4,3,1
12974,Unarmed,1.0687763893464371e-05,1.742643628342769e-05,17,7,10
12975,Unauthorized,1.0687763893464371e-05,1.8979287041356905e-06,7,5,2
12976,Unbearable,2.095639979110664e-07,5.348708166200577e-06,4,0,4
12977,Unbelievable,1.278340387257504e-05,8.79948762826546e-06,13,7,6
12978,Unblock,2.3052039770217305e-06,3.6233184351681345e-06,4,1,3
12979,Uncensored,4.400843956132392e-06,1.8979287041356905e-06,3,2,1
12980,Uncertain,4.400843956132392e-06,3.6233184351681345e-06,5,2,3
12981,Uncertainty,1.278340387257504e-05,1.2250267090330355e-05,14,7,7
12982,Uncharted,4.400843956132392e-06,7.074097897233022e-06,6,2,4
12983,Uncle,8.592123914353715e-06,2.9504164400654783e-05,23,4,19
12984,Unclear,8.592123914353715e-06,7.074097897233022e-06,8,4,4
12985,Uncomfortable,2.3052039770217305e-06,3.6233184351681345e-06,4,1,3
12986,Unconfirmed,6.496483935243052e-06,1.8979287041356905e-06,4,3,1
12987,Unconstitutional,2.7452883726349685e-05,2.9504164400654783e-05,33,14,19
12988,Uncontacted,2.3052039770217305e-06,3.6233184351681345e-06,3,1,2
12989,Uncover,2.095639979110664e-07,1.2250267090330355e-05,8,0,8
12990,Uncovered,8.592123914353715e-06,1.2250267090330355e-05,12,4,8
12991,Uncut,2.095639979110664e-07,5.348708166200577e-06,3,0,3
12992,Undecided,1.6974683830796368e-05,7.074097897233022e-06,13,8,5
12993,Underage,4.400843956132392e-06,1.8979287041356905e-06,4,3,1
12994,Underappreciated,4.400843956132392e-06,1.8979287041356905e-06,3,2,1
12995,Undercover,1.278340387257504e-05,1.052487735929791e-05,15,8,7
12996,Undercut,2.3052039770217305e-06,3.6233184351681345e-06,5,3,2
12997,Underdog,2.095639979110664e-07,5.348708166200577e-06,3,0,3
12998,Underestimated,2.3052039770217305e-06,5.348708166200577e-06,4,1,3
12999,Underfunded,2.3052039770217305e-06,1.8979287041356905e-06,3,1,2
13000,Undergo,2.3052039770217305e-06,1.8979287041356905e-06,3,1,2
13001,Underground,1.48790438516857e-05,1.3975656821362803e-05,17,7,10
13002,Undermine,1.0687763893464371e-05,2.2602605476525032e-05,21,7,14
13003,Undermining,2.3052039770217305e-06,5.348708166200577e-06,5,1,4
13004,Undersea,2.3052039770217305e-06,3.6233184351681345e-06,3,1,2
13005,Underserved,4.400843956132392e-06,5.348708166200577e-06,5,2,3
13006,Understand,2.5357243747239038e-05,3.985650278684949e-05,40,17,23
13007,Understanding,1.6974683830796368e-05,1.3975656821362803e-05,20,11,9
13008,Underwater,1.0687763893464371e-05,1.570104655239525e-05,14,5,9
13009,Underwhelming,2.095639979110664e-07,5.348708166200577e-06,3,0,3
13010,Underwood,6.496483935243052e-06,1.7253897310324457e-07,4,4,0
13011,Undisclosed,2.3052039770217305e-06,3.6233184351681345e-06,3,1,2
13012,Undo,4.400843956132392e-06,1.3975656821362803e-05,10,2,8
13013,Undocumented,5.050492349656699e-05,6.228656929027126e-05,63,25,38
13014,Undoing,2.3052039770217305e-06,3.6233184351681345e-06,3,1,2
13015,Unearth,2.3052039770217305e-06,1.8979287041356905e-06,4,2,2
13016,Unearthed,1.6974683830796368e-05,8.79948762826546e-06,13,8,5
13017,Uneasy,4.400843956132392e-06,3.6233184351681345e-06,4,2,2
13018,Unemployed,4.400843956132392e-06,2.087721574549256e-05,16,4,12
13019,Unemployment,4.840928351745632e-05,5.5385010366141504e-05,60,25,35
13020,Unendorse,6.496483935243052e-06,1.7253897310324457e-07,3,3,0
13021,Unequal,6.496483935243052e-06,3.6233184351681345e-06,5,3,2
13022,Unesco,1.6974683830796368e-05,1.2250267090330355e-05,15,8,7
13023,Unethical,6.496483935243052e-06,3.6233184351681345e-06,5,3,2
13024,Unexpected,1.48790438516857e-05,8.79948762826546e-06,15,8,7
13025,Unexpectedly,4.400843956132392e-06,5.348708166200577e-06,5,2,3
13026,Unfair,1.9070323809907035e-05,1.2250267090330355e-05,19,9,10
13027,Unfairly,4.400843956132392e-06,1.8979287041356905e-06,3,2,1
13028,Unfit,4.400843956132392e-06,1.052487735929791e-05,9,3,6
13029,Unfortunate,1.0687763893464371e-05,1.7253897310324457e-07,6,5,1
13030,Unfortunately,3.7931083621902995e-05,3.640572332478458e-05,45,19,26
13031,Unhappy,6.496483935243052e-06,1.2250267090330355e-05,11,3,8
13032,Unhinged,6.496483935243052e-06,7.074097897233022e-06,8,3,5
13033,Unicef,2.3052039770217305e-06,5.348708166200577e-06,5,1,4
13034,Unicorn,6.496483935243052e-06,7.074097897233022e-06,8,4,4
13035,Unidentified,4.400843956132392e-06,5.348708166200577e-06,6,2,4
13036,Unification,2.3052039770217305e-06,3.6233184351681345e-06,3,1,2
13037,Unified,4.400843956132392e-06,5.348708166200577e-06,5,2,3
13038,Uniform,2.3052039770217305e-06,7.074097897233022e-06,6,2,4
13039,Unifying,4.400843956132392e-06,3.6233184351681345e-06,4,2,2
13040,Unilateral,2.3052039770217305e-06,1.8979287041356905e-06,3,1,2
13041,Unilaterally,2.3052039770217305e-06,5.348708166200577e-06,4,1,3
13042,Unilever,2.3052039770217305e-06,5.348708166200577e-06,4,1,3
13043,Unimaginable,2.095639979110664e-07,7.074097897233022e-06,5,1,4
13044,Unimpressed,2.3052039770217305e-06,5.348708166200577e-06,4,1,3
13045,Uninsured,2.326160376812834e-05,5.348708166200577e-06,18,11,7
13046,Union,0.0004130506398827114,0.0003814836695312734,457,218,239
13047,UnionBusting,4.400843956132392e-06,3.6233184351681345e-06,4,2,2
13048,Unionize,1.0687763893464371e-05,1.2250267090330355e-05,15,7,8
13049,Unionizing,4.400843956132392e-06,5.348708166200577e-06,5,2,3
13050,Unique,1.0687763893464371e-05,1.2250267090330355e-05,14,5,9
13051,Uniquely,2.3052039770217305e-06,1.8979287041356905e-06,3,1,2
13052,Unit,1.6974683830796368e-05,2.2602605476525032e-05,27,10,17
13053,Unite,1.6974683830796368e-05,8.79948762826546e-06,16,9,7
13054,United,0.0007902658361226308,0.0007645201898204765,911,411,500
13055,Uniting,2.095639979110664e-07,5.348708166200577e-06,3,0,3
13056,Unity,2.116596378901769e-05,3.468033359375216e-05,30,10,20
13057,Universal,1.0687763893464371e-05,7.074097897233022e-06,13,8,5
13058,Universe,2.7452883726349685e-05,3.985650278684949e-05,39,14,25
13059,University,0.00024330380157474795,0.0002607063883590024,293,126,167
13060,Univision,2.3052039770217305e-06,7.074097897233022e-06,5,1,4
13061,Unknown,1.9070323809907035e-05,1.9151826014460126e-05,23,10,13
13062,Unlawful,8.592123914353715e-06,5.348708166200577e-06,7,4,3
13063,Unleash,1.278340387257504e-05,1.742643628342769e-05,16,6,10
13064,Unleashed,2.095639979110664e-07,3.6233184351681345e-06,4,1,3
13065,Unleashing,2.3052039770217305e-06,5.348708166200577e-06,5,2,3
13066,Unles,3.7931083621902995e-05,4.330728224891437e-05,46,19,27
13067,Unlike,2.116596378901769e-05,2.087721574549256e-05,26,13,13
13068,Unlikely,1.278340387257504e-05,2.4327995207557487e-05,22,8,14
13069,Unlimited,6.496483935243052e-06,5.348708166200577e-06,7,4,3
13070,Unload,2.3052039770217305e-06,1.8979287041356905e-06,3,1,2
13071,Unlock,2.095639979110664e-07,8.79948762826546e-06,8,2,6
13072,Unlocking,2.3052039770217305e-06,3.6233184351681345e-06,4,2,2
13073,Unmanned,4.400843956132392e-06,3.6233184351681345e-06,5,3,2
13074,Unmarried,2.3052039770217305e-06,5.348708166200577e-06,5,1,4
13075,Unmasked,4.400843956132392e-06,1.7253897310324457e-07,3,2,1
13076,Unmoved,4.400843956132392e-06,3.6233184351681345e-06,4,2,2
13077,Unnamed,4.400843956132392e-06,1.8979287041356905e-06,3,2,1
13078,Unnecessary,8.592123914353715e-06,1.7253897310324457e-07,4,4,0
13079,Unofficial,2.3052039770217305e-06,8.79948762826546e-06,6,1,5
13080,Unpaid,1.48790438516857e-05,1.3975656821362803e-05,18,9,9
13081,Unplug,4.400843956132392e-06,3.6233184351681345e-06,4,2,2
13082,Unpopular,1.0687763893464371e-05,1.2250267090330355e-05,14,5,9
13083,Unprecedented,2.954852370546031e-05,1.9151826014460126e-05,30,15,15
13084,Unpredictable,2.095639979110664e-07,1.8979287041356905e-06,3,0,3
13085,Unprepared,4.400843956132392e-06,1.7253897310324457e-07,3,2,1
13086,Unproven,2.3052039770217305e-06,5.348708166200577e-06,4,1,3
13087,Unravel,8.592123914353715e-06,7.074097897233022e-06,9,4,5
13088,Unraveling,2.3052039770217305e-06,3.6233184351681345e-06,3,1,2
13089,Unregulated,2.095639979110664e-07,5.348708166200577e-06,3,0,3
13090,Unreliable,4.400843956132392e-06,1.8979287041356905e-06,3,2,1
13091,Unreported,2.3052039770217305e-06,1.8979287041356905e-06,3,1,2
13092,Unrest,1.278340387257504e-05,1.3975656821362803e-05,17,8,9
13093,Unruly,2.3052039770217305e-06,5.348708166200577e-06,4,1,3
13094,Unseat,4.400843956132392e-06,3.6233184351681345e-06,4,2,2
13095,Unseen,2.095639979110664e-07,1.8979287041356905e-06,3,2,1
13096,Unsold,2.3052039770217305e-06,3.6233184351681345e-06,3,1,2
13097,Unspeakable,4.400843956132392e-06,1.8979287041356905e-06,3,2,1
13098,Unstoppable,4.400843956132392e-06,1.8979287041356905e-06,4,3,1
13099,Unsung,6.496483935243052e-06,7.074097897233022e-06,8,4,4
13100,Unsure,2.3052039770217305e-06,8.79948762826546e-06,7,2,5
13101,Unsuspecting,2.3052039770217305e-06,3.6233184351681345e-06,3,1,2
13102,Unthinkable,2.3052039770217305e-06,1.8979287041356905e-06,3,1,2
13103,Untold,4.400843956132392e-06,7.074097897233022e-06,6,2,4
13104,Untouchable,1.278340387257504e-05,7.074097897233022e-06,10,6,4
13105,Unusual,1.48790438516857e-05,2.087721574549256e-05,19,7,12
13106,Unusually,2.3052039770217305e-06,1.8979287041356905e-06,3,2,1
13107,Unvaccinated,4.400843956132392e-06,5.348708166200577e-06,7,2,5
13108,Unveil,3.583544364279237e-05,3.2954943862719716e-05,42,19,23
13109,Unveiled,8.592123914353715e-06,1.052487735929791e-05,10,4,6
13110,Unveiling,2.3052039770217305e-06,1.7253897310324457e-07,3,1,2
13111,Unwanted,4.400843956132392e-06,8.79948762826546e-06,9,2,7
13112,Unwelcome,6.496483935243052e-06,5.348708166200577e-06,6,3,3
13113,Up,6.496483935243052e-06,1.2250267090330355e-05,14,4,10
13114,Upcoming,1.6974683830796368e-05,1.052487735929791e-05,16,8,8
13115,Update,4.4218003559234974e-05,6.401195902130366e-05,69,26,43
13116,Updated,6.496483935243052e-06,5.348708166200577e-06,8,5,3
13117,Upgrade,1.6974683830796368e-05,1.052487735929791e-05,15,9,6
13118,Upheld,4.400843956132392e-06,5.348708166200577e-06,5,2,3
13119,Uphill,2.095639979110664e-07,3.6233184351681345e-06,4,0,4
13120,Uphold,1.9070323809907035e-05,1.742643628342769e-05,22,10,12
13121,Upholding,2.095639979110664e-07,5.348708166200577e-06,3,0,3
13122,Upon,1.6974683830796368e-05,1.2250267090330355e-05,18,8,10
13123,Upper,4.400843956132392e-06,1.052487735929791e-05,8,2,6
13124,Uprising,2.116596378901769e-05,1.052487735929791e-05,18,11,7
13125,Uproar,1.48790438516857e-05,8.79948762826546e-06,14,8,6
13126,Upset,1.6974683830796368e-05,1.3975656821362803e-05,18,9,9
13127,Upside,8.592123914353715e-06,5.348708166200577e-06,8,5,3
13128,Uptick,2.095639979110664e-07,3.6233184351681345e-06,3,0,3
13129,Upton,6.496483935243052e-06,1.8979287041356905e-06,4,3,1
13130,Upward,2.3052039770217305e-06,5.348708166200577e-06,4,1,3
13131,Ural,6.496483935243052e-06,1.7253897310324457e-07,3,3,0
13132,Uranium,6.496483935243052e-06,1.2250267090330355e-05,13,5,8
13133,Urban,2.326160376812834e-05,3.640572332478458e-05,35,13,22
13134,Urge,9.03220830996695e-05,0.0001347529379936339,134,49,85
13135,Urged,1.48790438516857e-05,1.2250267090330355e-05,15,8,7
13136,Urgency,4.400843956132392e-06,1.8979287041356905e-06,3,2,1
13137,Urgent,1.48790438516857e-05,1.570104655239525e-05,16,7,9
13138,Urging,6.496483935243052e-06,1.052487735929791e-05,9,3,6
13139,Uri,2.3052039770217305e-06,3.6233184351681345e-06,3,1,2
13140,Urine,1.0687763893464371e-05,1.7253897310324457e-07,5,5,0
13141,Uruguay,3.7931083621902995e-05,3.640572332478458e-05,52,22,30
13142,Uruguayan,2.095639979110664e-07,5.348708166200577e-06,3,0,3
13143,Urumqi,6.496483935243052e-06,3.6233184351681345e-06,7,3,4
13144,Use,0.00027892968121962896,0.0002400017115866128,307,148,159
13145,Used,8.193952318322689e-05,0.00012267520987640663,126,50,76
13146,Useles,2.3052039770217305e-06,3.6233184351681345e-06,3,1,2
13147,User,9.870464301611217e-05,0.00011232287149021227,121,49,72
13148,Usher,2.3052039770217305e-06,7.074097897233022e-06,6,2,4
13149,Using,0.00011756540282810809,0.00012612598933847184,148,65,83
13150,Usual,1.278340387257504e-05,7.074097897233022e-06,11,7,4
13151,Usually,2.3052039770217305e-06,5.348708166200577e-06,6,2,4
13152,Utah,5.4696203454788295e-05,6.918812821440096e-05,74,30,44
13153,Utility,1.0687763893464371e-05,2.087721574549256e-05,17,5,12
13154,Uttar,2.3052039770217305e-06,1.8979287041356905e-06,3,1,2
13155,Utter,8.592123914353715e-06,1.8979287041356905e-06,5,4,1
13156,Utterly,4.400843956132392e-06,5.348708166200577e-06,7,4,3
13157,Uturn,4.400843956132392e-06,1.8979287041356905e-06,4,3,1
13158,Utya,4.400843956132392e-06,1.8979287041356905e-06,4,3,1
13159,Uvalde,1.0687763893464371e-05,7.074097897233022e-06,12,5,7
13160,Uyghur,2.095639979110664e-07,1.2250267090330355e-05,7,0,7
13161,Uzbek,2.3052039770217305e-06,5.348708166200577e-06,4,1,3
13162,Uzbekistan,1.0687763893464371e-05,1.3975656821362803e-05,13,5,8
13163,VA,3.1644163684570994e-05,4.50326719799468e-05,44,17,27
13164,VI,2.3052039770217305e-06,1.8979287041356905e-06,4,1,3
13165,VICE,1.6974683830796368e-05,5.348708166200577e-06,11,8,3
13166,VID,4.400843956132392e-06,8.79948762826546e-06,8,3,5
13167,VIDEO,8.613080314144832e-05,7.091351794543343e-05,93,47,46
13168,VIP,1.0687763893464371e-05,1.2250267090330355e-05,14,5,9
13169,VKontakte,4.400843956132392e-06,3.6233184351681345e-06,5,3,2
13170,VP,4.4218003559234974e-05,8.126585633162811e-05,71,23,48
13171,VPN,1.48790438516857e-05,5.348708166200577e-06,11,7,4
13172,VR,1.0687763893464371e-05,5.348708166200577e-06,8,5,3
13173,VW,2.5357243747239038e-05,1.9151826014460126e-05,30,18,12
13174,Va,4.400843956132392e-06,3.6233184351681345e-06,4,2,2
13175,Vacancy,1.48790438516857e-05,1.3975656821362803e-05,15,7,8
13176,Vacant,2.095639979110664e-07,7.074097897233022e-06,4,0,4
13177,Vacation,1.6974683830796368e-05,1.3975656821362803e-05,20,11,9
13178,Vaccinated,4.400843956132392e-06,5.348708166200577e-06,6,3,3
13179,Vaccination,1.9070323809907035e-05,1.742643628342769e-05,23,10,13
13180,Vaccine,7.984388320411623e-05,5.3659620635109e-05,79,41,38
13181,Vacuum,2.3052039770217305e-06,3.6233184351681345e-06,3,1,2
13182,Vader,4.400843956132392e-06,5.348708166200577e-06,5,2,3
13183,Vagina,2.3052039770217305e-06,3.6233184351681345e-06,3,1,2
13184,Vague,2.3052039770217305e-06,1.570104655239525e-05,10,1,9
13185,Valdez,4.400843956132392e-06,1.8979287041356905e-06,4,2,2
13186,Vale,4.400843956132392e-06,1.8979287041356905e-06,3,2,1
13187,Valentine,8.592123914353715e-06,2.6053384938589907e-05,20,4,16
13188,Vall,4.400843956132392e-06,3.6233184351681345e-06,4,2,2
13189,Valley,9.24177230787802e-05,7.091351794543343e-05,96,48,48
13190,Valor,2.3052039770217305e-06,3.6233184351681345e-06,3,1,2
13191,Valuable,4.400843956132392e-06,8.79948762826546e-06,7,2,5
13192,Value,4.002672360101368e-05,5.1934230904076595e-05,53,21,32
13193,Valued,8.592123914353715e-06,1.7253897310324457e-07,4,4,0
13194,Vampire,2.3052039770217305e-06,5.348708166200577e-06,5,1,4
13195,Van,2.954852370546031e-05,3.640572332478458e-05,37,14,23
13196,Vance,4.400843956132392e-06,1.3975656821362803e-05,10,2,8
13197,Vancouver,4.6313643538345614e-05,4.8483451442011706e-05,56,23,33
13198,Vandal,2.3052039770217305e-06,3.6233184351681345e-06,4,2,2
13199,Vandalism,4.400843956132392e-06,3.6233184351681345e-06,4,2,2
13200,Vandalized,1.0687763893464371e-05,1.7253897310324457e-07,5,5,0
13201,Vanessa,4.400843956132392e-06,7.074097897233022e-06,7,2,5
13202,Vanish,4.400843956132392e-06,7.074097897233022e-06,6,2,4
13203,Vanished,2.3052039770217305e-06,5.348708166200577e-06,6,1,5
13204,Vanishing,2.3052039770217305e-06,1.8979287041356905e-06,3,1,2
13205,Vanity,8.592123914353715e-06,7.074097897233022e-06,8,4,4
13206,Vanuatu,2.3052039770217305e-06,7.074097897233022e-06,5,1,4
13207,Vanunu,8.592123914353715e-06,7.074097897233022e-06,9,4,5
13208,Varga,2.095639979110664e-07,7.074097897233022e-06,5,1,4
13209,Variable,2.095639979110664e-07,3.6233184351681345e-06,3,1,2
13210,Variant,2.3052039770217305e-06,1.8979287041356905e-06,4,1,3
13211,Varoufaki,6.496483935243052e-06,1.8979287041356905e-06,4,3,1
13212,Vary,2.3052039770217305e-06,5.348708166200577e-06,4,1,3
13213,Vast,1.278340387257504e-05,1.570104655239525e-05,17,6,11
13214,Vastly,2.095639979110664e-07,7.074097897233022e-06,5,0,5
13215,Vatican,0.00019300844207609195,0.00017788768126944505,214,98,116
13216,Vaughn,8.592123914353715e-06,1.7253897310324457e-07,4,4,0
13217,Vault,6.496483935243052e-06,1.8979287041356905e-06,4,3,1
13218,Veep,2.3052039770217305e-06,8.79948762826546e-06,6,1,5
13219,Veepstake,2.095639979110664e-07,5.348708166200577e-06,3,0,3
13220,Vega,6.307876337123095e-05,8.816741525575797e-05,92,37,55
13221,Vegan,4.400843956132392e-06,1.8979287041356905e-06,3,2,1
13222,Vegetable,1.278340387257504e-05,1.7253897310324457e-07,6,6,0
13223,Vegetarian,4.400843956132392e-06,1.8979287041356905e-06,3,2,1
13224,Vehicle,2.116596378901769e-05,2.9504164400654783e-05,31,13,18
13225,Veil,8.592123914353715e-06,1.570104655239525e-05,13,4,9
13226,Vendor,4.400843956132392e-06,1.052487735929791e-05,8,2,6
13227,Venezuela,0.00021396484186719832,0.0001847892401935746,239,118,121
13228,Venezuelan,4.840928351745632e-05,5.711040009717395e-05,63,25,38
13229,Venice,8.592123914353715e-06,1.742643628342769e-05,14,4,10
13230,Venmo,4.400843956132392e-06,3.6233184351681345e-06,4,2,2
13231,Venture,1.6974683830796368e-05,5.348708166200577e-06,12,9,3
13232,Venu,1.0687763893464371e-05,7.074097897233022e-06,9,5,4
13233,Veracruz,6.496483935243052e-06,1.8979287041356905e-06,4,3,1
13234,Verdict,1.48790438516857e-05,8.79948762826546e-06,12,7,5
13235,Verge,8.592123914353715e-06,1.3975656821362803e-05,12,4,8
13236,Verify,8.592123914353715e-06,1.8979287041356905e-06,5,4,1
13237,Verita,2.3052039770217305e-06,3.6233184351681345e-06,3,1,2
13238,Verizon,5.260056347567764e-05,3.985650278684949e-05,50,25,25
13239,Vermont,6.098312339212028e-05,5.883578982820635e-05,68,29,39
13240,Vernon,8.592123914353715e-06,1.8979287041356905e-06,5,4,1
13241,Versa,2.3052039770217305e-06,3.6233184351681345e-06,3,1,2
13242,Verse,6.496483935243052e-06,1.7253897310324457e-07,3,3,0
13243,Version,2.5357243747239038e-05,1.570104655239525e-05,22,12,10
13244,Versu,1.0687763893464371e-05,8.79948762826546e-06,11,6,5
13245,Very,2.3052039770217305e-06,7.074097897233022e-06,5,1,4
13246,Vessel,2.3052039770217305e-06,1.2250267090330355e-05,8,1,7
13247,Vest,2.3052039770217305e-06,3.6233184351681345e-06,3,1,2
13248,Vet,4.4218003559234974e-05,4.6758061710979285e-05,52,25,27
13249,Veteran,0.00012385232276544028,0.00016926073261428268,186,74,112
13250,Veto,4.212236358012434e-05,2.777877466962238e-05,42,24,18
13251,Vetted,2.095639979110664e-07,5.348708166200577e-06,3,0,3
13252,Vetting,1.0687763893464371e-05,7.074097897233022e-06,9,5,4
13253,Via,8.592123914353715e-06,1.570104655239525e-05,13,4,9
13254,Viacom,2.3052039770217305e-06,7.074097897233022e-06,5,1,4
13255,Viagra,1.0687763893464371e-05,1.3975656821362803e-05,15,7,8
13256,Viber,4.400843956132392e-06,1.8979287041356905e-06,3,2,1
13257,Vice,6.72700433294523e-05,8.816741525575797e-05,91,35,56
13258,VicePresident,2.095639979110664e-07,7.074097897233022e-06,4,0,4
13259,Vicente,1.6974683830796368e-05,7.074097897233022e-06,15,10,5
13260,Viciou,8.592123914353715e-06,1.052487735929791e-05,10,4,6
13261,Victim,0.0002097735619089774,0.00017788768126944505,229,114,115
13262,Victimized,2.095639979110664e-07,5.348708166200577e-06,3,0,3
13263,Victor,2.3052039770217305e-06,5.348708166200577e-06,4,1,3
13264,Victoria,3.1644163684570994e-05,2.4327995207557487e-05,32,17,15
13265,Victorian,1.278340387257504e-05,7.074097897233022e-06,10,6,4
13266,Victory,8.613080314144832e-05,0.00011922443041434203,120,46,74
13267,Vid,6.496483935243052e-06,1.052487735929791e-05,9,3,6
13268,Vidal,6.496483935243052e-06,1.8979287041356905e-06,4,3,1
13269,Videla,2.095639979110664e-07,1.8979287041356905e-06,3,0,3
13270,Video,0.00030617300094806777,0.0003038411316348131,369,163,206
13271,Vienna,6.496483935243052e-06,7.074097897233022e-06,8,3,5
13272,Vietnam,0.00011127848289077625,0.00012267520987640663,138,59,79
13273,Vietnamese,2.954852370546031e-05,3.2954943862719716e-05,36,17,19
13274,View,8.403516316233764e-05,8.4716635793693e-05,103,48,55
13275,Viewed,2.3052039770217305e-06,5.348708166200577e-06,4,1,3
13276,Viewer,2.116596378901769e-05,7.074097897233022e-06,15,10,5
13277,Viewing,4.400843956132392e-06,1.8979287041356905e-06,5,4,1
13278,Vigil,1.0687763893464371e-05,5.348708166200577e-06,8,5,3
13279,Vigilante,1.48790438516857e-05,1.052487735929791e-05,13,7,6
13280,Viking,1.0687763893464371e-05,2.087721574549256e-05,20,6,14
13281,Viktor,2.5357243747239038e-05,1.2250267090330355e-05,23,14,9
13282,Villa,2.3052039770217305e-06,1.8979287041356905e-06,3,1,2
13283,Village,2.326160376812834e-05,4.330728224891437e-05,42,14,28
13284,Villager,1.278340387257504e-05,8.79948762826546e-06,12,7,5
13285,Villain,6.496483935243052e-06,3.6233184351681345e-06,5,3,2
13286,Vilsack,2.3052039770217305e-06,3.6233184351681345e-06,3,1,2
13287,Vince,4.400843956132392e-06,5.348708166200577e-06,5,2,3
13288,Vincent,4.400843956132392e-06,8.79948762826546e-06,9,3,6
13289,Vinci,1.0687763893464371e-05,5.348708166200577e-06,8,5,3
13290,Violate,2.5357243747239038e-05,2.087721574549256e-05,29,13,16
13291,Violated,8.592123914353715e-06,1.570104655239525e-05,13,4,9
13292,Violating,1.48790438516857e-05,8.79948762826546e-06,15,9,6
13293,Violation,3.1644163684570994e-05,1.742643628342769e-05,26,15,11
13294,Violence,0.00021186920188808795,0.0002020431375038992,244,118,126
13295,Violent,4.840928351745632e-05,5.1934230904076595e-05,61,27,34
13296,Viral,3.1644163684570994e-05,4.6758061710979285e-05,48,20,28
13297,Virgin,3.3739803663681634e-05,3.468033359375216e-05,40,18,22
13298,Virginia,0.00016157384238943198,0.00025898099862796983,258,93,165
13299,Virginian,4.400843956132392e-06,7.074097897233022e-06,6,2,4
13300,Virginity,6.496483935243052e-06,7.074097897233022e-06,7,3,4
13301,Virtual,2.7452883726349685e-05,1.052487735929791e-05,21,14,7
13302,Virtually,4.400843956132392e-06,1.2250267090330355e-05,11,4,7
13303,Viru,4.840928351745632e-05,3.122955413168725e-05,48,25,23
13304,Virunga,6.496483935243052e-06,1.8979287041356905e-06,5,3,2
13305,Virus,4.400843956132392e-06,1.8979287041356905e-06,4,2,2
13306,Visa,2.954852370546031e-05,3.2954943862719716e-05,40,17,23
13307,Visible,2.095639979110664e-07,3.6233184351681345e-06,3,1,2
13308,Vision,1.9070323809907035e-05,2.2602605476525032e-05,26,11,15
13309,Visit,0.00010708720293255492,0.0001036959228350498,123,58,65
13310,Visited,8.592123914353715e-06,3.6233184351681345e-06,6,4,2
13311,Visiting,6.496483935243052e-06,1.570104655239525e-05,12,3,9
13312,Visitor,1.48790438516857e-05,5.348708166200577e-06,13,7,6
13313,Visual,2.095639979110664e-07,7.074097897233022e-06,5,1,4
13314,Visualizing,2.3052039770217305e-06,1.7253897310324457e-07,3,3,0
13315,Vital,8.592123914353715e-06,1.3975656821362803e-05,13,4,9
13316,Vitter,6.496483935243052e-06,7.074097897233022e-06,7,3,4
13317,Viva,2.3052039770217305e-06,3.6233184351681345e-06,3,1,2
13318,Vivek,2.095639979110664e-07,5.348708166200577e-06,3,0,3
13319,Viviane,2.095639979110664e-07,5.348708166200577e-06,3,0,3
13320,Vladimir,0.00022234740178364096,0.00017616229153841266,230,114,116
13321,Vocal,4.400843956132392e-06,3.6233184351681345e-06,4,2,2
13322,Vodafone,2.3052039770217305e-06,1.2250267090330355e-05,8,1,7
13323,Vodka,4.400843956132392e-06,3.6233184351681345e-06,4,2,2
13324,Vogue,8.592123914353715e-06,7.074097897233022e-06,8,4,4
13325,Voice,5.260056347567764e-05,5.020884117304414e-05,60,28,32
13326,Void,2.095639979110664e-07,5.348708166200577e-06,4,0,4
13327,Volatile,2.095639979110664e-07,5.348708166200577e-06,4,1,3
13328,Volcanic,2.3052039770217305e-06,7.074097897233022e-06,5,1,4
13329,Volcano,1.278340387257504e-05,3.122955413168725e-05,26,7,19
13330,Volkswagen,5.4696203454788295e-05,4.50326719799468e-05,58,29,29
13331,Voltaire,6.496483935243052e-06,1.7253897310324457e-07,3,3,0
13332,Volume,2.095639979110664e-07,7.074097897233022e-06,4,0,4
13333,Voluntary,2.3052039770217305e-06,8.79948762826546e-06,7,1,6
13334,Volunteer,2.326160376812834e-05,3.985650278684949e-05,41,15,26
13335,Volunteering,8.592123914353715e-06,8.79948762826546e-06,9,4,5
13336,Volvo,2.3052039770217305e-06,5.348708166200577e-06,4,1,3
13337,Vomit,2.3052039770217305e-06,3.6233184351681345e-06,4,1,3
13338,Vote,0.0004989718790262485,0.00040908990522779264,529,265,264
13339,Voted,3.3739803663681634e-05,6.056117955923882e-05,54,18,36
13340,Voter,0.0004926849590889169,0.0004867324431242528,576,261,315
13341,Voting,0.0001741476822640959,0.0001951415785797695,222,92,130
13342,Voucher,2.095639979110664e-07,7.074097897233022e-06,4,0,4
13343,Vow,9.870464301611217e-05,7.954046660059569e-05,99,49,50
13344,Vowed,4.400843956132392e-06,7.074097897233022e-06,7,3,4
13345,Vu,4.400843956132392e-06,1.8979287041356905e-06,4,2,2
13346,Vulgar,4.400843956132392e-06,3.6233184351681345e-06,4,2,2
13347,Vulnerability,2.3052039770217305e-06,3.6233184351681345e-06,3,1,2
13348,Vulnerable,2.5357243747239038e-05,2.087721574549256e-05,28,12,16
13349,Vulture,2.095639979110664e-07,3.6233184351681345e-06,4,2,2
13350,Vying,4.400843956132392e-06,1.7253897310324457e-07,3,3,0
13351,WAR,2.3052039770217305e-06,3.6233184351681345e-06,3,1,2
13352,WARNING,6.496483935243052e-06,7.074097897233022e-06,7,3,4
13353,WASHINGTON,8.613080314144832e-05,8.126585633162811e-05,97,46,51
13354,WATCH,4.6313643538345614e-05,5.711040009717395e-05,61,26,35
13355,WICHITA,2.3052039770217305e-06,3.6233184351681345e-06,3,1,2
13356,WIRED,2.3052039770217305e-06,7.074097897233022e-06,6,1,5
13357,WMD,1.6974683830796368e-05,2.4327995207557487e-05,23,8,15
13358,WRONG,6.496483935243052e-06,1.7253897310324457e-07,3,3,0
13359,WSJ,1.0687763893464371e-05,1.052487735929791e-05,13,7,6
13360,WSJcom,4.400843956132392e-06,5.348708166200577e-06,5,2,3
13361,WTF,3.583544364279237e-05,3.122955413168725e-05,45,19,26
13362,WTO,1.48790438516857e-05,1.2250267090330355e-05,15,7,8
13363,WW,4.400843956132392e-06,3.6233184351681345e-06,4,2,2
13364,WW2,6.496483935243052e-06,1.052487735929791e-05,9,3,6
13365,WWF,1.6974683830796368e-05,1.052487735929791e-05,15,8,7
13366,WWI,6.496483935243052e-06,7.074097897233022e-06,7,3,4
13367,WWII,4.212236358012434e-05,6.401195902130366e-05,62,21,41
13368,WWIII,2.3052039770217305e-06,3.6233184351681345e-06,3,1,2
13369,Wachovia,4.400843956132392e-06,1.8979287041356905e-06,3,2,1
13370,Wacky,4.400843956132392e-06,5.348708166200577e-06,5,2,3
13371,Wade,1.9070323809907035e-05,2.9504164400654783e-05,32,13,19
13372,Wael,2.3052039770217305e-06,7.074097897233022e-06,5,1,4
13373,Waffle,6.496483935243052e-06,1.7253897310324457e-07,3,3,0
13374,Wage,9.24177230787802e-05,0.00012612598933847184,132,49,83
13375,Waging,6.496483935243052e-06,5.348708166200577e-06,6,3,3
13376,Wagner,2.3052039770217305e-06,7.074097897233022e-06,7,1,6
13377,Wahhabi,2.095639979110664e-07,5.348708166200577e-06,3,0,3
13378,Wahhabism,2.3052039770217305e-06,3.6233184351681345e-06,3,1,2
13379,Wait,5.050492349656699e-05,4.8483451442011706e-05,57,28,29
13380,Waited,2.3052039770217305e-06,3.6233184351681345e-06,4,2,2
13381,Waiting,4.212236358012434e-05,4.8483451442011706e-05,52,21,31
13382,Waitres,2.3052039770217305e-06,3.6233184351681345e-06,4,1,3
13383,Waive,2.3052039770217305e-06,8.79948762826546e-06,6,1,5
13384,Waiver,8.592123914353715e-06,1.052487735929791e-05,11,4,7
13385,Wake,4.4218003559234974e-05,3.8131113055817005e-05,49,23,26
13386,Waking,4.400843956132392e-06,3.6233184351681345e-06,4,2,2
13387,WalMart,3.3739803663681634e-05,2.4327995207557487e-05,33,19,14
13388,Wale,3.1644163684570994e-05,5.1934230904076595e-05,48,17,31
13389,Walensky,4.400843956132392e-06,1.8979287041356905e-06,3,2,1
13390,Walgreen,6.496483935243052e-06,5.348708166200577e-06,8,5,3
13391,Wali,2.3052039770217305e-06,1.8979287041356905e-06,3,2,1
13392,Walk,5.4696203454788295e-05,4.8483451442011706e-05,57,27,30
13393,Walked,6.496483935243052e-06,8.79948762826546e-06,8,3,5
13394,Walker,9.870464301611217e-05,6.918812821440096e-05,103,55,48
13395,Walking,1.48790438516857e-05,1.3975656821362803e-05,16,7,9
13396,Walkout,1.48790438516857e-05,1.9151826014460126e-05,20,8,12
13397,Wall,0.0003124599208853996,0.00036595516195198134,400,172,228
13398,Wallace,1.278340387257504e-05,1.2250267090330355e-05,13,6,7
13399,Wallet,1.278340387257504e-05,1.2250267090330355e-05,14,7,7
13400,Walmart,0.00010499156295344414,0.00012267520987640663,138,59,79
13401,Walsh,8.592123914353715e-06,5.348708166200577e-06,7,4,3
13402,Walt,6.496483935243052e-06,1.2250267090330355e-05,13,4,9
13403,Walter,1.9070323809907035e-05,2.4327995207557487e-05,26,9,17
13404,Walton,2.3052039770217305e-06,8.79948762826546e-06,9,3,6
13405,Wanda,4.400843956132392e-06,3.6233184351681345e-06,4,2,2
13406,Wang,4.400843956132392e-06,3.6233184351681345e-06,4,2,2
13407,Wanna,4.400843956132392e-06,1.7253897310324457e-07,3,3,0
13408,Want,0.0007106315169164257,0.0007334631746618924,871,381,490
13409,Wanted,5.050492349656699e-05,6.746273848336857e-05,75,27,48
13410,Wanting,1.0687763893464371e-05,7.074097897233022e-06,9,5,4
13411,War,0.0007965527560599625,0.0008663181839513904,981,422,559
13412,Warcraft,2.3052039770217305e-06,3.6233184351681345e-06,3,1,2
13413,Ward,4.400843956132392e-06,8.79948762826546e-06,8,3,5
13414,Warehouse,1.278340387257504e-05,1.2250267090330355e-05,15,6,9
13415,Warfare,8.592123914353715e-06,7.074097897233022e-06,9,5,4
13416,Warlord,6.496483935243052e-06,8.79948762826546e-06,10,4,6
13417,Warm,3.1644163684570994e-05,1.742643628342769e-05,28,17,11
13418,Warmbier,6.496483935243052e-06,1.8979287041356905e-06,4,3,1
13419,Warmer,2.3052039770217305e-06,5.348708166200577e-06,4,1,3
13420,Warmest,2.3052039770217305e-06,5.348708166200577e-06,4,1,3
13421,Warming,2.954852370546031e-05,3.640572332478458e-05,39,17,22
13422,Warn,0.00018881716211787043,0.00018306385046254245,223,102,121
13423,Warned,1.6974683830796368e-05,7.074097897233022e-06,15,8,7
13424,Warner,3.3739803663681634e-05,2.2602605476525032e-05,36,18,18
13425,Warning,7.774824322500554e-05,8.4716635793693e-05,99,42,57
13426,Warnock,4.400843956132392e-06,1.8979287041356905e-06,3,2,1
13427,Warplane,4.400843956132392e-06,5.348708166200577e-06,5,2,3
13428,Warrant,1.9070323809907035e-05,2.6053384938589907e-05,25,10,15
13429,Warren,0.0002097735619089774,0.00024172710131764556,279,115,164
13430,Warrior,2.5357243747239038e-05,8.79948762826546e-06,18,13,5
13431,Warsaw,1.6974683830796368e-05,2.2602605476525032e-05,21,8,13
13432,Warship,1.0687763893464371e-05,8.79948762826546e-06,12,5,7
13433,Warsi,6.496483935243052e-06,1.7253897310324457e-07,3,3,0
13434,Wary,4.400843956132392e-06,7.074097897233022e-06,7,3,4
13435,Wash,1.6974683830796368e-05,1.3975656821362803e-05,19,8,11
13436,Washing,4.400843956132392e-06,1.8979287041356905e-06,3,2,1
13437,Washington,0.0004633459993813674,0.0004349707511932791,533,250,283
13438,Washingtonbased,2.3052039770217305e-06,3.6233184351681345e-06,3,1,2
13439,Wasn,8.592123914353715e-06,8.79948762826546e-06,10,4,6
13440,Wasserman,1.278340387257504e-05,2.087721574549256e-05,21,8,13
13441,Waste,4.212236358012434e-05,4.1581892517881935e-05,46,20,26
13442,Wasted,4.400843956132392e-06,8.79948762826546e-06,7,2,5
13443,Wasteland,2.3052039770217305e-06,3.6233184351681345e-06,4,1,3
13444,Wasting,2.095639979110664e-07,8.79948762826546e-06,5,0,5
13445,Watch,0.00022863432172097337,0.000286587234324489,307,130,177
13446,Watchdog,3.583544364279237e-05,6.228656929027126e-05,57,20,37
13447,Watched,2.3052039770217305e-06,1.2250267090330355e-05,9,1,8
13448,Watcher,1.0687763893464371e-05,5.348708166200577e-06,8,5,3
13449,Watching,3.7931083621902995e-05,3.2954943862719716e-05,37,18,19
13450,Water,0.0002537820014703013,0.0002400017115866128,285,131,154
13451,Waterboarding,8.592123914353715e-06,8.79948762826546e-06,9,4,5
13452,Waterfall,2.095639979110664e-07,5.348708166200577e-06,3,0,3
13453,Watergate,2.326160376812834e-05,2.087721574549256e-05,25,12,13
13454,Waterway,2.095639979110664e-07,5.348708166200577e-06,3,0,3
13455,Watson,1.0687763893464371e-05,1.3975656821362803e-05,13,5,8
13456,Watt,4.400843956132392e-06,5.348708166200577e-06,5,2,3
13457,Wave,5.6791843433898893e-05,4.50326719799468e-05,58,30,28
13458,Way,0.0004235288397782649,0.00045912620742773343,514,225,289
13459,Waymo,2.3052039770217305e-06,1.2250267090330355e-05,9,2,7
13460,Wayne,1.6974683830796368e-05,1.2250267090330355e-05,16,8,8
13461,Waziristan,1.0687763893464371e-05,7.074097897233022e-06,9,5,4
13462,We,0.00018043460220142793,0.00017098612234531542,209,102,107
13463,Weak,2.116596378901769e-05,2.4327995207557487e-05,25,11,14
13464,Weaken,4.400843956132392e-06,8.79948762826546e-06,9,3,6
13465,Weakened,4.400843956132392e-06,1.8979287041356905e-06,4,3,1
13466,Weakening,8.592123914353715e-06,5.348708166200577e-06,7,4,3
13467,Weaker,4.400843956132392e-06,1.8979287041356905e-06,4,3,1
13468,Wealth,3.1644163684570994e-05,4.330728224891437e-05,46,19,27
13469,Wealthier,2.3052039770217305e-06,3.6233184351681345e-06,3,1,2
13470,Wealthiest,4.400843956132392e-06,1.7253897310324457e-07,3,3,0
13471,Wealthy,4.212236358012434e-05,1.9151826014460126e-05,33,20,13
13472,Weapon,0.00012175668278632962,0.0001019705331040174,130,63,67
13473,Weaponry,2.3052039770217305e-06,3.6233184351681345e-06,3,1,2
13474,Wear,3.3739803663681634e-05,2.4327995207557487e-05,34,19,15
13475,Wearable,4.400843956132392e-06,5.348708166200577e-06,6,3,3
13476,Wearing,2.5357243747239038e-05,1.742643628342769e-05,24,12,12
13477,Weasel,2.3052039770217305e-06,3.6233184351681345e-06,3,1,2
13478,Weather,1.9070323809907035e-05,2.777877466962238e-05,27,11,16
13479,Weaver,8.592123914353715e-06,3.6233184351681345e-06,6,4,2
13480,Web,7.355696326678427e-05,6.918812821440096e-05,84,41,43
13481,Webb,1.278340387257504e-05,5.348708166200577e-06,10,6,4
13482,Weber,4.400843956132392e-06,7.074097897233022e-06,6,2,4
13483,Website,6.307876337123095e-05,6.573734875233614e-05,74,35,39
13484,Wed,8.592123914353715e-06,8.79948762826546e-06,13,7,6
13485,Wedding,2.7452883726349685e-05,1.9151826014460126e-05,27,14,13
13486,Wednesday,0.0003899986001124942,0.0003694059414140463,467,214,253
13487,Weed,3.7931083621902995e-05,2.9504164400654783e-05,40,20,20
13488,Week,0.0002055822819507562,0.0002400017115866128,268,105,163
13489,Weekend,1.278340387257504e-05,4.50326719799468e-05,34,6,28
13490,Weeklong,6.496483935243052e-06,1.7253897310324457e-07,3,3,0
13491,Weekly,1.0687763893464371e-05,5.348708166200577e-06,11,7,4
13492,Weibo,8.592123914353715e-06,1.8979287041356905e-06,5,4,1
13493,Weigh,3.583544364279237e-05,3.640572332478458e-05,45,20,25
13494,Weight,1.6974683830796368e-05,1.2250267090330355e-05,16,8,8
13495,Weiner,2.326160376812834e-05,2.2602605476525032e-05,26,11,15
13496,Weingarten,2.3052039770217305e-06,5.348708166200577e-06,4,1,3
13497,Weinstein,2.7452883726349685e-05,3.640572332478458e-05,38,17,21
13498,Weird,2.116596378901769e-05,3.8131113055817005e-05,34,11,23
13499,Weis,6.496483935243052e-06,8.79948762826546e-06,8,3,5
13500,Weiwei,2.5357243747239038e-05,7.074097897233022e-06,20,12,8
13501,Welch,2.3052039770217305e-06,8.79948762826546e-06,6,1,5
13502,Welcome,0.00024539944155385846,0.0002296493732004186,281,131,150
13503,Welcomed,2.095639979110664e-07,3.6233184351681345e-06,3,0,3
13504,Welcoming,2.3052039770217305e-06,1.052487735929791e-05,8,2,6
13505,Weld,4.400843956132392e-06,3.6233184351681345e-06,4,2,2
13506,Welfare,1.6974683830796368e-05,2.9504164400654783e-05,30,12,18
13507,Well,0.0002265386817418625,0.0002020431375038992,251,116,135
13508,WellBeing,6.496483935243052e-06,1.8979287041356905e-06,4,3,1
13509,Welle,2.3052039770217305e-06,3.6233184351681345e-06,3,1,2
13510,Wellington,2.3052039770217305e-06,3.6233184351681345e-06,5,2,3
13511,Wellnes,1.278340387257504e-05,8.79948762826546e-06,12,7,5
13512,Welsh,6.496483935243052e-06,7.074097897233022e-06,7,3,4
13513,Wen,6.496483935243052e-06,1.2250267090330355e-05,11,3,8
13514,Wendell,4.400843956132392e-06,7.074097897233022e-06,6,2,4
13515,Wendy,1.278340387257504e-05,1.2250267090330355e-05,20,11,9
13516,Went,4.6313643538345614e-05,6.573734875233614e-05,65,25,40
13517,Wesley,6.496483935243052e-06,1.8979287041356905e-06,4,3,1
13518,West,0.00047172855929781003,0.0005091625096276747,567,250,317
13519,Western,0.00016576512234765329,0.0001968669683108019,215,83,132
13520,Westerner,8.592123914353715e-06,5.348708166200577e-06,9,5,4
13521,Westerwelle,4.400843956132392e-06,3.6233184351681345e-06,4,2,2
13522,Westminster,8.592123914353715e-06,7.074097897233022e-06,9,4,5
13523,Wet,2.095639979110664e-07,3.6233184351681345e-06,3,1,2
13524,Weve,6.098312339212028e-05,5.5385010366141504e-05,72,35,37
13525,Whale,2.7452883726349685e-05,2.777877466962238e-05,29,13,16
13526,Whaler,2.095639979110664e-07,3.6233184351681345e-06,3,0,3
13527,Whaling,4.400843956132392e-06,1.2250267090330355e-05,10,2,8
13528,What,0.0001971997220343134,0.00015373222503499084,203,100,103
13529,Whatever,2.326160376812834e-05,1.9151826014460126e-05,25,11,14
13530,WhatsApp,2.7452883726349685e-05,8.79948762826546e-06,18,13,5
13531,Wheat,6.496483935243052e-06,5.348708166200577e-06,6,3,3
13532,Wheel,1.6974683830796368e-05,5.348708166200577e-06,12,9,3
13533,Wheelchair,1.6974683830796368e-05,1.9151826014460126e-05,21,9,12
13534,Wheeler,2.095639979110664e-07,1.052487735929791e-05,7,0,7
13535,When,1.48790438516857e-05,1.9151826014460126e-05,20,9,11
13536,Whenever,1.6974683830796368e-05,5.348708166200577e-06,11,8,3
13537,Where,1.6974683830796368e-05,1.052487735929791e-05,15,8,7
13538,Wherever,2.3052039770217305e-06,3.6233184351681345e-06,4,1,3
13539,Whether,0.00010708720293255492,0.0001019705331040174,127,61,66
13540,Whining,2.3052039770217305e-06,7.074097897233022e-06,6,2,4
13541,Whip,8.592123914353715e-06,1.2250267090330355e-05,11,4,7
13542,Whistle,4.400843956132392e-06,3.6233184351681345e-06,4,2,2
13543,WhistleBlower,2.3052039770217305e-06,3.6233184351681345e-06,3,1,2
13544,Whistleblower,5.260056347567764e-05,4.6758061710979285e-05,58,27,31
13545,Whistler,4.400843956132392e-06,1.8979287041356905e-06,3,2,1
13546,White,0.0010815597932190126,0.0011285774230683219,1315,580,735
13547,WhiteCollar,2.095639979110664e-07,7.074097897233022e-06,4,0,4
13548,Whitefish,2.3052039770217305e-06,3.6233184351681345e-06,4,2,2
13549,Whitehouse,4.400843956132392e-06,1.8979287041356905e-06,4,2,2
13550,Whitenes,2.095639979110664e-07,3.6233184351681345e-06,3,0,3
13551,Whitewash,4.400843956132392e-06,1.8979287041356905e-06,4,2,2
13552,Whitman,2.3052039770217305e-06,5.348708166200577e-06,4,1,3
13553,Whitney,4.400843956132392e-06,1.8979287041356905e-06,3,2,1
13554,Who,4.840928351745632e-05,4.6758061710979285e-05,56,24,32
13555,Whoa,2.3052039770217305e-06,3.6233184351681345e-06,3,1,2
13556,Whod,2.095639979110664e-07,5.348708166200577e-06,3,0,3
13557,Whoever,2.3052039770217305e-06,1.052487735929791e-05,8,1,7
13558,Whole,4.4218003559234974e-05,3.122955413168725e-05,43,22,21
13559,Wholesale,4.400843956132392e-06,1.8979287041356905e-06,3,2,1
13560,Whoop,4.400843956132392e-06,1.570104655239525e-05,12,3,9
13561,Whoopi,2.3052039770217305e-06,3.6233184351681345e-06,3,1,2
13562,Whose,1.278340387257504e-05,3.8131113055817005e-05,31,7,24
13563,Why,1.0687763893464371e-05,3.6233184351681345e-06,8,6,2
13564,WiFi,3.7931083621902995e-05,2.087721574549256e-05,32,18,14
13565,Wichita,2.3052039770217305e-06,5.348708166200577e-06,4,1,3
13566,Wicked,2.3052039770217305e-06,3.6233184351681345e-06,3,1,2
13567,Wide,2.116596378901769e-05,1.570104655239525e-05,20,10,10
13568,Widely,2.3052039770217305e-06,5.348708166200577e-06,4,1,3
13569,Widen,1.6974683830796368e-05,8.79948762826546e-06,16,9,7
13570,Widening,4.400843956132392e-06,3.6233184351681345e-06,4,2,2
13571,Wider,2.095639979110664e-07,1.7253897310324457e-07,3,2,1
13572,Widespread,1.48790438516857e-05,1.3975656821362803e-05,16,7,9
13573,Widow,1.278340387257504e-05,1.570104655239525e-05,18,7,11
13574,Wife,6.517440335034157e-05,6.228656929027126e-05,80,36,44
13575,Wiki,4.400843956132392e-06,3.6233184351681345e-06,4,2,2
13576,WikiLeak,0.00035437272046761313,0.0002986649624417165,396,183,213
13577,WikiLeaks,2.3052039770217305e-06,3.6233184351681345e-06,3,1,2
13578,WikiLeaksstyle,2.3052039770217305e-06,3.6233184351681345e-06,3,1,2
13579,Wikileak,0.0001741476822640959,0.00017443690180738014,207,90,117
13580,Wikipedia,6.517440335034157e-05,3.640572332478458e-05,56,33,23
13581,Wilbur,4.400843956132392e-06,1.052487735929791e-05,12,5,7
13582,Wild,5.050492349656699e-05,5.020884117304414e-05,57,26,31
13583,Wilder,1.6974683830796368e-05,1.052487735929791e-05,15,9,6
13584,Wildest,6.496483935243052e-06,3.6233184351681345e-06,5,3,2
13585,Wildfire,2.116596378901769e-05,2.087721574549256e-05,25,11,14
13586,Wildlife,3.3739803663681634e-05,2.6053384938589907e-05,32,17,15
13587,Wildly,4.400843956132392e-06,5.348708166200577e-06,6,2,4
13588,Will,6.496483935243052e-06,1.8979287041356905e-06,4,3,1
13589,Willi,2.3052039770217305e-06,3.6233184351681345e-06,3,1,2
13590,William,7.146132328767358e-05,7.781507686956326e-05,84,36,48
13591,Willie,6.496483935243052e-06,1.2250267090330355e-05,11,4,7
13592,Willing,1.48790438516857e-05,1.570104655239525e-05,18,8,10
13593,Wilson,3.1644163684570994e-05,1.742643628342769e-05,25,15,10
13594,Wimbledon,2.3052039770217305e-06,3.6233184351681345e-06,3,1,2
13595,Wimp,2.3052039770217305e-06,1.7253897310324457e-07,3,2,1
13596,Win,0.00035646836044672355,0.00042634380253811694,473,198,275
13597,Wind,4.002672360101368e-05,3.985650278684949e-05,47,21,26
13598,Windfall,4.400843956132392e-06,3.6233184351681345e-06,4,2,2
13599,Windfarm,6.496483935243052e-06,1.8979287041356905e-06,5,4,1
13600,Window,2.326160376812834e-05,3.468033359375216e-05,34,14,20
13601,Windsor,6.496483935243052e-06,8.79948762826546e-06,8,3,5
13602,Wine,1.0687763893464371e-05,1.2250267090330355e-05,12,5,7
13603,Winery,4.400843956132392e-06,1.8979287041356905e-06,3,2,1
13604,Winfrey,4.400843956132392e-06,8.79948762826546e-06,8,3,5
13605,Wing,1.0687763893464371e-05,2.087721574549256e-05,21,7,14
13606,Wink,4.400843956132392e-06,1.8979287041356905e-06,3,2,1
13607,Winner,5.4696203454788295e-05,7.091351794543343e-05,73,30,43
13608,Winning,5.260056347567764e-05,5.1934230904076595e-05,63,29,34
13609,Winston,4.400843956132392e-06,3.6233184351681345e-06,6,3,3
13610,Winter,5.050492349656699e-05,4.6758061710979285e-05,57,28,29
13611,Winterkorn,2.3052039770217305e-06,1.8979287041356905e-06,3,2,1
13612,Wipe,1.48790438516857e-05,7.074097897233022e-06,12,7,5
13613,Wiped,6.496483935243052e-06,1.8979287041356905e-06,4,3,1
13614,Wiping,4.400843956132392e-06,1.8979287041356905e-06,3,2,1
13615,Wire,1.0687763893464371e-05,1.2250267090330355e-05,13,5,8
13616,Wired,1.48790438516857e-05,1.2250267090330355e-05,15,7,8
13617,Wiredcom,2.3052039770217305e-06,5.348708166200577e-06,4,1,3
13618,Wireles,4.400843956132392e-06,5.348708166200577e-06,5,2,3
13619,Wiretap,1.48790438516857e-05,5.348708166200577e-06,11,8,3
13620,Wiretapped,2.095639979110664e-07,7.074097897233022e-06,5,1,4
13621,Wiretapping,2.326160376812834e-05,1.8979287041356905e-06,16,15,1
13622,Wisconsin,7.984388320411623e-05,9.161819471782287e-05,111,53,58
13623,Wisdom,1.48790438516857e-05,3.6233184351681345e-06,9,7,2
13624,Wise,6.496483935243052e-06,3.6233184351681345e-06,5,3,2
13625,Wisely,2.3052039770217305e-06,5.348708166200577e-06,5,1,4
13626,Wish,4.6313643538345614e-05,4.6758061710979285e-05,52,24,28
13627,Wishing,2.3052039770217305e-06,1.8979287041356905e-06,3,1,2
13628,Witch,1.9070323809907035e-05,2.2602605476525032e-05,23,10,13
13629,Witchcraft,2.3052039770217305e-06,5.348708166200577e-06,4,1,3
13630,With,2.3052039770217305e-06,3.6233184351681345e-06,4,1,3
13631,Withdraw,2.326160376812834e-05,3.122955413168725e-05,30,11,19
13632,Withdrawal,1.0687763893464371e-05,2.6053384938589907e-05,20,5,15
13633,Withhold,2.095639979110664e-07,5.348708166200577e-06,4,0,4
13634,Withholding,6.496483935243052e-06,7.074097897233022e-06,7,3,4
13635,Within,3.583544364279237e-05,3.122955413168725e-05,41,19,22
13636,Without,0.00019091280209698145,0.00023310015266248305,256,104,152
13637,Witnes,3.583544364279237e-05,1.570104655239525e-05,29,19,10
13638,Witness,1.6974683830796368e-05,2.087721574549256e-05,25,12,13
13639,Witnessing,2.095639979110664e-07,5.348708166200577e-06,3,0,3
13640,Wiwa,4.400843956132392e-06,1.8979287041356905e-06,3,2,1
13641,Wizard,4.400843956132392e-06,1.8979287041356905e-06,4,3,1
13642,Wobbly,6.496483935243052e-06,1.7253897310324457e-07,4,4,0
13643,Woe,1.6974683830796368e-05,1.742643628342769e-05,19,9,10
13644,Woke,2.3052039770217305e-06,5.348708166200577e-06,5,1,4
13645,Wolf,3.3739803663681634e-05,2.777877466962238e-05,34,17,17
13646,Wolff,4.400843956132392e-06,1.2250267090330355e-05,9,2,7
13647,Wolfgang,4.400843956132392e-06,3.6233184351681345e-06,5,3,2
13648,Woman,0.0008845696351826108,0.0008438881174479688,1025,482,543
13649,Women,0.00010708720293255492,0.00011749904068330962,132,57,75
13650,Won,3.3739803663681634e-05,3.468033359375216e-05,41,18,23
13651,Wonder,1.6974683830796368e-05,3.2954943862719716e-05,32,10,22
13652,Wonderful,8.592123914353715e-06,5.348708166200577e-06,8,4,4
13653,Wondering,2.3052039770217305e-06,1.052487735929791e-05,9,2,7
13654,Wonderland,6.496483935243052e-06,1.8979287041356905e-06,4,3,1
13655,Woo,4.400843956132392e-06,7.074097897233022e-06,9,5,4
13656,Wood,1.6974683830796368e-05,1.2250267090330355e-05,16,8,8
13657,Woodward,2.3052039770217305e-06,3.6233184351681345e-06,3,1,2
13658,Woody,6.496483935243052e-06,1.8979287041356905e-06,5,4,1
13659,Wookiee,4.400843956132392e-06,1.8979287041356905e-06,3,2,1
13660,Woolly,4.400843956132392e-06,1.7253897310324457e-07,3,2,1
13661,Word,7.146132328767358e-05,9.679436391092026e-05,96,36,60
13662,Wore,4.400843956132392e-06,3.6233184351681345e-06,5,3,2
13663,Work,0.00022863432172097337,0.00027623489593829424,308,124,184
13664,WorkLife,4.400843956132392e-06,7.074097897233022e-06,6,2,4
13665,Workday,4.400843956132392e-06,7.074097897233022e-06,6,2,4
13666,Worked,1.278340387257504e-05,2.2602605476525032e-05,21,6,15
13667,Worker,0.0002935991610734039,0.00032109502894513814,363,159,204
13668,Workers,4.400843956132392e-06,1.8979287041356905e-06,3,2,1
13669,Workforce,1.6974683830796368e-05,7.074097897233022e-06,13,8,5
13670,Working,0.00011127848289077625,0.00010542131256608228,131,60,71
13671,WorkingClas,2.3052039770217305e-06,5.348708166200577e-06,4,1,3
13672,Workplace,4.002672360101368e-05,3.8131113055817005e-05,48,26,22
13673,Workshop,6.496483935243052e-06,1.8979287041356905e-06,6,3,3
13674,World,0.0012387327916523125,0.0012493547042405936,1471,667,804
13675,Worldfirst,2.095639979110664e-07,5.348708166200577e-06,3,0,3
13676,Worldwide,3.3739803663681634e-05,2.9504164400654783e-05,37,18,19
13677,Worm,4.400843956132392e-06,5.348708166200577e-06,5,2,3
13678,Worried,5.4696203454788295e-05,4.50326719799468e-05,55,28,27
13679,Worry,4.212236358012434e-05,3.8131113055817005e-05,49,22,27
13680,Worrying,4.400843956132392e-06,8.79948762826546e-06,8,2,6
13681,Worse,7.774824322500554e-05,7.608968713853079e-05,90,40,50
13682,Worsen,2.116596378901769e-05,1.8979287041356905e-06,12,10,2
13683,Worsening,2.3052039770217305e-06,5.348708166200577e-06,4,1,3
13684,Worship,4.400843956132392e-06,5.348708166200577e-06,6,2,4
13685,Worst,8.822644312055891e-05,8.816741525575797e-05,104,48,56
13686,Worth,5.6791843433898893e-05,4.6758061710979285e-05,59,29,30
13687,Would,0.000385807320154273,0.00034870126464165704,431,198,233
13688,WouldBe,2.095639979110664e-07,5.348708166200577e-06,3,0,3
13689,Wouldn,2.3052039770217305e-06,3.6233184351681345e-06,3,1,2
13690,Wouldve,4.400843956132392e-06,1.8979287041356905e-06,7,3,4
13691,Wound,8.592123914353715e-06,7.074097897233022e-06,9,4,5
13692,Wounded,2.5357243747239038e-05,1.9151826014460126e-05,25,13,12
13693,Wow,2.954852370546031e-05,1.3975656821362803e-05,22,14,8
13694,Wozniak,4.400843956132392e-06,7.074097897233022e-06,6,2,4
13695,Wrap,8.592123914353715e-06,1.8979287041356905e-06,5,4,1
13696,Wray,2.3052039770217305e-06,1.3975656821362803e-05,10,1,9
13697,Wreck,2.3052039770217305e-06,7.074097897233022e-06,6,2,4
13698,Wreckage,2.3052039770217305e-06,7.074097897233022e-06,5,1,4
13699,Wrecked,2.3052039770217305e-06,3.6233184351681345e-06,4,2,2
13700,Wrecking,2.095639979110664e-07,7.074097897233022e-06,4,0,4
13701,Wright,2.116596378901769e-05,3.6233184351681345e-06,13,10,3
13702,Write,3.583544364279237e-05,3.2954943862719716e-05,38,17,21
13703,Writer,1.9070323809907035e-05,1.052487735929791e-05,17,9,8
13704,Writing,1.48790438516857e-05,1.570104655239525e-05,16,7,9
13705,Written,4.400843956132392e-06,8.79948762826546e-06,8,2,6
13706,Wrong,0.0001552869224521,0.0001364783277246665,176,87,89
13707,Wrongdoing,4.400843956132392e-06,3.6233184351681345e-06,4,2,2
13708,Wrongful,2.3052039770217305e-06,1.8979287041356905e-06,3,2,1
13709,Wrongfully,2.095639979110664e-07,5.348708166200577e-06,4,1,3
13710,Wrongly,8.592123914353715e-06,3.6233184351681345e-06,7,5,2
13711,Wrote,2.116596378901769e-05,1.742643628342769e-05,22,10,12
13712,Wukan,4.400843956132392e-06,1.8979287041356905e-06,3,2,1
13713,Wulff,2.3052039770217305e-06,5.348708166200577e-06,5,1,4
13714,Wyclef,6.496483935243052e-06,5.348708166200577e-06,6,3,3
13715,Wyden,8.592123914353715e-06,5.348708166200577e-06,7,4,3
13716,Wynn,2.5357243747239038e-05,1.7253897310324457e-07,12,12,0
13717,Wyoming,1.0687763893464371e-05,1.9151826014460126e-05,16,5,11
13718,XE,4.400843956132392e-06,1.8979287041356905e-06,3,2,1
13719,XKeyscore,6.496483935243052e-06,1.7253897310324457e-07,3,3,0
13720,XL,3.1644163684570994e-05,2.2602605476525032e-05,29,16,13
13721,XPost,4.400843956132392e-06,1.8979287041356905e-06,3,2,1
13722,XRay,4.400843956132392e-06,3.6233184351681345e-06,5,3,2
13723,XVI,2.326160376812834e-05,1.3975656821362803e-05,20,12,8
13724,Xavier,2.3052039770217305e-06,5.348708166200577e-06,5,1,4
13725,Xbox,6.496483935243052e-06,7.074097897233022e-06,10,5,5
13726,Xenophobia,4.400843956132392e-06,1.8979287041356905e-06,3,2,1
13727,Xi,2.326160376812834e-05,3.122955413168725e-05,33,12,21
13728,Xiaobo,1.0687763893464371e-05,1.2250267090330355e-05,12,5,7
13729,Xilai,6.496483935243052e-06,7.074097897233022e-06,7,3,4
13730,Xinhua,1.0687763893464371e-05,5.348708166200577e-06,8,5,3
13731,Xinjiang,2.7452883726349685e-05,1.9151826014460126e-05,25,13,12
13732,Xma,2.095639979110664e-07,8.79948762826546e-06,5,0,5
13733,Xpost,1.0687763893464371e-05,3.6233184351681345e-06,8,6,2
13734,Xray,4.400843956132392e-06,5.348708166200577e-06,5,2,3
13735,Xu,2.3052039770217305e-06,3.6233184351681345e-06,3,1,2
13736,YAI,2.3052039770217305e-06,3.6233184351681345e-06,3,1,2
13737,YE,4.400843956132392e-06,3.6233184351681345e-06,4,2,2
13738,YEAR,2.095639979110664e-07,3.6233184351681345e-06,3,1,2
13739,YIKE,2.3052039770217305e-06,3.6233184351681345e-06,3,1,2
13740,YONHAP,6.496483935243052e-06,1.7253897310324457e-07,3,3,0
13741,YORK,2.116596378901769e-05,1.742643628342769e-05,21,11,10
13742,YPG,2.095639979110664e-07,5.348708166200577e-06,3,0,3
13743,Ya,8.592123914353715e-06,5.348708166200577e-06,7,4,3
13744,Yacht,6.496483935243052e-06,1.7253897310324457e-07,4,3,1
13745,Yahoo,7.774824322500554e-05,5.1934230904076595e-05,79,45,34
13746,Yahya,2.3052039770217305e-06,5.348708166200577e-06,4,1,3
13747,Yak,4.400843956132392e-06,3.6233184351681345e-06,4,2,2
13748,Yale,1.278340387257504e-05,8.79948762826546e-06,11,6,5
13749,Yang,2.3052039770217305e-06,1.8979287041356905e-06,3,1,2
13750,Yangtze,4.400843956132392e-06,5.348708166200577e-06,6,2,4
13751,Yankee,6.496483935243052e-06,3.6233184351681345e-06,5,3,2
13752,Yanukovich,4.400843956132392e-06,3.6233184351681345e-06,6,4,2
13753,Yanukovych,1.48790438516857e-05,1.570104655239525e-05,21,10,11
13754,Yard,2.116596378901769e-05,2.087721574549256e-05,29,12,17
13755,Yasser,8.592123914353715e-06,5.348708166200577e-06,7,4,3
13756,Yate,2.7452883726349685e-05,1.742643628342769e-05,23,13,10
13757,Yay,4.400843956132392e-06,1.8979287041356905e-06,3,2,1
13758,Yazidi,2.5357243747239038e-05,2.9504164400654783e-05,34,14,20
13759,Ye,9.660900303700153e-05,0.00011577365095227703,133,59,74
13760,Yeah,2.116596378901769e-05,1.742643628342769e-05,22,11,11
13761,Year,0.0007253009967702005,0.0007213854465446653,859,399,460
13762,YearEnd,6.496483935243052e-06,1.8979287041356905e-06,5,4,1
13763,YearOld,2.3052039770217305e-06,1.8979287041356905e-06,3,1,2
13764,Yearbook,4.400843956132392e-06,5.348708166200577e-06,6,3,3
13765,Yee,4.400843956132392e-06,1.8979287041356905e-06,4,2,2
13766,Yell,2.3052039770217305e-06,5.348708166200577e-06,4,1,3
13767,Yelled,2.3052039770217305e-06,3.6233184351681345e-06,3,1,2
13768,Yellen,1.48790438516857e-05,2.2602605476525032e-05,21,7,14
13769,Yelling,6.496483935243052e-06,3.6233184351681345e-06,6,3,3
13770,Yellow,8.592123914353715e-06,1.2250267090330355e-05,12,5,7
13771,Yellowstone,6.496483935243052e-06,7.074097897233022e-06,8,4,4
13772,Yelp,8.592123914353715e-06,1.8979287041356905e-06,5,4,1
13773,Yeman,0.00019091280209698145,0.0002106700861590614,230,94,136
13774,Yemen,8.592123914353715e-06,1.052487735929791e-05,11,4,7
13775,Yemeni,5.260056347567764e-05,5.3659620635109e-05,61,26,35
13776,Yeonpyeong,4.400843956132392e-06,1.7253897310324457e-07,3,3,0
13777,Yep,4.400843956132392e-06,8.79948762826546e-06,7,2,5
13778,Yesterday,2.7452883726349685e-05,2.087721574549256e-05,26,14,12
13779,Yet,0.00019510408205520246,0.00017443690180738014,217,103,114
13780,Yew,6.496483935243052e-06,1.8979287041356905e-06,5,3,2
13781,Yezidi,2.3052039770217305e-06,3.6233184351681345e-06,3,1,2
13782,Yield,4.400843956132392e-06,1.2250267090330355e-05,11,4,7
13783,Yik,4.400843956132392e-06,1.8979287041356905e-06,3,2,1
13784,Yike,2.3052039770217305e-06,5.348708166200577e-06,6,1,5
13785,Yingluck,2.3052039770217305e-06,5.348708166200577e-06,4,1,3
13786,Yo,2.3052039770217305e-06,3.6233184351681345e-06,3,1,2
13787,Yoga,1.278340387257504e-05,2.087721574549256e-05,21,7,14
13788,Yom,6.496483935243052e-06,3.6233184351681345e-06,5,3,2
13789,Yong,2.3052039770217305e-06,3.6233184351681345e-06,3,1,2
13790,Yonhap,2.095639979110664e-07,8.79948762826546e-06,7,1,6
13791,Yoo,2.3052039770217305e-06,3.6233184351681345e-06,3,1,2
13792,York,0.0005576497984413471,0.0004988101712414799,618,295,323
13793,Yorker,5.050492349656699e-05,3.985650278684949e-05,49,25,24
13794,Yorkshire,8.592123914353715e-06,5.348708166200577e-06,7,4,3
13795,Yosemite,2.095639979110664e-07,5.348708166200577e-06,3,0,3
13796,You,6.098312339212028e-05,5.5385010366141504e-05,66,32,34
13797,YouTube,7.774824322500554e-05,7.263890767646595e-05,96,41,55
13798,Young,0.00018462588215964923,0.00016580995315221804,195,94,101
13799,Younger,8.592123914353715e-06,5.348708166200577e-06,8,5,3
13800,Youngest,6.496483935243052e-06,1.570104655239525e-05,13,4,9
13801,Youngkin,2.095639979110664e-07,5.348708166200577e-06,3,0,3
13802,Yousafzai,1.48790438516857e-05,1.570104655239525e-05,19,9,10
13803,Youssef,4.400843956132392e-06,3.6233184351681345e-06,4,2,2
13804,Yousuf,6.496483935243052e-06,1.7253897310324457e-07,3,3,0
13805,Yousufzai,4.400843956132392e-06,1.8979287041356905e-06,3,2,1
13806,Youth,4.6313643538345614e-05,7.954046660059569e-05,81,30,51
13807,Youtube,8.592123914353715e-06,1.2250267090330355e-05,12,5,7
13808,Yoweri,2.3052039770217305e-06,5.348708166200577e-06,4,1,3
13809,Yr,2.3052039770217305e-06,7.074097897233022e-06,8,3,5
13810,Yu,2.3052039770217305e-06,1.8979287041356905e-06,3,1,2
13811,Yuan,4.400843956132392e-06,7.074097897233022e-06,6,2,4
13812,Yulia,2.095639979110664e-07,5.348708166200577e-06,3,0,3
13813,Yulín,2.3052039770217305e-06,5.348708166200577e-06,4,1,3
13814,Yup,4.400843956132392e-06,1.8979287041356905e-06,3,2,1
13815,Yuri,2.3052039770217305e-06,3.6233184351681345e-06,4,1,3
13816,ZERO,4.400843956132392e-06,1.8979287041356905e-06,3,2,1
13817,Zachary,8.592123914353715e-06,1.8979287041356905e-06,5,4,1
13818,Zakaria,2.3052039770217305e-06,5.348708166200577e-06,5,1,4
13819,Zambia,4.400843956132392e-06,1.052487735929791e-05,8,2,6
13820,Zambian,1.0687763893464371e-05,8.79948762826546e-06,10,5,5
13821,Zanzibar,2.3052039770217305e-06,3.6233184351681345e-06,3,1,2
13822,Zara,4.400843956132392e-06,1.8979287041356905e-06,3,2,1
13823,Zardari,4.400843956132392e-06,8.79948762826546e-06,8,2,6
13824,Zawiyah,4.400843956132392e-06,1.8979287041356905e-06,3,2,1
13825,Zealand,0.00019300844207609195,0.00022274781427628854,245,102,143
13826,Zealander,1.48790438516857e-05,1.2250267090330355e-05,14,7,7
13827,Zelaya,2.116596378901769e-05,8.79948762826546e-06,16,10,6
13828,Zelensky,4.400843956132392e-06,1.8979287041356905e-06,3,2,1
13829,Zen,4.400843956132392e-06,3.6233184351681345e-06,4,2,2
13830,Zephyr,6.496483935243052e-06,1.2250267090330355e-05,11,4,7
13831,Zero,2.326160376812834e-05,2.777877466962238e-05,31,12,19
13832,Zervo,6.496483935243052e-06,3.6233184351681345e-06,5,3,2
13833,Zeta,3.3739803663681634e-05,1.570104655239525e-05,30,20,10
13834,Zhao,2.3052039770217305e-06,5.348708166200577e-06,4,1,3
13835,Zhisheng,4.400843956132392e-06,1.8979287041356905e-06,3,2,1
13836,Zika,0.00010080028299522283,8.4716635793693e-05,105,49,56
13837,Zimbabwe,0.00013013924270277222,8.4716635793693e-05,136,74,62
13838,Zimbabwean,8.592123914353715e-06,1.570104655239525e-05,18,5,13
13839,Zimmerman,8.592123914353715e-06,3.6233184351681345e-06,9,7,2
13840,Zinke,3.583544364279237e-05,4.8483451442011706e-05,53,20,33
13841,Zion,2.3052039770217305e-06,5.348708166200577e-06,6,2,4
13842,Zionism,1.6974683830796368e-05,8.79948762826546e-06,14,9,5
13843,Zionist,2.954852370546031e-05,3.122955413168725e-05,37,17,20
13844,Zip,4.400843956132392e-06,1.7253897310324457e-07,5,4,1
13845,Zoe,4.400843956132392e-06,5.348708166200577e-06,5,2,3
13846,Zombie,6.496483935243052e-06,7.074097897233022e-06,12,6,6
13847,Zone,3.583544364279237e-05,4.50326719799468e-05,46,19,27
13848,Zoo,1.6974683830796368e-05,2.2602605476525032e-05,21,8,13
13849,Zoom,2.3052039770217305e-06,3.6233184351681345e-06,3,1,2
13850,Zuckerberg,7.146132328767358e-05,7.091351794543343e-05,82,39,43
13851,Zulu,2.3052039770217305e-06,3.6233184351681345e-06,3,1,2
13852,Zuma,8.592123914353715e-06,1.052487735929791e-05,12,6,6
13853,Zurich,1.278340387257504e-05,5.348708166200577e-06,9,6,3
13854,abandon,4.212236358012434e-05,4.50326719799468e-05,50,23,27
13855,abandoned,5.6791843433898893e-05,5.3659620635109e-05,66,27,39
13856,abandoning,1.48790438516857e-05,1.2250267090330355e-05,15,7,8
13857,abandonment,2.3052039770217305e-06,1.8979287041356905e-06,3,1,2
13858,abdicate,4.400843956132392e-06,5.348708166200577e-06,6,2,4
13859,abdoman,6.496483935243052e-06,1.8979287041356905e-06,4,3,1
13860,abduct,8.592123914353715e-06,5.348708166200577e-06,9,5,4
13861,abducted,4.002672360101368e-05,3.2954943862719716e-05,40,20,20
13862,abducting,1.0687763893464371e-05,1.8979287041356905e-06,7,5,2
13863,abduction,1.0687763893464371e-05,1.2250267090330355e-05,15,6,9
13864,abductor,4.400843956132392e-06,1.8979287041356905e-06,3,2,1
13865,abide,6.496483935243052e-06,8.79948762826546e-06,8,3,5
13866,abiding,2.3052039770217305e-06,5.348708166200577e-06,5,2,3
13867,ability,9.03220830996695e-05,0.0001019705331040174,113,46,67
13868,abject,6.496483935243052e-06,3.6233184351681345e-06,5,3,2
13869,ablaze,6.496483935243052e-06,1.3975656821362803e-05,15,5,10
13870,able,0.00023072996170008382,0.00022792398346938586,264,122,142
13871,abnormal,6.496483935243052e-06,1.8979287041356905e-06,5,4,1
13872,abnormality,8.592123914353715e-06,8.79948762826546e-06,9,4,5
13873,aboard,2.116596378901769e-05,2.4327995207557487e-05,29,13,16
13874,abolish,1.9070323809907035e-05,2.777877466962238e-05,26,10,16
13875,abolished,1.0687763893464371e-05,1.052487735929791e-05,11,5,6
13876,abolishing,6.496483935243052e-06,3.6233184351681345e-06,6,4,2
13877,abolition,6.496483935243052e-06,5.348708166200577e-06,6,3,3
13878,aboriginal,4.400843956132392e-06,5.348708166200577e-06,8,2,6
13879,abort,2.095639979110664e-07,5.348708166200577e-06,3,0,3
13880,aborted,8.592123914353715e-06,5.348708166200577e-06,8,4,4
13881,abortion,0.00019929536201342395,0.0002089446964280291,244,108,136
13882,abound,8.592123914353715e-06,5.348708166200577e-06,8,4,4
13883,about,4.400843956132392e-06,3.6233184351681345e-06,4,2,2
13884,abroad,4.212236358012434e-05,7.091351794543343e-05,69,21,48
13885,abrupt,2.3052039770217305e-06,7.074097897233022e-06,5,1,4
13886,abruptly,1.278340387257504e-05,5.348708166200577e-06,11,7,4
13887,absence,1.0687763893464371e-05,2.6053384938589907e-05,23,5,18
13888,absent,1.278340387257504e-05,7.074097897233022e-06,10,6,4
13889,absentee,6.496483935243052e-06,7.074097897233022e-06,7,3,4
13890,absentia,2.095639979110664e-07,3.6233184351681345e-06,5,1,4
13891,absolute,2.326160376812834e-05,2.2602605476525032e-05,25,12,13
13892,absolutely,3.1644163684570994e-05,3.985650278684949e-05,52,23,29
13893,absorb,8.592123914353715e-06,8.79948762826546e-06,9,4,5
13894,absorbed,2.3052039770217305e-06,3.6233184351681345e-06,4,1,3
13895,abstain,2.3052039770217305e-06,7.074097897233022e-06,6,1,5
13896,abstained,2.3052039770217305e-06,1.8979287041356905e-06,3,1,2
13897,absurd,2.7452883726349685e-05,2.2602605476525032e-05,32,14,18
13898,abundance,2.3052039770217305e-06,5.348708166200577e-06,4,1,3
13899,abundant,4.400843956132392e-06,8.79948762826546e-06,8,3,5
13900,abundantly,4.400843956132392e-06,1.7253897310324457e-07,3,3,0
13901,abuse,0.0004277201197364861,0.00033662353652443006,456,233,223
13902,abused,5.6791843433898893e-05,4.330728224891437e-05,57,29,28
13903,abuser,1.9070323809907035e-05,1.9151826014460126e-05,23,9,14
13904,abusing,3.1644163684570994e-05,2.087721574549256e-05,31,17,14
13905,abusive,6.496483935243052e-06,1.742643628342769e-05,16,4,12
13906,abys,2.3052039770217305e-06,3.6233184351681345e-06,6,2,4
13907,abysmal,4.400843956132392e-06,1.8979287041356905e-06,3,2,1
13908,academic,5.4696203454788295e-05,4.8483451442011706e-05,57,28,29
13909,academy,1.9070323809907035e-05,5.348708166200577e-06,12,9,3
13910,accelerate,2.326160376812834e-05,8.79948762826546e-06,17,11,6
13911,accelerated,8.592123914353715e-06,1.742643628342769e-05,14,4,10
13912,accelerating,1.6974683830796368e-05,1.8979287041356905e-06,9,8,1
13913,accent,4.400843956132392e-06,8.79948762826546e-06,7,2,5
13914,accept,0.0001259479627445509,0.00013302754826260141,151,64,87
13915,acceptable,2.954852370546031e-05,1.2250267090330355e-05,24,15,9
13916,acceptance,1.6974683830796368e-05,8.79948762826546e-06,13,8,5
13917,accepted,3.1644163684570994e-05,3.122955413168725e-05,36,17,19
13918,accepting,2.326160376812834e-05,3.122955413168725e-05,31,12,19
13919,acces,0.0002935991610734039,0.00032972197760030013,371,157,214
13920,accessed,8.592123914353715e-06,3.6233184351681345e-06,6,4,2
13921,accessibility,4.400843956132392e-06,1.8979287041356905e-06,3,2,1
13922,accessible,1.0687763893464371e-05,1.3975656821362803e-05,13,5,8
13923,accessing,1.48790438516857e-05,5.348708166200577e-06,12,7,5
13924,accessory,4.400843956132392e-06,8.79948762826546e-06,9,3,6
13925,accident,7.774824322500554e-05,6.918812821440096e-05,92,40,52
13926,accidental,8.592123914353715e-06,3.6233184351681345e-06,7,5,2
13927,accidentally,3.1644163684570994e-05,3.640572332478458e-05,45,19,26
13928,accidently,2.095639979110664e-07,5.348708166200577e-06,3,0,3
13929,acclaimed,1.0687763893464371e-05,1.8979287041356905e-06,6,5,1
13930,accommodate,4.400843956132392e-06,3.6233184351681345e-06,4,2,2
13931,accommodating,2.3052039770217305e-06,3.6233184351681345e-06,3,1,2
13932,accommodation,8.592123914353715e-06,5.348708166200577e-06,9,5,4
13933,accompanied,1.9070323809907035e-05,7.074097897233022e-06,14,10,4
13934,accompany,8.592123914353715e-06,7.074097897233022e-06,8,4,4
13935,accompanying,4.400843956132392e-06,7.074097897233022e-06,6,2,4
13936,accomplice,1.0687763893464371e-05,1.8979287041356905e-06,6,5,1
13937,accomplish,1.9070323809907035e-05,5.348708166200577e-06,15,11,4
13938,accomplished,2.116596378901769e-05,1.570104655239525e-05,22,12,10
13939,accomplishing,2.3052039770217305e-06,3.6233184351681345e-06,4,1,3
13940,accomplishment,1.0687763893464371e-05,8.79948762826546e-06,10,5,5
13941,accord,3.1644163684570994e-05,1.9151826014460126e-05,33,17,16
13942,accordance,4.400843956132392e-06,5.348708166200577e-06,5,2,3
13943,according,0.0003627552803840558,0.00041426607442089007,466,197,269
13944,accordingly,2.095639979110664e-07,7.074097897233022e-06,4,0,4
13945,account,0.00029150352109429334,0.0002503540499728076,314,150,164
13946,accountability,4.212236358012434e-05,1.570104655239525e-05,33,21,12
13947,accountable,5.050492349656699e-05,4.50326719799468e-05,55,28,27
13948,accountant,4.400843956132392e-06,1.8979287041356905e-06,3,2,1
13949,accounted,6.496483935243052e-06,3.6233184351681345e-06,5,3,2
13950,accounting,1.48790438516857e-05,1.742643628342769e-05,20,9,11
13951,accredited,2.3052039770217305e-06,3.6233184351681345e-06,3,1,2
13952,accumulated,4.400843956132392e-06,1.2250267090330355e-05,11,4,7
13953,accuracy,2.116596378901769e-05,1.052487735929791e-05,16,10,6
13954,accurate,2.5357243747239038e-05,2.2602605476525032e-05,29,13,16
13955,accurately,1.278340387257504e-05,1.052487735929791e-05,14,7,7
13956,accus,0.00010918284291166549,9.334358444885519e-05,118,58,60
13957,accusation,6.307876337123095e-05,6.056117955923882e-05,73,35,38
13958,accusatory,4.400843956132392e-06,1.8979287041356905e-06,3,2,1
13959,accuse,3.7931083621902995e-05,3.640572332478458e-05,49,22,27
13960,accused,0.0005010675190053595,0.00042979458200018204,544,263,281
13961,accuser,2.326160376812834e-05,1.052487735929791e-05,17,11,6
13962,accusing,5.260056347567764e-05,4.50326719799468e-05,57,28,29
13963,accustomed,8.592123914353715e-06,7.074097897233022e-06,10,4,6
13964,ache,6.496483935243052e-06,1.8979287041356905e-06,4,3,1
13965,achieve,6.307876337123095e-05,5.1934230904076595e-05,64,32,32
13966,achieved,3.1644163684570994e-05,2.777877466962238e-05,35,16,19
13967,achievement,6.496483935243052e-06,3.122955413168725e-05,23,4,19
13968,achieving,1.0687763893464371e-05,8.79948762826546e-06,10,5,5
13969,acid,4.002672360101368e-05,3.8131113055817005e-05,42,19,23
13970,acknowledge,3.1644163684570994e-05,4.330728224891437e-05,43,16,27
13971,acknowledged,3.3739803663681634e-05,2.2602605476525032e-05,34,18,16
13972,acknowledging,8.592123914353715e-06,1.8979287041356905e-06,6,4,2
13973,acknowledgment,2.095639979110664e-07,1.8979287041356905e-06,3,0,3
13974,acoustic,4.400843956132392e-06,3.6233184351681345e-06,4,2,2
13975,acquire,1.0687763893464371e-05,8.79948762826546e-06,12,6,6
13976,acquired,6.496483935243052e-06,1.2250267090330355e-05,10,3,7
13977,acquiring,4.400843956132392e-06,3.6233184351681345e-06,5,2,3
13978,acquisition,6.496483935243052e-06,1.052487735929791e-05,10,4,6
13979,acquit,6.496483935243052e-06,3.6233184351681345e-06,5,3,2
13980,acquittal,6.496483935243052e-06,1.7253897310324457e-07,4,4,0
13981,acquitted,1.278340387257504e-05,1.2250267090330355e-05,14,7,7
13982,acre,2.326160376812834e-05,1.570104655239525e-05,21,11,10
13983,acros,0.00042143319979915414,0.00042634380253811694,502,226,276
13984,act,0.0002747384012614078,0.0002520794397038401,307,145,162
13985,acted,2.7452883726349685e-05,2.6053384938589907e-05,29,14,15
13986,acting,3.1644163684570994e-05,5.5385010366141504e-05,54,19,35
13987,action,0.0004444852395693713,0.0004435976998484416,534,240,294
13988,activate,6.496483935243052e-06,1.2250267090330355e-05,10,3,7
13989,activated,2.3052039770217305e-06,3.6233184351681345e-06,4,2,2
13990,active,5.4696203454788295e-05,4.1581892517881935e-05,55,28,27
13991,actively,2.116596378901769e-05,2.087721574549256e-05,22,10,12
13992,activism,1.6974683830796368e-05,2.4327995207557487e-05,23,8,15
13993,activist,0.00038790296013338374,0.00041771685388295495,481,212,269
13994,activity,0.00014271308257743603,0.00011922443041434203,150,73,77
13995,actor,3.583544364279237e-05,4.8483451442011706e-05,46,18,28
13996,actres,3.1644163684570994e-05,3.8131113055817005e-05,38,16,22
13997,actual,5.260056347567764e-05,4.50326719799468e-05,54,28,26
13998,actually,0.0002244430417627521,0.00025898099862796983,285,113,172
13999,acuman,2.095639979110664e-07,5.348708166200577e-06,4,1,3
14000,acute,4.400843956132392e-06,7.074097897233022e-06,6,2,4
14001,ad,0.00014271308257743603,0.00014510527637982858,168,72,96
14002,adage,2.3052039770217305e-06,5.348708166200577e-06,4,1,3
14003,adamant,2.3052039770217305e-06,1.8979287041356905e-06,3,2,1
14004,adamantly,2.095639979110664e-07,3.6233184351681345e-06,3,1,2
14005,adapt,1.48790438516857e-05,7.074097897233022e-06,14,8,6
14006,adaptation,4.400843956132392e-06,1.7253897310324457e-07,3,3,0
14007,adapted,2.3052039770217305e-06,3.6233184351681345e-06,3,1,2
14008,add,8.613080314144832e-05,7.781507686956326e-05,97,43,54
14009,added,5.888748341300963e-05,8.126585633162811e-05,84,32,52
14010,addict,2.326160376812834e-05,3.640572332478458e-05,35,12,23
14011,addicted,1.48790438516857e-05,7.074097897233022e-06,13,7,6
14012,addiction,4.4218003559234974e-05,4.50326719799468e-05,49,21,28
14013,adding,2.954852370546031e-05,3.985650278684949e-05,42,16,26
14014,addition,2.954852370546031e-05,2.4327995207557487e-05,31,15,16
14015,additional,3.583544364279237e-05,3.468033359375216e-05,44,21,23
14016,additive,2.3052039770217305e-06,7.074097897233022e-06,5,1,4
14017,addon,2.3052039770217305e-06,3.6233184351681345e-06,3,1,2
14018,addres,0.00017205204228498542,0.00016063378395912072,195,91,104
14019,addressed,2.116596378901769e-05,2.6053384938589907e-05,26,10,16
14020,addressing,2.116596378901769e-05,2.6053384938589907e-05,26,11,15
14021,adequate,1.6974683830796368e-05,1.742643628342769e-05,22,8,14
14022,adequately,1.0687763893464371e-05,1.052487735929791e-05,12,6,6
14023,adhere,2.3052039770217305e-06,3.6233184351681345e-06,3,1,2
14024,adjacent,4.400843956132392e-06,1.8979287041356905e-06,4,2,2
14025,adjust,2.3052039770217305e-06,8.79948762826546e-06,6,1,5
14026,adjusted,4.400843956132392e-06,5.348708166200577e-06,6,2,4
14027,adjustment,1.0687763893464371e-05,1.8979287041356905e-06,7,5,2
14028,admin,6.496483935243052e-06,3.6233184351681345e-06,6,3,3
14029,administered,6.496483935243052e-06,1.7253897310324457e-07,4,3,1
14030,administration,0.00036904220032138744,0.00040391373603469537,461,197,264
14031,administrative,1.278340387257504e-05,1.2250267090330355e-05,14,6,8
14032,administrator,1.278340387257504e-05,1.742643628342769e-05,17,7,10
14033,admirable,4.400843956132392e-06,7.074097897233022e-06,6,2,4
14034,admiral,6.496483935243052e-06,5.348708166200577e-06,7,3,4
14035,admiration,6.496483935243052e-06,8.79948762826546e-06,9,3,6
14036,admire,2.095639979110664e-07,3.6233184351681345e-06,3,1,2
14037,admired,2.3052039770217305e-06,7.074097897233022e-06,6,1,5
14038,admirer,4.400843956132392e-06,3.6233184351681345e-06,4,2,2
14039,admission,4.840928351745632e-05,8.79948762826546e-06,30,24,6
14040,admit,0.00019091280209698145,0.0002089446964280291,238,100,138
14041,admitted,7.146132328767358e-05,9.334358444885519e-05,100,42,58
14042,admitting,1.6974683830796368e-05,2.087721574549256e-05,22,9,13
14043,admonished,4.400843956132392e-06,7.074097897233022e-06,7,2,5
14044,admonition,2.3052039770217305e-06,1.8979287041356905e-06,3,2,1
14045,adolescent,1.0687763893464371e-05,1.3975656821362803e-05,18,8,10
14046,adopt,4.212236358012434e-05,3.2954943862719716e-05,44,22,22
14047,adopted,2.5357243747239038e-05,3.122955413168725e-05,32,13,19
14048,adopting,1.6974683830796368e-05,1.3975656821362803e-05,16,8,8
14049,adoption,3.3739803663681634e-05,4.330728224891437e-05,42,17,25
14050,adorable,1.0687763893464371e-05,7.074097897233022e-06,10,6,4
14051,adrift,6.496483935243052e-06,5.348708166200577e-06,7,3,4
14052,adult,0.00010499156295344414,0.0001036959228350498,124,54,70
14053,adultery,3.7931083621902995e-05,1.742643628342769e-05,33,18,15
14054,adulthood,4.400843956132392e-06,1.3975656821362803e-05,10,2,8
14055,advance,5.260056347567764e-05,7.608968713853079e-05,76,28,48
14056,advanced,3.1644163684570994e-05,4.6758061710979285e-05,47,17,30
14057,advancement,2.3052039770217305e-06,5.348708166200577e-06,4,1,3
14058,advancing,6.496483935243052e-06,8.79948762826546e-06,9,3,6
14059,advantage,5.4696203454788295e-05,5.020884117304414e-05,62,29,33
14060,adventure,1.278340387257504e-05,7.074097897233022e-06,10,6,4
14061,adversary,8.592123914353715e-06,8.79948762826546e-06,12,4,8
14062,adverse,2.3052039770217305e-06,5.348708166200577e-06,4,1,3
14063,adversity,2.095639979110664e-07,5.348708166200577e-06,3,0,3
14064,advert,1.6974683830796368e-05,1.3975656821362803e-05,19,8,11
14065,advertise,6.496483935243052e-06,3.6233184351681345e-06,6,3,3
14066,advertised,6.496483935243052e-06,3.6233184351681345e-06,6,3,3
14067,advertisement,2.116596378901769e-05,7.074097897233022e-06,15,10,5
14068,advertiser,2.095639979110664e-07,7.074097897233022e-06,4,0,4
14069,advertising,2.5357243747239038e-05,4.8483451442011706e-05,46,14,32
14070,advice,6.72700433294523e-05,8.126585633162811e-05,87,34,53
14071,advise,2.7452883726349685e-05,2.2602605476525032e-05,27,14,13
14072,advised,2.326160376812834e-05,2.2602605476525032e-05,26,12,14
14073,adviser,0.0001385218026192147,0.0001278513790695043,155,71,84
14074,advising,4.400843956132392e-06,7.074097897233022e-06,8,2,6
14075,advisor,2.116596378901769e-05,3.122955413168725e-05,31,12,19
14076,advisory,6.496483935243052e-06,1.9151826014460126e-05,17,5,12
14077,advocacy,1.48790438516857e-05,3.122955413168725e-05,26,8,18
14078,advocate,0.00011756540282810809,0.00014165449691776373,156,61,95
14079,advocated,4.400843956132392e-06,5.348708166200577e-06,5,2,3
14080,advocating,8.592123914353715e-06,2.087721574549256e-05,20,4,16
14081,aerial,8.592123914353715e-06,1.570104655239525e-05,14,5,9
14082,aerospace,4.400843956132392e-06,1.7253897310324457e-07,4,3,1
14083,affair,5.6791843433898893e-05,7.091351794543343e-05,75,30,45
14084,affect,8.822644312055891e-05,8.299124606266055e-05,102,46,56
14085,affected,6.517440335034157e-05,6.746273848336857e-05,81,36,45
14086,affecting,1.9070323809907035e-05,2.6053384938589907e-05,28,11,17
14087,affidavit,2.3052039770217305e-06,3.6233184351681345e-06,4,2,2
14088,affiliate,1.0687763893464371e-05,3.6233184351681345e-06,8,6,2
14089,affiliated,8.592123914353715e-06,8.79948762826546e-06,10,4,6
14090,affiliation,4.400843956132392e-06,8.79948762826546e-06,8,2,6
14091,affinity,6.496483935243052e-06,1.7253897310324457e-07,3,3,0
14092,affirm,8.592123914353715e-06,8.79948762826546e-06,10,4,6
14093,affirmative,6.496483935243052e-06,1.8979287041356905e-06,5,3,2
14094,afflict,4.400843956132392e-06,5.348708166200577e-06,5,2,3
14095,affluence,2.3052039770217305e-06,1.8979287041356905e-06,3,1,2
14096,affluent,4.400843956132392e-06,1.2250267090330355e-05,9,2,7
14097,afford,6.517440335034157e-05,5.883578982820635e-05,70,35,35
14098,affordability,2.095639979110664e-07,7.074097897233022e-06,5,0,5
14099,affordable,4.6313643538345614e-05,2.4327995207557487e-05,40,25,15
14100,afforded,2.3052039770217305e-06,3.6233184351681345e-06,3,1,2
14101,affront,6.496483935243052e-06,3.6233184351681345e-06,5,3,2
14102,afghan,8.592123914353715e-06,1.7253897310324457e-07,4,4,0
14103,afloat,4.400843956132392e-06,3.6233184351681345e-06,5,2,3
14104,afoot,6.496483935243052e-06,1.8979287041356905e-06,5,3,2
14105,afoul,4.400843956132392e-06,1.8979287041356905e-06,5,3,2
14106,afraid,4.840928351745632e-05,5.020884117304414e-05,59,27,32
14107,aftermath,2.5357243747239038e-05,3.8131113055817005e-05,37,13,24
14108,afternoon,2.954852370546031e-05,2.9504164400654783e-05,33,14,19
14109,aftershock,4.400843956132392e-06,1.7253897310324457e-07,4,3,1
14110,afterward,2.3052039770217305e-06,3.6233184351681345e-06,3,1,2
14111,again,4.400843956132392e-06,5.348708166200577e-06,5,2,3
14112,age,0.0001531912824729893,0.00022102242454525643,224,81,143
14113,aged,3.7931083621902995e-05,5.3659620635109e-05,56,24,32
14114,ageing,2.3052039770217305e-06,1.3975656821362803e-05,9,1,8
14115,agency,0.00039838116002893705,0.00038838522845540324,462,215,247
14116,agendum,0.00010708720293255492,8.816741525575797e-05,115,56,59
14117,agent,0.00014061744259832545,0.00013992910718673112,165,73,92
14118,ageold,2.3052039770217305e-06,3.6233184351681345e-06,4,1,3
14119,aggravate,2.3052039770217305e-06,3.6233184351681345e-06,4,1,3
14120,aggravated,1.0687763893464371e-05,7.074097897233022e-06,10,5,5
14121,aggression,3.583544364279237e-05,2.2602605476525032e-05,32,18,14
14122,aggressive,5.050492349656699e-05,2.9504164400654783e-05,49,28,21
14123,aggressively,1.48790438516857e-05,1.3975656821362803e-05,16,7,9
14124,aggressor,4.400843956132392e-06,7.074097897233022e-06,7,2,5
14125,aghast,4.400843956132392e-06,1.8979287041356905e-06,3,2,1
14126,aging,1.48790438516857e-05,1.9151826014460126e-05,20,8,12
14127,ago,0.00039838116002893705,0.00041426607442089007,476,210,266
14128,agonizing,6.496483935243052e-06,1.8979287041356905e-06,4,3,1
14129,agree,0.00017205204228498542,0.00017788768126944505,204,89,115
14130,agreed,9.24177230787802e-05,0.00010542131256608228,126,53,73
14131,agreeing,8.592123914353715e-06,1.3975656821362803e-05,14,4,10
14132,agreement,0.0001762433222432067,0.0001554576147660233,195,94,101
14133,agribusines,2.3052039770217305e-06,3.6233184351681345e-06,3,1,2
14134,agricultural,2.954852370546031e-05,2.777877466962238e-05,34,16,18
14135,agriculture,2.116596378901769e-05,2.087721574549256e-05,25,10,15
14136,aground,4.400843956132392e-06,3.6233184351681345e-06,4,2,2
14137,ahead,0.00024539944155385846,0.00023482554239351563,279,125,154
14138,ahole,4.400843956132392e-06,1.7253897310324457e-07,3,2,1
14139,aid,0.00035646836044672355,0.0003055665213658457,387,189,198
14140,aide,8.403516316233764e-05,0.00011059748175917965,111,43,68
14141,aided,1.48790438516857e-05,7.074097897233022e-06,11,7,4
14142,aiding,1.48790438516857e-05,1.2250267090330355e-05,15,8,7
14143,ailing,1.0687763893464371e-05,5.348708166200577e-06,8,5,3
14144,ailment,4.400843956132392e-06,1.8979287041356905e-06,3,2,1
14145,aim,0.00011127848289077625,0.0001364783277246665,144,57,87
14146,aimed,8.193952318322689e-05,8.126585633162811e-05,94,42,52
14147,aiming,1.6974683830796368e-05,8.79948762826546e-06,17,11,6
14148,aint,8.592123914353715e-06,1.3975656821362803e-05,14,5,9
14149,air,0.000304077360968957,0.00031074269055894344,369,159,210
14150,airbag,2.095639979110664e-07,5.348708166200577e-06,4,1,3
14151,airbase,4.400843956132392e-06,1.052487735929791e-05,8,2,6
14152,airborne,4.400843956132392e-06,3.6233184351681345e-06,4,2,2
14153,aircraft,9.660900303700153e-05,8.816741525575797e-05,111,54,57
14154,airdrop,4.400843956132392e-06,1.8979287041356905e-06,4,2,2
14155,aired,4.400843956132392e-06,1.2250267090330355e-05,10,3,7
14156,airing,8.592123914353715e-06,1.570104655239525e-05,13,4,9
14157,airlift,4.400843956132392e-06,1.8979287041356905e-06,3,2,1
14158,airline,6.307876337123095e-05,5.5385010366141504e-05,68,32,36
14159,airliner,8.592123914353715e-06,8.79948762826546e-06,9,4,5
14160,airman,6.496483935243052e-06,3.6233184351681345e-06,5,3,2
14161,airplane,8.592123914353715e-06,2.087721574549256e-05,17,5,12
14162,airport,0.00014690436253565753,0.00016063378395912072,182,73,109
14163,airspace,4.6313643538345614e-05,2.2602605476525032e-05,36,23,13
14164,airstrike,7.774824322500554e-05,8.299124606266055e-05,91,39,52
14165,airtime,6.496483935243052e-06,3.6233184351681345e-06,5,3,2
14166,airwave,2.3052039770217305e-06,5.348708166200577e-06,4,1,3
14167,aisle,1.0687763893464371e-05,8.79948762826546e-06,11,6,5
14168,aka,1.48790438516857e-05,8.79948762826546e-06,14,7,7
14169,akin,1.48790438516857e-05,5.348708166200577e-06,12,7,5
14170,al,5.888748341300963e-05,4.50326719799468e-05,63,32,31
14171,alAssad,4.4218003559234974e-05,2.087721574549256e-05,37,21,16
14172,alAwlaki,4.400843956132392e-06,3.6233184351681345e-06,4,2,2
14173,alBaghdadi,8.592123914353715e-06,8.79948762826546e-06,9,4,5
14174,alBashir,8.592123914353715e-06,3.6233184351681345e-06,6,4,2
14175,alIslam,2.3052039770217305e-06,7.074097897233022e-06,6,1,5
14176,alJazeera,8.592123914353715e-06,1.2250267090330355e-05,11,4,7
14177,alMabhouh,2.3052039770217305e-06,5.348708166200577e-06,5,2,3
14178,alMaliki,2.3052039770217305e-06,5.348708166200577e-06,6,1,5
14179,alMasri,2.3052039770217305e-06,3.6233184351681345e-06,3,1,2
14180,alMegrahi,4.400843956132392e-06,7.074097897233022e-06,6,2,4
14181,alNimr,4.400843956132392e-06,3.6233184351681345e-06,4,2,2
14182,alQaddafi,4.400843956132392e-06,1.8979287041356905e-06,3,2,1
14183,alQaeda,5.4696203454788295e-05,3.8131113055817005e-05,51,28,23
14184,alQaida,3.7931083621902995e-05,4.1581892517881935e-05,45,21,24
14185,alShabab,1.0687763893464371e-05,3.6233184351681345e-06,7,5,2
14186,alarm,3.583544364279237e-05,3.640572332478458e-05,41,18,23
14187,alarmed,2.326160376812834e-05,7.074097897233022e-06,17,12,5
14188,alarming,2.7452883726349685e-05,3.985650278684949e-05,38,15,23
14189,alarmingly,2.095639979110664e-07,5.348708166200577e-06,4,0,4
14190,albeit,2.095639979110664e-07,3.6233184351681345e-06,3,0,3
14191,albino,1.0687763893464371e-05,1.9151826014460126e-05,21,6,15
14192,album,6.496483935243052e-06,7.074097897233022e-06,8,3,5
14193,alcohol,3.7931083621902995e-05,4.50326719799468e-05,46,20,26
14194,alcoholic,8.592123914353715e-06,3.6233184351681345e-06,8,4,4
14195,alert,8.822644312055891e-05,7.608968713853079e-05,94,46,48
14196,alerted,8.592123914353715e-06,8.79948762826546e-06,10,4,6
14197,alga,2.3052039770217305e-06,8.79948762826546e-06,7,1,6
14198,algorithm,2.3052039770217305e-06,3.6233184351681345e-06,4,1,3
14199,alien,1.9070323809907035e-05,2.6053384938589907e-05,31,13,18
14200,alienated,2.3052039770217305e-06,3.6233184351681345e-06,3,1,2
14201,alienating,2.3052039770217305e-06,8.79948762826546e-06,6,1,5
14202,alienation,2.095639979110664e-07,5.348708166200577e-06,3,0,3
14203,alight,6.496483935243052e-06,5.348708166200577e-06,6,3,3
14204,align,8.592123914353715e-06,1.2250267090330355e-05,12,4,8
14205,aligned,6.496483935243052e-06,8.79948762826546e-06,8,3,5
14206,alignment,6.496483935243052e-06,1.8979287041356905e-06,5,3,2
14207,alike,2.954852370546031e-05,1.742643628342769e-05,27,15,12
14208,alive,9.870464301611217e-05,0.00011059748175917965,125,53,72
14209,all,1.278340387257504e-05,5.348708166200577e-06,10,6,4
14210,allegation,0.00016995640230587486,0.00018133846073150993,208,89,119
14211,allege,4.002672360101368e-05,3.985650278684949e-05,46,21,25
14212,alleged,0.0002055822819507562,0.00016408456342118544,211,105,106
14213,allegedly,0.0002055822819507562,0.00014165449691776373,200,104,96
14214,allegiance,1.9070323809907035e-05,1.3975656821362803e-05,18,10,8
14215,alleging,1.9070323809907035e-05,2.2602605476525032e-05,25,11,14
14216,allergic,2.095639979110664e-07,5.348708166200577e-06,4,1,3
14217,allergy,4.400843956132392e-06,1.7253897310324457e-07,3,2,1
14218,alleviate,2.3052039770217305e-06,5.348708166200577e-06,4,1,3
14219,alley,4.400843956132392e-06,1.7253897310324457e-07,3,2,1
14220,alliance,4.002672360101368e-05,5.3659620635109e-05,55,19,36
14221,allied,4.400843956132392e-06,8.79948762826546e-06,9,3,6
14222,allin,2.095639979110664e-07,3.6233184351681345e-06,3,0,3
14223,allocate,2.3052039770217305e-06,5.348708166200577e-06,4,1,3
14224,allocated,2.3052039770217305e-06,5.348708166200577e-06,4,1,3
14225,allout,1.278340387257504e-05,1.9151826014460126e-05,17,6,11
14226,allow,0.0003459901605511704,0.00035732821329681935,399,175,224
14227,allowance,1.48790438516857e-05,3.6233184351681345e-06,11,8,3
14228,allowed,0.00020767792192986646,0.0001916907991177046,226,104,122
14229,allowing,0.00013642616264010403,0.0001036959228350498,144,71,73
14230,alltime,1.278340387257504e-05,1.742643628342769e-05,19,7,12
14231,allweather,4.400843956132392e-06,1.7253897310324457e-07,3,2,1
14232,ally,0.00015947820241032126,0.00017616229153841266,197,79,118
14233,almost,0.0003292250407182847,0.0002986649624417165,363,172,191
14234,alone,8.403516316233764e-05,0.00011577365095227703,120,47,73
14235,along,0.00016995640230587486,0.00017098612234531542,206,90,116
14236,alongside,3.1644163684570994e-05,2.9504164400654783e-05,39,18,21
14237,already,0.00034179888059294886,0.0003694059414140463,405,176,229
14238,also,0.0007755963562688564,0.0008542404558341633,970,418,552
14239,altar,6.496483935243052e-06,1.8979287041356905e-06,4,3,1
14240,alter,1.9070323809907035e-05,1.9151826014460126e-05,23,10,13
14241,altered,4.400843956132392e-06,1.3975656821362803e-05,10,2,8
14242,altering,2.3052039770217305e-06,8.79948762826546e-06,7,2,5
14243,alternate,4.400843956132392e-06,1.8979287041356905e-06,3,2,1
14244,alternative,7.146132328767358e-05,8.816741525575797e-05,88,35,53
14245,although,3.7931083621902995e-05,2.9504164400654783e-05,41,20,21
14246,altitude,2.095639979110664e-07,1.8979287041356905e-06,3,1,2
14247,altogether,8.592123914353715e-06,2.6053384938589907e-05,21,6,15
14248,altright,2.3052039770217305e-06,1.3975656821362803e-05,9,1,8
14249,aluminium,2.095639979110664e-07,5.348708166200577e-06,3,0,3
14250,aluminum,2.3052039770217305e-06,5.348708166200577e-06,4,1,3
14251,alumnu,2.3052039770217305e-06,5.348708166200577e-06,4,1,3
14252,alway,0.00018672152213876006,0.00020376852723493182,238,100,138
14253,amas,2.3052039770217305e-06,1.8979287041356905e-06,3,1,2
14254,amassed,6.496483935243052e-06,1.8979287041356905e-06,5,3,2
14255,amassing,6.496483935243052e-06,1.8979287041356905e-06,4,3,1
14256,amateur,8.592123914353715e-06,5.348708166200577e-06,9,4,5
14257,amaze,2.095639979110664e-07,1.8979287041356905e-06,3,1,2
14258,amazed,4.400843956132392e-06,7.074097897233022e-06,6,2,4
14259,amazing,4.6313643538345614e-05,4.6758061710979285e-05,56,25,31
14260,amazingly,2.3052039770217305e-06,1.8979287041356905e-06,3,2,1
14261,ambassador,0.00014480872255654665,0.00014165449691776373,170,77,93
14262,ambiguou,4.400843956132392e-06,1.7253897310324457e-07,3,2,1
14263,ambition,1.9070323809907035e-05,2.777877466962238e-05,26,9,17
14264,ambitiou,2.116596378901769e-05,2.777877466962238e-05,29,11,18
14265,ambulance,8.592123914353715e-06,1.052487735929791e-05,12,6,6
14266,ambush,1.48790438516857e-05,1.052487735929791e-05,14,8,6
14267,ambushed,1.278340387257504e-05,7.074097897233022e-06,10,6,4
14268,amend,2.095639979110664e-07,3.6233184351681345e-06,4,1,3
14269,amended,2.3052039770217305e-06,7.074097897233022e-06,6,2,4
14270,amending,2.3052039770217305e-06,1.8979287041356905e-06,3,2,1
14271,amendment,4.002672360101368e-05,3.468033359375216e-05,46,22,24
14272,amid,0.00024959072151208,0.0001916907991177046,247,124,123
14273,amidst,1.48790438516857e-05,1.2250267090330355e-05,15,7,8
14274,ammo,4.400843956132392e-06,5.348708166200577e-06,5,2,3
14275,ammunition,3.3739803663681634e-05,1.9151826014460126e-05,32,19,13
14276,amnesty,1.48790438516857e-05,8.79948762826546e-06,15,8,7
14277,amok,1.0687763893464371e-05,3.6233184351681345e-06,7,5,2
14278,among,0.0002935991610734039,0.0003607789927588843,390,159,231
14279,amongst,1.48790438516857e-05,7.074097897233022e-06,11,7,4
14280,amoral,2.3052039770217305e-06,1.8979287041356905e-06,3,2,1
14281,amount,0.00014480872255654665,0.00016926073261428268,181,75,106
14282,amounted,1.0687763893464371e-05,8.79948762826546e-06,10,5,5
14283,amounting,4.400843956132392e-06,1.8979287041356905e-06,3,2,1
14284,amp,0.0009076216749528278,0.0007627948000894436,945,461,484
14285,amphetamine,2.095639979110664e-07,3.6233184351681345e-06,3,0,3
14286,ample,4.400843956132392e-06,3.6233184351681345e-06,4,2,2
14287,amputated,6.496483935243052e-06,1.7253897310324457e-07,3,3,0
14288,amputation,4.400843956132392e-06,7.074097897233022e-06,7,3,4
14289,amputee,6.496483935243052e-06,1.8979287041356905e-06,5,3,2
14290,an,2.095639979110664e-07,3.6233184351681345e-06,3,0,3
14291,anal,2.3052039770217305e-06,3.6233184351681345e-06,3,1,2
14292,analysi,4.4218003559234974e-05,6.056117955923882e-05,65,26,39
14293,analyst,4.4218003559234974e-05,3.640572332478458e-05,47,26,21
14294,analytic,6.496483935243052e-06,1.8979287041356905e-06,4,3,1
14295,analytical,4.400843956132392e-06,3.6233184351681345e-06,4,2,2
14296,analyze,4.400843956132392e-06,1.2250267090330355e-05,10,2,8
14297,analyzed,6.496483935243052e-06,8.79948762826546e-06,8,3,5
14298,analyzing,6.496483935243052e-06,5.348708166200577e-06,7,3,4
14299,anarchist,1.48790438516857e-05,8.79948762826546e-06,15,9,6
14300,anarchy,6.496483935243052e-06,5.348708166200577e-06,7,3,4
14301,ancestor,4.400843956132392e-06,1.2250267090330355e-05,12,4,8
14302,ancestral,4.400843956132392e-06,1.052487735929791e-05,10,2,8
14303,ancestry,6.496483935243052e-06,1.8979287041356905e-06,4,3,1
14304,anchor,3.583544364279237e-05,2.777877466962238e-05,38,22,16
14305,ancient,0.00012385232276544028,9.679436391092026e-05,134,66,68
14306,and,8.592123914353715e-06,1.052487735929791e-05,11,4,7
14307,andor,1.278340387257504e-05,1.052487735929791e-05,12,6,6
14308,anesthetic,2.3052039770217305e-06,3.6233184351681345e-06,3,1,2
14309,angel,2.3052039770217305e-06,8.79948762826546e-06,6,1,5
14310,anger,7.565260324589493e-05,9.161819471782287e-05,101,39,62
14311,angered,1.0687763893464371e-05,1.9151826014460126e-05,23,6,17
14312,angering,4.400843956132392e-06,5.348708166200577e-06,5,2,3
14313,angle,6.496483935243052e-06,5.348708166200577e-06,7,3,4
14314,angrily,1.278340387257504e-05,1.2250267090330355e-05,13,6,7
14315,angry,7.146132328767358e-05,8.989280498679035e-05,96,39,57
14316,angst,2.095639979110664e-07,3.6233184351681345e-06,3,0,3
14317,anguish,4.400843956132392e-06,5.348708166200577e-06,5,2,3
14318,animal,0.00022025176180453062,0.00020721930669699654,246,115,131
14319,animation,2.3052039770217305e-06,3.6233184351681345e-06,3,1,2
14320,animosity,4.400843956132392e-06,3.6233184351681345e-06,5,3,2
14321,animu,2.3052039770217305e-06,5.348708166200577e-06,4,1,3
14322,ankle,4.400843956132392e-06,7.074097897233022e-06,6,2,4
14323,annex,4.400843956132392e-06,1.052487735929791e-05,9,2,7
14324,annexation,2.7452883726349685e-05,1.570104655239525e-05,22,13,9
14325,annexed,2.3052039770217305e-06,1.052487735929791e-05,7,1,6
14326,annihilation,4.400843956132392e-06,1.8979287041356905e-06,3,2,1
14327,anniversary,9.03220830996695e-05,8.644202552472544e-05,98,45,53
14328,announce,0.00016366948236854273,0.0001347529379936339,167,81,86
14329,announced,0.00021396484186719832,0.00023310015266248305,266,117,149
14330,announcement,5.4696203454788295e-05,5.3659620635109e-05,66,30,36
14331,announcing,3.1644163684570994e-05,1.3975656821362803e-05,25,16,9
14332,annoyed,2.3052039770217305e-06,5.348708166200577e-06,5,1,4
14333,annoying,6.496483935243052e-06,7.074097897233022e-06,8,3,5
14334,annual,0.00011127848289077625,0.00010887209202814718,127,58,69
14335,annually,2.954852370546031e-05,1.570104655239525e-05,25,15,10
14336,annuity,4.400843956132392e-06,1.8979287041356905e-06,3,2,1
14337,annulled,2.3052039770217305e-06,3.6233184351681345e-06,3,1,2
14338,anomaly,6.496483935243052e-06,5.348708166200577e-06,6,3,3
14339,anonymity,1.278340387257504e-05,7.074097897233022e-06,11,7,4
14340,anonymou,2.954852370546031e-05,2.777877466962238e-05,33,15,18
14341,anonymously,4.400843956132392e-06,1.8979287041356905e-06,3,2,1
14342,another,0.0003941898800707157,0.0004953593917794149,523,209,314
14343,answer,0.00016576512234765329,0.00017616229153841266,199,81,118
14344,answered,8.592123914353715e-06,5.348708166200577e-06,9,5,4
14345,answering,1.0687763893464371e-05,7.074097897233022e-06,9,5,4
14346,ant,2.3052039770217305e-06,5.348708166200577e-06,4,1,3
14347,antagonist,4.400843956132392e-06,3.6233184351681345e-06,4,2,2
14348,antelope,2.095639979110664e-07,5.348708166200577e-06,4,1,3
14349,anthem,1.48790438516857e-05,8.79948762826546e-06,12,7,5
14350,anthrax,6.496483935243052e-06,1.8979287041356905e-06,4,3,1
14351,anthropologist,2.3052039770217305e-06,8.79948762826546e-06,6,1,5
14352,anti,4.400843956132392e-06,1.570104655239525e-05,12,2,10
14353,antiAmerican,6.496483935243052e-06,3.6233184351681345e-06,8,4,4
14354,antiArab,4.400843956132392e-06,3.6233184351681345e-06,5,3,2
14355,antiChristian,4.400843956132392e-06,5.348708166200577e-06,5,2,3
14356,antiISI,1.0687763893464371e-05,5.348708166200577e-06,10,5,5
14357,antiIslam,1.48790438516857e-05,2.4327995207557487e-05,23,7,16
14358,antiIslamic,8.592123914353715e-06,5.348708166200577e-06,8,5,3
14359,antiIslamist,2.3052039770217305e-06,5.348708166200577e-06,4,1,3
14360,antiIslamization,2.3052039770217305e-06,3.6233184351681345e-06,3,1,2
14361,antiIsrael,8.592123914353715e-06,7.074097897233022e-06,8,4,4
14362,antiJewish,4.400843956132392e-06,3.6233184351681345e-06,5,3,2
14363,antiLGBT,2.3052039770217305e-06,5.348708166200577e-06,4,1,3
14364,antiLGBTQ,2.3052039770217305e-06,7.074097897233022e-06,6,1,5
14365,antiMuslim,3.3739803663681634e-05,2.777877466962238e-05,32,16,16
14366,antiPutin,6.496483935243052e-06,1.7253897310324457e-07,3,3,0
14367,antiRussia,2.3052039770217305e-06,3.6233184351681345e-06,3,1,2
14368,antiSemite,2.095639979110664e-07,8.79948762826546e-06,5,0,5
14369,antiSemitic,1.6974683830796368e-05,1.742643628342769e-05,23,12,11
14370,antiSemitism,1.6974683830796368e-05,2.9504164400654783e-05,26,9,17
14371,antiTrump,1.278340387257504e-05,1.2250267090330355e-05,14,7,7
14372,antiU,4.400843956132392e-06,3.6233184351681345e-06,4,2,2
14373,antiZionist,4.400843956132392e-06,1.7253897310324457e-07,3,2,1
14374,antiabortion,3.1644163684570994e-05,2.087721574549256e-05,28,15,13
14375,antiaircraft,6.496483935243052e-06,1.742643628342769e-05,13,3,10
14376,antiausterity,2.3052039770217305e-06,5.348708166200577e-06,5,2,3
14377,antibiotic,2.954852370546031e-05,1.2250267090330355e-05,26,18,8
14378,antic,1.0687763893464371e-05,1.8979287041356905e-06,7,5,2
14379,anticapitalism,4.400843956132392e-06,1.8979287041356905e-06,4,2,2
14380,anticipate,1.0687763893464371e-05,7.074097897233022e-06,9,5,4
14381,anticipated,1.9070323809907035e-05,8.79948762826546e-06,14,9,5
14382,anticipating,2.3052039770217305e-06,5.348708166200577e-06,4,1,3
14383,anticipation,6.496483935243052e-06,8.79948762826546e-06,9,3,6
14384,anticorruption,2.116596378901769e-05,3.2954943862719716e-05,34,15,19
14385,antidemocratic,2.3052039770217305e-06,3.6233184351681345e-06,5,2,3
14386,antidepressant,6.496483935243052e-06,1.8979287041356905e-06,4,3,1
14387,antidiscrimination,4.400843956132392e-06,7.074097897233022e-06,6,2,4
14388,antidote,4.400843956132392e-06,5.348708166200577e-06,5,2,3
14389,antidrug,2.116596378901769e-05,7.074097897233022e-06,14,10,4
14390,antiestablishment,8.592123914353715e-06,3.6233184351681345e-06,6,4,2
14391,antifracking,2.3052039770217305e-06,8.79948762826546e-06,6,1,5
14392,antigay,2.7452883726349685e-05,3.8131113055817005e-05,38,15,23
14393,antigovernment,2.5357243747239038e-05,3.985650278684949e-05,39,15,24
14394,antigraft,4.400843956132392e-06,3.6233184351681345e-06,4,2,2
14395,antihomosexuality,6.496483935243052e-06,1.8979287041356905e-06,4,3,1
14396,antiimmigrant,1.48790438516857e-05,1.570104655239525e-05,17,7,10
14397,antiimmigration,6.496483935243052e-06,5.348708166200577e-06,9,4,5
14398,antimalaria,2.3052039770217305e-06,3.6233184351681345e-06,3,1,2
14399,antimissile,6.496483935243052e-06,7.074097897233022e-06,8,3,5
14400,antinuclear,6.496483935243052e-06,3.6233184351681345e-06,6,4,2
14401,antipersonnel,2.095639979110664e-07,3.6233184351681345e-06,3,1,2
14402,antipiracy,1.0687763893464371e-05,1.3975656821362803e-05,13,5,8
14403,antipoaching,4.400843956132392e-06,7.074097897233022e-06,6,2,4
14404,antipolice,4.400843956132392e-06,1.8979287041356905e-06,3,2,1
14405,antipoverty,4.400843956132392e-06,3.6233184351681345e-06,5,2,3
14406,antiquated,4.400843956132392e-06,8.79948762826546e-06,7,2,5
14407,antique,2.3052039770217305e-06,3.6233184351681345e-06,3,1,2
14408,antiquity,1.278340387257504e-05,7.074097897233022e-06,12,8,4
14409,antiracism,4.400843956132392e-06,3.6233184351681345e-06,4,2,2
14410,antirape,2.095639979110664e-07,5.348708166200577e-06,3,0,3
14411,antirefugee,2.3052039770217305e-06,5.348708166200577e-06,4,1,3
14412,antiregime,4.400843956132392e-06,1.8979287041356905e-06,4,2,2
14413,antiretroviral,2.3052039770217305e-06,1.8979287041356905e-06,3,1,2
14414,antiscience,2.3052039770217305e-06,3.6233184351681345e-06,3,1,2
14415,antisemitic,4.400843956132392e-06,3.6233184351681345e-06,4,2,2
14416,antisemitism,6.496483935243052e-06,3.6233184351681345e-06,5,3,2
14417,antisocial,8.592123914353715e-06,1.8979287041356905e-06,5,4,1
14418,antitank,2.095639979110664e-07,1.052487735929791e-05,6,0,6
14419,antiterror,4.6313643538345614e-05,2.777877466962238e-05,41,24,17
14420,antiterrorism,1.48790438516857e-05,1.2250267090330355e-05,15,7,8
14421,antiterrorist,8.592123914353715e-06,7.074097897233022e-06,8,4,4
14422,antithetical,4.400843956132392e-06,1.8979287041356905e-06,3,2,1
14423,antitran,2.3052039770217305e-06,3.6233184351681345e-06,4,2,2
14424,antitrust,6.496483935243052e-06,1.9151826014460126e-05,16,4,12
14425,antiunion,2.095639979110664e-07,5.348708166200577e-06,4,1,3
14426,antivaccine,2.095639979110664e-07,3.6233184351681345e-06,3,0,3
14427,antiwar,8.592123914353715e-06,1.2250267090330355e-05,13,6,7
14428,anu,2.3052039770217305e-06,1.8979287041356905e-06,4,2,2
14429,anxiety,2.326160376812834e-05,1.2250267090330355e-05,24,14,10
14430,anxiou,1.48790438516857e-05,7.074097897233022e-06,13,9,4
14431,anybody,2.5357243747239038e-05,3.122955413168725e-05,36,14,22
14432,anymore,5.260056347567764e-05,5.020884117304414e-05,60,27,33
14433,anyone,0.0002349212416583052,0.0001916907991177046,241,121,120
14434,anything,0.0001531912824729893,0.0001382037174556987,166,76,90
14435,anytime,1.6974683830796368e-05,7.074097897233022e-06,12,8,4
14436,anyway,3.7931083621902995e-05,6.918812821440096e-05,63,21,42
14437,anywhere,4.4218003559234974e-05,3.985650278684949e-05,54,25,29
14438,apart,5.050492349656699e-05,5.5385010366141504e-05,63,26,37
14439,apartheid,3.7931083621902995e-05,2.4327995207557487e-05,32,18,14
14440,apartment,3.583544364279237e-05,3.8131113055817005e-05,46,20,26
14441,apathy,2.3052039770217305e-06,8.79948762826546e-06,7,1,6
14442,ape,8.592123914353715e-06,5.348708166200577e-06,9,5,4
14443,apocalypse,1.278340387257504e-05,1.3975656821362803e-05,16,8,8
14444,apocalyptic,6.496483935243052e-06,7.074097897233022e-06,8,3,5
14445,apolitical,4.400843956132392e-06,1.8979287041356905e-06,3,2,1
14446,apologise,1.6974683830796368e-05,1.9151826014460126e-05,23,8,15
14447,apologised,1.278340387257504e-05,5.348708166200577e-06,10,7,3
14448,apologist,6.496483935243052e-06,1.7253897310324457e-07,3,3,0
14449,apologize,6.307876337123095e-05,3.468033359375216e-05,55,31,24
14450,apologized,1.278340387257504e-05,1.052487735929791e-05,17,7,10
14451,apologizing,2.3052039770217305e-06,5.348708166200577e-06,4,1,3
14452,apology,3.583544364279237e-05,5.020884117304414e-05,58,21,37
14453,apostasy,2.3052039770217305e-06,1.052487735929791e-05,8,1,7
14454,apostate,2.095639979110664e-07,5.348708166200577e-06,3,0,3
14455,app,8.822644312055891e-05,6.056117955923882e-05,88,46,42
14456,appalled,1.48790438516857e-05,7.074097897233022e-06,11,7,4
14457,appalling,1.6974683830796368e-05,7.074097897233022e-06,12,8,4
14458,apparatus,2.3052039770217305e-06,1.8979287041356905e-06,3,1,2
14459,apparel,6.496483935243052e-06,5.348708166200577e-06,6,3,3
14460,apparent,3.1644163684570994e-05,5.3659620635109e-05,50,15,35
14461,apparently,9.03220830996695e-05,0.00010714670229711469,119,49,70
14462,appeal,0.00019091280209698145,0.0001382037174556987,193,97,96
14463,appealed,1.0687763893464371e-05,1.052487735929791e-05,12,5,7
14464,appealing,1.278340387257504e-05,7.074097897233022e-06,12,8,4
14465,appear,0.0002097735619089774,0.0002313747629314509,271,121,150
14466,appearance,6.098312339212028e-05,5.020884117304414e-05,65,30,35
14467,appeared,0.00010289592297433347,9.334358444885519e-05,110,56,54
14468,appearing,4.400843956132392e-06,1.742643628342769e-05,14,2,12
14469,appease,8.592123914353715e-06,5.348708166200577e-06,7,4,3
14470,appeasement,2.3052039770217305e-06,3.6233184351681345e-06,3,1,2
14471,appeasing,4.400843956132392e-06,1.7253897310324457e-07,3,3,0
14472,appellate,4.400843956132392e-06,1.8979287041356905e-06,4,2,2
14473,appetite,2.3052039770217305e-06,5.348708166200577e-06,5,1,4
14474,applaud,1.6974683830796368e-05,7.074097897233022e-06,12,8,4
14475,applauded,1.0687763893464371e-05,5.348708166200577e-06,9,5,4
14476,applause,8.592123914353715e-06,8.79948762826546e-06,9,4,5
14477,apple,4.400843956132392e-06,1.570104655239525e-05,12,2,10
14478,appliance,2.3052039770217305e-06,3.6233184351681345e-06,6,2,4
14479,applicable,2.3052039770217305e-06,3.6233184351681345e-06,3,1,2
14480,applicant,1.9070323809907035e-05,1.2250267090330355e-05,17,9,8
14481,application,5.4696203454788295e-05,2.4327995207557487e-05,47,29,18
14482,applied,1.9070323809907035e-05,1.742643628342769e-05,21,10,11
14483,apply,6.72700433294523e-05,9.334358444885519e-05,93,34,59
14484,applying,6.496483935243052e-06,1.2250267090330355e-05,13,4,9
14485,appoint,2.326160376812834e-05,1.9151826014460126e-05,24,12,12
14486,appointed,3.7931083621902995e-05,2.2602605476525032e-05,32,18,14
14487,appointee,2.116596378901769e-05,2.2602605476525032e-05,24,11,13
14488,appointing,2.3052039770217305e-06,3.6233184351681345e-06,3,1,2
14489,appointment,8.592123914353715e-06,2.777877466962238e-05,24,5,19
14490,appraisal,2.3052039770217305e-06,1.8979287041356905e-06,3,2,1
14491,appreciate,1.9070323809907035e-05,1.2250267090330355e-05,19,10,9
14492,appreciated,4.400843956132392e-06,5.348708166200577e-06,5,2,3
14493,appreciation,2.3052039770217305e-06,1.8979287041356905e-06,4,1,3
14494,apprehend,2.095639979110664e-07,5.348708166200577e-06,4,1,3
14495,apprehended,6.496483935243052e-06,5.348708166200577e-06,6,3,3
14496,approach,0.00011127848289077625,0.00015028144557292604,152,56,96
14497,approached,1.48790438516857e-05,1.570104655239525e-05,17,8,9
14498,approaching,2.5357243747239038e-05,1.742643628342769e-05,24,12,12
14499,appropriate,2.954852370546031e-05,2.4327995207557487e-05,31,16,15
14500,appropriation,2.095639979110664e-07,8.79948762826546e-06,5,0,5
14501,approval,8.822644312055891e-05,8.4716635793693e-05,97,43,54
14502,approve,0.00010080028299522283,8.644202552472544e-05,115,56,59
14503,approved,0.00010918284291166549,0.00010024514337298497,127,61,66
14504,approving,4.400843956132392e-06,1.570104655239525e-05,11,2,9
14505,approx,2.095639979110664e-07,5.348708166200577e-06,3,0,3
14506,approximately,1.6974683830796368e-05,2.9504164400654783e-05,27,8,19
14507,apt,4.400843956132392e-06,1.8979287041356905e-06,4,3,1
14508,aquatic,6.496483935243052e-06,1.7253897310324457e-07,3,3,0
14509,aquifer,6.496483935243052e-06,5.348708166200577e-06,6,3,3
14510,arab,2.3052039770217305e-06,3.6233184351681345e-06,3,1,2
14511,arable,2.3052039770217305e-06,5.348708166200577e-06,4,1,3
14512,arbitrarily,2.3052039770217305e-06,3.6233184351681345e-06,3,1,2
14513,arbitrary,6.496483935243052e-06,1.052487735929791e-05,10,3,7
14514,arbitration,1.48790438516857e-05,5.348708166200577e-06,10,7,3
14515,arc,2.3052039770217305e-06,1.8979287041356905e-06,5,1,4
14516,arcane,2.3052039770217305e-06,7.074097897233022e-06,5,1,4
14517,arch,4.400843956132392e-06,5.348708166200577e-06,5,2,3
14518,archaeological,1.278340387257504e-05,1.052487735929791e-05,12,6,6
14519,archaeologist,2.5357243747239038e-05,2.4327995207557487e-05,27,12,15
14520,archaic,6.496483935243052e-06,5.348708166200577e-06,6,3,3
14521,archbishop,4.400843956132392e-06,7.074097897233022e-06,8,4,4
14522,archeological,2.3052039770217305e-06,5.348708166200577e-06,4,1,3
14523,architect,1.0687763893464371e-05,1.052487735929791e-05,12,6,6
14524,architecture,1.48790438516857e-05,7.074097897233022e-06,13,9,4
14525,archive,2.326160376812834e-05,1.2250267090330355e-05,19,12,7
14526,arctic,2.3052039770217305e-06,3.6233184351681345e-06,3,1,2
14527,are,4.400843956132392e-06,3.6233184351681345e-06,5,2,3
14528,area,0.00024959072151208,0.00027796028566932717,315,133,182
14529,aren,2.116596378901769e-05,3.122955413168725e-05,31,12,19
14530,arena,1.278340387257504e-05,1.2250267090330355e-05,13,6,7
14531,arguably,8.592123914353715e-06,5.348708166200577e-06,8,5,3
14532,argue,9.03220830996695e-05,8.989280498679035e-05,102,46,56
14533,argued,4.212236358012434e-05,5.711040009717395e-05,57,22,35
14534,arguing,3.583544364279237e-05,3.2954943862719716e-05,37,17,20
14535,argument,6.307876337123095e-05,8.299124606266055e-05,85,34,51
14536,arise,1.0687763893464371e-05,7.074097897233022e-06,9,5,4
14537,arithmetic,4.400843956132392e-06,1.8979287041356905e-06,3,2,1
14538,arm,0.00024120816159563723,0.00023482554239351563,285,134,151
14539,armament,4.400843956132392e-06,1.7253897310324457e-07,3,3,0
14540,armband,2.3052039770217305e-06,1.7253897310324457e-07,3,3,0
14541,armed,0.0001154697628489974,0.0001364783277246665,152,61,91
14542,arming,8.592123914353715e-06,1.570104655239525e-05,14,5,9
14543,armistice,2.3052039770217305e-06,7.074097897233022e-06,5,1,4
14544,armor,4.400843956132392e-06,3.6233184351681345e-06,4,2,2
14545,armored,1.9070323809907035e-05,1.052487735929791e-05,17,11,6
14546,armour,2.095639979110664e-07,5.348708166200577e-06,5,2,3
14547,armoured,2.3052039770217305e-06,8.79948762826546e-06,6,1,5
14548,army,0.00036694656034227697,0.0003003903521727485,390,192,198
14549,around,0.000559745438420458,0.0004970847815104472,609,293,316
14550,arrange,6.496483935243052e-06,5.348708166200577e-06,6,3,3
14551,arranged,1.0687763893464371e-05,8.79948762826546e-06,10,5,5
14552,arrangement,6.496483935243052e-06,8.79948762826546e-06,8,3,5
14553,arranging,2.095639979110664e-07,7.074097897233022e-06,4,0,4
14554,array,8.592123914353715e-06,1.3975656821362803e-05,13,5,8
14555,arrest,0.00035437272046761313,0.0003176442494830731,391,181,210
14556,arrested,0.00046753727933958864,0.0004919086123173498,575,247,328
14557,arresting,1.48790438516857e-05,1.570104655239525e-05,17,7,10
14558,arrival,2.326160376812834e-05,1.742643628342769e-05,23,11,12
14559,arrive,4.002672360101368e-05,4.6758061710979285e-05,52,21,31
14560,arrived,6.098312339212028e-05,4.1581892517881935e-05,63,34,29
14561,arriving,1.6974683830796368e-05,8.79948762826546e-06,17,9,8
14562,arrogance,6.496483935243052e-06,8.79948762826546e-06,10,5,5
14563,arrogant,4.400843956132392e-06,8.79948762826546e-06,7,2,5
14564,arrow,6.496483935243052e-06,1.2250267090330355e-05,11,3,8
14565,arsenal,2.326160376812834e-05,2.777877466962238e-05,30,13,17
14566,arson,1.0687763893464371e-05,8.79948762826546e-06,11,6,5
14567,art,7.774824322500554e-05,6.573734875233614e-05,80,40,40
14568,article,0.00012385232276544028,0.00017788768126944505,172,63,109
14569,articulate,2.3052039770217305e-06,3.6233184351681345e-06,3,1,2
14570,artifact,1.9070323809907035e-05,1.9151826014460126e-05,24,12,12
14571,artificial,2.116596378901769e-05,3.2954943862719716e-05,30,10,20
14572,artificially,6.496483935243052e-06,7.074097897233022e-06,7,3,4
14573,artillery,4.840928351745632e-05,1.742643628342769e-05,41,26,15
14574,artist,8.613080314144832e-05,5.883578982820635e-05,81,44,37
14575,artwork,8.592123914353715e-06,1.8979287041356905e-06,5,4,1
14576,as,1.48790438516857e-05,1.052487735929791e-05,13,7,6
14577,asbesto,4.400843956132392e-06,5.348708166200577e-06,9,6,3
14578,ascent,2.3052039770217305e-06,1.7253897310324457e-07,3,2,1
14579,ash,2.5357243747239038e-05,3.640572332478458e-05,35,13,22
14580,ashamed,2.326160376812834e-05,1.570104655239525e-05,21,12,9
14581,ashore,1.0687763893464371e-05,7.074097897233022e-06,9,5,4
14582,aside,3.3739803663681634e-05,3.985650278684949e-05,43,17,26
14583,ask,0.00027683404124051843,0.00027105872674519724,320,147,173
14584,asked,0.0002642602013658546,0.0002400017115866128,288,137,151
14585,asking,8.403516316233764e-05,0.00012094982014537423,128,47,81
14586,asleep,1.278340387257504e-05,1.3975656821362803e-05,14,6,8
14587,aspect,2.326160376812834e-05,2.777877466962238e-05,29,13,16
14588,aspiration,1.0687763893464371e-05,1.570104655239525e-05,16,6,10
14589,aspirational,2.3052039770217305e-06,1.8979287041356905e-06,3,2,1
14590,aspire,4.400843956132392e-06,1.8979287041356905e-06,3,2,1
14591,assailant,4.400843956132392e-06,7.074097897233022e-06,6,2,4
14592,assassin,8.592123914353715e-06,1.052487735929791e-05,12,5,7
14593,assassinate,1.48790438516857e-05,7.074097897233022e-06,12,8,4
14594,assassinated,2.116596378901769e-05,3.2954943862719716e-05,30,10,20
14595,assassinating,4.400843956132392e-06,7.074097897233022e-06,6,2,4
14596,assassination,7.774824322500554e-05,5.3659620635109e-05,75,40,35
14597,assault,0.0002244430417627521,0.00017961307100047735,229,115,114
14598,assaulted,2.7452883726349685e-05,5.5385010366141504e-05,50,14,36
14599,assaulting,1.6974683830796368e-05,1.742643628342769e-05,19,8,11
14600,assaultstyle,2.3052039770217305e-06,1.8979287041356905e-06,3,1,2
14601,assemble,6.496483935243052e-06,3.6233184351681345e-06,5,3,2
14602,assembled,4.400843956132392e-06,8.79948762826546e-06,7,2,5
14603,assembling,6.496483935243052e-06,7.074097897233022e-06,7,3,4
14604,assembly,2.326160376812834e-05,3.2954943862719716e-05,35,13,22
14605,assert,1.0687763893464371e-05,1.2250267090330355e-05,13,5,8
14606,asserted,2.095639979110664e-07,5.348708166200577e-06,3,0,3
14607,assertion,1.0687763893464371e-05,5.348708166200577e-06,8,5,3
14608,assessed,4.400843956132392e-06,5.348708166200577e-06,5,2,3
14609,assessing,2.3052039770217305e-06,3.6233184351681345e-06,3,1,2
14610,assessment,1.6974683830796368e-05,2.6053384938589907e-05,26,9,17
14611,asset,8.193952318322689e-05,6.746273848336857e-05,85,42,43
14612,assigned,2.3052039770217305e-06,1.052487735929791e-05,7,1,6
14613,assignment,1.0687763893464371e-05,8.79948762826546e-06,11,5,6
14614,assist,1.278340387257504e-05,1.052487735929791e-05,14,8,6
14615,assistance,3.1644163684570994e-05,3.8131113055817005e-05,40,16,24
14616,assistant,1.0687763893464371e-05,1.3975656821362803e-05,14,5,9
14617,assisted,6.496483935243052e-06,1.052487735929791e-05,10,4,6
14618,assisting,1.0687763893464371e-05,8.79948762826546e-06,10,5,5
14619,associate,2.5357243747239038e-05,2.2602605476525032e-05,25,12,13
14620,associated,4.002672360101368e-05,2.777877466962238e-05,39,20,19
14621,association,2.5357243747239038e-05,1.742643628342769e-05,23,13,10
14622,assorted,2.3052039770217305e-06,1.8979287041356905e-06,3,2,1
14623,assume,2.5357243747239038e-05,2.4327995207557487e-05,28,13,15
14624,assumed,1.48790438516857e-05,1.570104655239525e-05,18,8,10
14625,assuming,2.3052039770217305e-06,1.052487735929791e-05,7,1,6
14626,assumption,8.592123914353715e-06,1.3975656821362803e-05,13,4,9
14627,assurance,6.496483935243052e-06,1.3975656821362803e-05,12,4,8
14628,assure,1.278340387257504e-05,7.074097897233022e-06,10,6,4
14629,assured,1.48790438516857e-05,1.2250267090330355e-05,16,9,7
14630,asteroid,2.5357243747239038e-05,8.79948762826546e-06,17,12,5
14631,astonished,4.400843956132392e-06,5.348708166200577e-06,6,3,3
14632,astonishing,1.6974683830796368e-05,8.79948762826546e-06,14,8,6
14633,astounding,1.48790438516857e-05,7.074097897233022e-06,11,7,4
14634,astronaut,2.954852370546031e-05,1.742643628342769e-05,26,16,10
14635,astronomer,6.496483935243052e-06,5.348708166200577e-06,7,4,3
14636,astronomical,1.0687763893464371e-05,1.8979287041356905e-06,6,5,1
14637,asylum,0.00015738256243121094,0.00016926073261428268,189,84,105
14638,asylumseeker,1.6974683830796368e-05,8.79948762826546e-06,14,8,6
14639,at,2.3052039770217305e-06,3.6233184351681345e-06,3,1,2
14640,ate,1.0687763893464371e-05,8.79948762826546e-06,11,6,5
14641,atheism,8.592123914353715e-06,1.8979287041356905e-06,6,4,2
14642,atheist,4.840928351745632e-05,3.2954943862719716e-05,45,25,20
14643,athlete,4.840928351745632e-05,2.9504164400654783e-05,43,24,19
14644,athletic,4.400843956132392e-06,8.79948762826546e-06,7,2,5
14645,atmosphere,1.278340387257504e-05,2.777877466962238e-05,25,8,17
14646,atmospheric,4.400843956132392e-06,1.8979287041356905e-06,3,2,1
14647,atoll,4.400843956132392e-06,1.8979287041356905e-06,3,2,1
14648,atom,8.592123914353715e-06,5.348708166200577e-06,8,4,4
14649,atomic,2.7452883726349685e-05,3.468033359375216e-05,35,13,22
14650,atop,1.48790438516857e-05,3.6233184351681345e-06,10,8,2
14651,atrocity,5.888748341300963e-05,2.2602605476525032e-05,46,29,17
14652,attach,2.095639979110664e-07,3.6233184351681345e-06,3,0,3
14653,attached,1.278340387257504e-05,8.79948762826546e-06,12,6,6
14654,attack,0.0013016019910256319,0.0012993910064405339,1518,678,840
14655,attacked,0.00018881716211787043,0.0001847892401935746,214,97,117
14656,attacker,5.050492349656699e-05,4.6758061710979285e-05,55,24,31
14657,attacking,5.888748341300963e-05,3.985650278684949e-05,57,29,28
14658,attain,6.496483935243052e-06,1.7253897310324457e-07,3,3,0
14659,attempt,0.00028102532119873944,0.00025725560889693777,315,147,168
14660,attempted,7.355696326678427e-05,3.985650278684949e-05,66,36,30
14661,attempting,6.098312339212028e-05,5.1934230904076595e-05,67,32,35
14662,attend,5.260056347567764e-05,6.401195902130366e-05,66,27,39
14663,attendance,1.0687763893464371e-05,8.79948762826546e-06,11,6,5
14664,attendant,6.496483935243052e-06,1.570104655239525e-05,13,4,9
14665,attended,1.9070323809907035e-05,3.8131113055817005e-05,32,10,22
14666,attendee,8.592123914353715e-06,1.9151826014460126e-05,16,4,12
14667,attending,3.583544364279237e-05,2.4327995207557487e-05,34,17,17
14668,attention,0.00014480872255654665,0.00016063378395912072,178,73,105
14669,attire,2.3052039770217305e-06,5.348708166200577e-06,4,1,3
14670,attitude,4.840928351745632e-05,4.6758061710979285e-05,55,24,31
14671,attorney,0.00018881716211787043,0.00020721930669699654,231,96,135
14672,attract,2.116596378901769e-05,2.9504164400654783e-05,28,11,17
14673,attracted,1.0687763893464371e-05,7.074097897233022e-06,10,5,5
14674,attracting,6.496483935243052e-06,8.79948762826546e-06,9,4,5
14675,attraction,2.3052039770217305e-06,8.79948762826546e-06,6,1,5
14676,attractive,2.116596378901769e-05,2.087721574549256e-05,23,10,13
14677,attribute,4.400843956132392e-06,8.79948762826546e-06,7,2,5
14678,attributed,1.278340387257504e-05,1.570104655239525e-05,17,6,11
14679,auction,1.6974683830796368e-05,1.570104655239525e-05,20,10,10
14680,auctioned,4.400843956132392e-06,3.6233184351681345e-06,4,2,2
14681,audaciou,8.592123914353715e-06,1.7253897310324457e-07,5,4,1
14682,audience,2.5357243747239038e-05,4.1581892517881935e-05,42,14,28
14683,audio,2.954852370546031e-05,1.3975656821362803e-05,27,15,12
14684,audit,1.6974683830796368e-05,8.79948762826546e-06,16,8,8
14685,audited,1.0687763893464371e-05,1.7253897310324457e-07,5,5,0
14686,audition,2.095639979110664e-07,5.348708166200577e-06,3,0,3
14687,auditor,6.496483935243052e-06,5.348708166200577e-06,8,5,3
14688,aunt,4.400843956132392e-06,1.8979287041356905e-06,3,2,1
14689,austerity,8.403516316233764e-05,6.228656929027126e-05,87,47,40
14690,authentic,1.6974683830796368e-05,7.074097897233022e-06,14,8,6
14691,authenticity,2.3052039770217305e-06,3.6233184351681345e-06,3,1,2
14692,author,5.260056347567764e-05,8.989280498679035e-05,83,30,53
14693,authored,2.095639979110664e-07,7.074097897233022e-06,4,0,4
14694,authorise,2.095639979110664e-07,8.79948762826546e-06,5,0,5
14695,authorised,4.400843956132392e-06,5.348708166200577e-06,6,3,3
14696,authoritarian,2.326160376812834e-05,3.2954943862719716e-05,33,12,21
14697,authoritarianism,4.400843956132392e-06,3.6233184351681345e-06,4,2,2
14698,authoritative,1.0687763893464371e-05,1.8979287041356905e-06,6,5,1
14699,authority,0.00035437272046761313,0.0003245458084072032,384,178,206
14700,authorization,1.0687763893464371e-05,2.4327995207557487e-05,19,5,14
14701,authorize,1.0687763893464371e-05,1.8979287041356905e-06,9,5,4
14702,authorized,1.9070323809907035e-05,1.3975656821362803e-05,18,9,9
14703,authorizing,6.496483935243052e-06,3.6233184351681345e-06,5,3,2
14704,autism,1.278340387257504e-05,2.087721574549256e-05,19,6,13
14705,autistic,6.496483935243052e-06,8.79948762826546e-06,9,4,5
14706,auto,1.9070323809907035e-05,2.2602605476525032e-05,26,11,15
14707,autobiography,4.400843956132392e-06,3.6233184351681345e-06,4,2,2
14708,autocracy,4.400843956132392e-06,1.8979287041356905e-06,3,2,1
14709,autocrat,4.400843956132392e-06,1.8979287041356905e-06,3,2,1
14710,autocratic,2.3052039770217305e-06,1.052487735929791e-05,8,2,6
14711,automaker,1.48790438516857e-05,1.3975656821362803e-05,17,7,10
14712,automated,6.496483935243052e-06,5.348708166200577e-06,7,3,4
14713,automatic,2.5357243747239038e-05,2.087721574549256e-05,26,12,14
14714,automatically,1.278340387257504e-05,1.742643628342769e-05,17,7,10
14715,automobile,2.3052039770217305e-06,3.6233184351681345e-06,6,2,4
14716,automotive,2.3052039770217305e-06,7.074097897233022e-06,7,2,5
14717,autonomou,8.592123914353715e-06,1.052487735929791e-05,10,4,6
14718,autonomy,1.0687763893464371e-05,7.074097897233022e-06,10,5,5
14719,autopilot,2.095639979110664e-07,5.348708166200577e-06,3,0,3
14720,autopsy,1.0687763893464371e-05,5.348708166200577e-06,8,5,3
14721,autumn,6.496483935243052e-06,1.7253897310324457e-07,3,3,0
14722,availability,6.496483935243052e-06,1.8979287041356905e-06,5,3,2
14723,available,8.403516316233764e-05,8.816741525575797e-05,100,43,57
14724,avalanche,4.400843956132392e-06,5.348708166200577e-06,5,2,3
14725,avenge,1.0687763893464371e-05,5.348708166200577e-06,9,5,4
14726,avenue,8.592123914353715e-06,5.348708166200577e-06,8,5,3
14727,average,9.870464301611217e-05,0.00012267520987640663,130,53,77
14728,averaged,4.400843956132392e-06,5.348708166200577e-06,5,2,3
14729,averaging,2.3052039770217305e-06,3.6233184351681345e-06,4,1,3
14730,avert,1.9070323809907035e-05,1.742643628342769e-05,19,9,10
14731,averting,2.3052039770217305e-06,3.6233184351681345e-06,3,1,2
14732,avian,6.496483935243052e-06,1.7253897310324457e-07,4,4,0
14733,aviation,8.592123914353715e-06,8.79948762826546e-06,10,4,6
14734,aviator,2.095639979110664e-07,3.6233184351681345e-06,3,1,2
14735,avid,4.400843956132392e-06,1.8979287041356905e-06,4,2,2
14736,avocado,4.400843956132392e-06,1.8979287041356905e-06,3,2,1
14737,avoid,0.00015738256243121094,0.0001589083942280881,179,79,100
14738,avoidance,1.0687763893464371e-05,1.9151826014460126e-05,16,5,11
14739,avoided,2.5357243747239038e-05,1.9151826014460126e-05,25,12,13
14740,avoiding,1.6974683830796368e-05,1.742643628342769e-05,21,11,10
14741,await,8.592123914353715e-06,2.087721574549256e-05,17,4,13
14742,awaited,2.095639979110664e-07,5.348708166200577e-06,3,0,3
14743,awaiting,1.48790438516857e-05,1.570104655239525e-05,17,7,10
14744,awake,2.3052039770217305e-06,5.348708166200577e-06,4,1,3
14745,awaken,4.400843956132392e-06,1.8979287041356905e-06,3,2,1
14746,awakened,4.400843956132392e-06,5.348708166200577e-06,6,3,3
14747,awakening,6.496483935243052e-06,8.79948762826546e-06,11,4,7
14748,award,6.307876337123095e-05,5.711040009717395e-05,71,34,37
14749,awarded,4.6313643538345614e-05,3.8131113055817005e-05,46,23,23
14750,awarding,6.496483935243052e-06,1.8979287041356905e-06,4,3,1
14751,awardwinning,4.400843956132392e-06,3.6233184351681345e-06,4,2,2
14752,aware,4.4218003559234974e-05,5.711040009717395e-05,60,24,36
14753,awarenes,2.954852370546031e-05,3.640572332478458e-05,39,16,23
14754,awash,1.0687763893464371e-05,1.7253897310324457e-07,5,5,0
14755,away,0.00042981575971559697,0.00033489814679339735,450,222,228
14756,awe,4.400843956132392e-06,7.074097897233022e-06,8,3,5
14757,aweinspiring,2.3052039770217305e-06,1.8979287041356905e-06,4,2,2
14758,awesome,2.116596378901769e-05,7.074097897233022e-06,17,11,6
14759,awful,8.592123914353715e-06,1.742643628342769e-05,17,5,12
14760,awkward,1.6974683830796368e-05,1.3975656821362803e-05,20,10,10
14761,awoke,4.400843956132392e-06,3.6233184351681345e-06,4,2,2
14762,ax,8.592123914353715e-06,1.8979287041356905e-06,6,5,1
14763,axe,1.48790438516857e-05,1.742643628342769e-05,18,7,11
14764,axed,2.3052039770217305e-06,7.074097897233022e-06,5,1,4
14765,axi,6.496483935243052e-06,3.6233184351681345e-06,5,3,2
14766,baboon,2.3052039770217305e-06,5.348708166200577e-06,4,1,3
14767,baby,0.00018462588215964923,0.0001485560558418934,198,98,100
14768,bachelor,6.496483935243052e-06,3.6233184351681345e-06,5,3,2
14769,back,0.0008866652751617216,0.000942235332116818,1089,471,618
14770,backbone,2.3052039770217305e-06,3.6233184351681345e-06,3,1,2
14771,backdoor,1.48790438516857e-05,1.570104655239525e-05,19,7,12
14772,backed,7.355696326678427e-05,6.918812821440096e-05,84,39,45
14773,backer,2.116596378901769e-05,1.570104655239525e-05,22,10,12
14774,backfire,8.592123914353715e-06,3.6233184351681345e-06,7,4,3
14775,backfired,8.592123914353715e-06,1.8979287041356905e-06,5,4,1
14776,background,4.212236358012434e-05,3.468033359375216e-05,47,25,22
14777,backing,5.050492349656699e-05,7.091351794543343e-05,73,29,44
14778,backlash,3.583544364279237e-05,3.985650278684949e-05,46,18,28
14779,backlog,8.592123914353715e-06,1.8979287041356905e-06,5,4,1
14780,backpack,2.3052039770217305e-06,5.348708166200577e-06,4,1,3
14781,backstage,2.095639979110664e-07,5.348708166200577e-06,3,0,3
14782,backstory,4.400843956132392e-06,3.6233184351681345e-06,4,2,2
14783,backtoschool,4.400843956132392e-06,5.348708166200577e-06,5,2,3
14784,backtrack,4.400843956132392e-06,8.79948762826546e-06,7,2,5
14785,backtracked,2.3052039770217305e-06,3.6233184351681345e-06,3,1,2
14786,backtracking,2.3052039770217305e-06,1.8979287041356905e-06,3,1,2
14787,backup,8.592123914353715e-06,7.074097897233022e-06,9,5,4
14788,backward,2.116596378901769e-05,2.087721574549256e-05,27,12,15
14789,backyard,6.496483935243052e-06,1.8979287041356905e-06,5,4,1
14790,bacon,4.400843956132392e-06,5.348708166200577e-06,5,2,3
14791,bacterium,1.9070323809907035e-05,1.052487735929791e-05,17,9,8
14792,bad,0.00024749508153296894,0.00025725560889693777,299,135,164
14793,badge,2.3052039770217305e-06,7.074097897233022e-06,9,1,8
14794,badly,2.5357243747239038e-05,2.9504164400654783e-05,31,14,17
14795,baffled,4.400843956132392e-06,3.6233184351681345e-06,5,3,2
14796,baffling,2.3052039770217305e-06,3.6233184351681345e-06,5,3,2
14797,bag,7.984388320411623e-05,5.1934230904076595e-05,81,42,39
14798,baggage,6.496483935243052e-06,7.074097897233022e-06,8,3,5
14799,bail,4.212236358012434e-05,4.8483451442011706e-05,56,21,35
14800,bailed,8.592123914353715e-06,5.348708166200577e-06,8,5,3
14801,bailedout,4.400843956132392e-06,1.8979287041356905e-06,3,2,1
14802,bailing,4.400843956132392e-06,3.6233184351681345e-06,5,2,3
14803,bailout,7.774824322500554e-05,6.056117955923882e-05,82,38,44
14804,bait,6.496483935243052e-06,5.348708166200577e-06,7,3,4
14805,bake,6.496483935243052e-06,1.8979287041356905e-06,5,3,2
14806,bakery,6.496483935243052e-06,3.6233184351681345e-06,5,3,2
14807,balaclava,6.496483935243052e-06,1.7253897310324457e-07,3,3,0
14808,balance,5.260056347567764e-05,6.401195902130366e-05,67,25,42
14809,balanced,4.400843956132392e-06,1.052487735929791e-05,8,2,6
14810,balancing,2.3052039770217305e-06,5.348708166200577e-06,4,1,3
14811,balcony,4.400843956132392e-06,8.79948762826546e-06,8,2,6
14812,bald,6.496483935243052e-06,3.6233184351681345e-06,5,3,2
14813,balked,2.3052039770217305e-06,3.6233184351681345e-06,3,1,2
14814,balking,2.3052039770217305e-06,1.8979287041356905e-06,3,1,2
14815,ball,4.4218003559234974e-05,3.468033359375216e-05,49,25,24
14816,ballistic,1.9070323809907035e-05,2.2602605476525032e-05,23,9,14
14817,balloon,1.48790438516857e-05,2.087721574549256e-05,23,8,15
14818,ballot,8.822644312055891e-05,7.608968713853079e-05,100,47,53
14819,ballotstuffing,2.095639979110664e-07,3.6233184351681345e-06,3,1,2
14820,ban,0.0007923614761017417,0.0007610694103584114,930,426,504
14821,banana,2.116596378901769e-05,1.8979287041356905e-06,11,10,1
14822,band,3.3739803663681634e-05,3.8131113055817005e-05,44,18,26
14823,bandwagon,6.496483935243052e-06,1.7253897310324457e-07,3,3,0
14824,bandwidth,2.3052039770217305e-06,5.348708166200577e-06,4,1,3
14825,bang,6.496483935243052e-06,5.348708166200577e-06,8,4,4
14826,banished,6.496483935243052e-06,1.7253897310324457e-07,3,3,0
14827,bank,0.0006456666775639949,0.0005591988118276152,689,336,353
14828,banker,7.565260324589493e-05,6.918812821440096e-05,83,39,44
14829,banking,7.146132328767358e-05,6.401195902130366e-05,87,41,46
14830,banknote,2.3052039770217305e-06,3.6233184351681345e-06,4,2,2
14831,bankroll,4.400843956132392e-06,1.8979287041356905e-06,3,2,1
14832,bankrolled,2.3052039770217305e-06,5.348708166200577e-06,4,1,3
14833,bankrupt,1.9070323809907035e-05,2.087721574549256e-05,21,9,12
14834,bankruptcy,5.050492349656699e-05,3.122955413168725e-05,45,24,21
14835,banned,0.00025797328142852257,0.0002469032705107427,290,131,159
14836,banner,1.9070323809907035e-05,1.9151826014460126e-05,22,9,13
14837,banning,8.193952318322689e-05,5.711040009717395e-05,80,41,39
14838,banquet,4.400843956132392e-06,1.8979287041356905e-06,3,2,1
14839,baptism,2.3052039770217305e-06,3.6233184351681345e-06,3,1,2
14840,bar,0.00010499156295344414,0.00012267520987640663,131,54,77
14841,barb,4.400843956132392e-06,1.7253897310324457e-07,4,3,1
14842,barbaric,1.0687763893464371e-05,7.074097897233022e-06,11,5,6
14843,barbecue,8.592123914353715e-06,1.7253897310324457e-07,4,4,0
14844,bare,2.326160376812834e-05,7.074097897233022e-06,16,12,4
14845,barely,2.5357243747239038e-05,3.8131113055817005e-05,39,15,24
14846,bargain,2.3052039770217305e-06,1.9151826014460126e-05,12,1,11
14847,bargaining,6.496483935243052e-06,1.570104655239525e-05,12,3,9
14848,bark,2.3052039770217305e-06,3.6233184351681345e-06,3,1,2
14849,baron,2.3052039770217305e-06,5.348708166200577e-06,6,2,4
14850,barrack,6.496483935243052e-06,5.348708166200577e-06,6,3,3
14851,barrage,4.400843956132392e-06,5.348708166200577e-06,6,2,4
14852,barred,4.212236358012434e-05,2.777877466962238e-05,40,23,17
14853,barrel,4.002672360101368e-05,3.2954943862719716e-05,42,20,22
14854,barricade,1.278340387257504e-05,3.6233184351681345e-06,10,8,2
14855,barricaded,4.400843956132392e-06,1.8979287041356905e-06,3,2,1
14856,barrier,4.4218003559234974e-05,3.985650278684949e-05,56,25,31
14857,barring,1.0687763893464371e-05,8.79948762826546e-06,13,7,6
14858,bartender,2.3052039770217305e-06,5.348708166200577e-06,4,1,3
14859,bas,2.3052039770217305e-06,3.6233184351681345e-06,3,1,2
14860,base,0.00022234740178364096,0.00017271151207634748,225,117,108
14861,baseball,1.6974683830796368e-05,2.2602605476525032e-05,22,9,13
14862,based,0.00012385232276544028,0.00012612598933847184,147,67,80
14863,baseles,1.0687763893464371e-05,1.3975656821362803e-05,15,7,8
14864,basement,1.6974683830796368e-05,5.348708166200577e-06,11,8,3
14865,bash,2.3052039770217305e-06,7.074097897233022e-06,6,1,5
14866,bashed,6.496483935243052e-06,3.6233184351681345e-06,7,4,3
14867,bashing,4.400843956132392e-06,5.348708166200577e-06,6,3,3
14868,basi,5.4696203454788295e-05,5.020884117304414e-05,62,30,32
14869,basic,0.00012804360272366158,8.816741525575797e-05,121,65,56
14870,basically,3.583544364279237e-05,3.2954943862719716e-05,42,18,24
14871,basilica,8.592123914353715e-06,1.7253897310324457e-07,4,4,0
14872,basin,1.0687763893464371e-05,5.348708166200577e-06,9,6,3
14873,basket,4.400843956132392e-06,3.6233184351681345e-06,4,2,2
14874,basketball,4.400843956132392e-06,1.3975656821362803e-05,11,2,9
14875,bastard,4.400843956132392e-06,1.052487735929791e-05,8,2,6
14876,bastion,4.400843956132392e-06,3.6233184351681345e-06,5,2,3
14877,bat,1.278340387257504e-05,1.570104655239525e-05,16,6,10
14878,batch,2.3052039770217305e-06,7.074097897233022e-06,5,1,4
14879,bath,4.400843956132392e-06,8.79948762826546e-06,8,2,6
14880,bathing,2.3052039770217305e-06,5.348708166200577e-06,5,2,3
14881,bathroom,2.7452883726349685e-05,3.2954943862719716e-05,34,15,19
14882,baton,2.095639979110664e-07,1.2250267090330355e-05,9,1,8
14883,battalion,6.496483935243052e-06,8.79948762826546e-06,8,3,5
14884,batter,6.496483935243052e-06,1.8979287041356905e-06,4,3,1
14885,battered,8.592123914353715e-06,7.074097897233022e-06,11,6,5
14886,battery,3.7931083621902995e-05,2.4327995207557487e-05,37,19,18
14887,battle,0.00021396484186719832,0.00022274781427628854,250,111,139
14888,battled,8.592123914353715e-06,1.7253897310324457e-07,5,5,0
14889,battlefield,1.278340387257504e-05,2.2602605476525032e-05,20,6,14
14890,battleground,1.0687763893464371e-05,2.2602605476525032e-05,21,7,14
14891,battleship,4.400843956132392e-06,1.7253897310324457e-07,3,2,1
14892,battling,2.116596378901769e-05,2.087721574549256e-05,23,10,13
14893,bay,1.0687763893464371e-05,7.074097897233022e-06,9,5,4
14894,beach,6.936568330856297e-05,5.5385010366141504e-05,71,35,36
14895,beacon,2.095639979110664e-07,5.348708166200577e-06,4,0,4
14896,beam,6.496483935243052e-06,1.052487735929791e-05,10,4,6
14897,bean,1.0687763893464371e-05,1.8979287041356905e-06,6,5,1
14898,bear,6.098312339212028e-05,8.126585633162811e-05,90,33,57
14899,beard,1.0687763893464371e-05,8.79948762826546e-06,11,5,6
14900,bearing,1.0687763893464371e-05,1.3975656821362803e-05,15,5,10
14901,beast,6.496483935243052e-06,3.6233184351681345e-06,5,3,2
14902,beat,0.00011337412286988677,0.00010714670229711469,135,63,72
14903,beaten,0.00011756540282810809,9.506897417988779e-05,126,61,65
14904,beating,7.774824322500554e-05,6.228656929027126e-05,84,41,43
14905,beautiful,4.212236358012434e-05,3.8131113055817005e-05,48,22,26
14906,beauty,1.0687763893464371e-05,1.9151826014460126e-05,20,5,15
14907,became,9.660900303700153e-05,0.00011404826122124471,125,54,71
14908,become,0.0005199282788173553,0.0005591988118276152,639,267,372
14909,becoming,0.0001259479627445509,0.00014510527637982858,153,64,89
14910,becquerel,4.400843956132392e-06,1.7253897310324457e-07,3,2,1
14911,bed,3.583544364279237e-05,2.9504164400654783e-05,40,19,21
14912,bedfellow,2.3052039770217305e-06,3.6233184351681345e-06,4,1,3
14913,bedrock,4.400843956132392e-06,1.8979287041356905e-06,3,2,1
14914,bedroom,1.48790438516857e-05,1.052487735929791e-05,13,7,6
14915,bee,1.9070323809907035e-05,2.6053384938589907e-05,29,11,18
14916,beef,2.326160376812834e-05,1.742643628342769e-05,23,12,11
14917,beekeeper,2.3052039770217305e-06,1.8979287041356905e-06,3,1,2
14918,beer,2.5357243747239038e-05,4.6758061710979285e-05,44,16,28
14919,beetle,2.095639979110664e-07,7.074097897233022e-06,4,0,4
14920,before,8.592123914353715e-06,1.7253897310324457e-07,4,4,0
14921,beforehand,8.592123914353715e-06,1.7253897310324457e-07,4,4,0
14922,befuddled,4.400843956132392e-06,1.8979287041356905e-06,3,2,1
14923,beg,8.592123914353715e-06,8.79948762826546e-06,10,4,6
14924,began,0.0001259479627445509,0.0001278513790695043,145,63,82
14925,beggar,8.592123914353715e-06,5.348708166200577e-06,10,5,5
14926,begging,1.0687763893464371e-05,1.3975656821362803e-05,15,7,8
14927,begin,0.00024539944155385846,0.00019341618884873702,251,126,125
14928,beginning,8.403516316233764e-05,0.00011404826122124471,116,48,68
14929,begun,6.098312339212028e-05,6.401195902130366e-05,76,33,43
14930,behalf,5.6791843433898893e-05,3.640572332478458e-05,53,29,24
14931,behave,1.48790438516857e-05,1.052487735929791e-05,14,8,6
14932,behaving,1.0687763893464371e-05,7.074097897233022e-06,9,5,4
14933,behavior,5.4696203454788295e-05,8.126585633162811e-05,83,29,54
14934,behavioral,6.496483935243052e-06,5.348708166200577e-06,6,3,3
14935,behaviour,1.9070323809907035e-05,1.2250267090330355e-05,16,9,7
14936,behead,2.326160376812834e-05,1.742643628342769e-05,22,11,11
14937,beheaded,2.954852370546031e-05,3.468033359375216e-05,37,16,21
14938,beheading,3.1644163684570994e-05,3.8131113055817005e-05,40,15,25
14939,behemoth,8.592123914353715e-06,5.348708166200577e-06,7,4,3
14940,behest,2.3052039770217305e-06,5.348708166200577e-06,4,1,3
14941,behind,0.0002935991610734039,0.0003124680802899761,361,157,204
14942,behindthescene,2.095639979110664e-07,8.79948762826546e-06,5,0,5
14943,beholden,2.3052039770217305e-06,5.348708166200577e-06,4,1,3
14944,behoove,4.400843956132392e-06,3.6233184351681345e-06,4,2,2
14945,being,2.326160376812834e-05,2.777877466962238e-05,32,12,20
14946,beleaguered,1.48790438516857e-05,7.074097897233022e-06,12,7,5
14947,belief,0.00014271308257743603,0.0001554576147660233,171,77,94
14948,believe,0.00030617300094806777,0.00036595516195198134,399,168,231
14949,believed,0.0001154697628489974,9.334358444885519e-05,116,60,56
14950,believer,1.278340387257504e-05,8.79948762826546e-06,13,7,6
14951,believing,4.400843956132392e-06,5.348708166200577e-06,6,2,4
14952,belittling,2.3052039770217305e-06,3.6233184351681345e-06,4,1,3
14953,bell,1.0687763893464371e-05,1.052487735929791e-05,12,6,6
14954,belligerent,2.3052039770217305e-06,3.6233184351681345e-06,5,1,4
14955,belly,2.3052039770217305e-06,3.6233184351681345e-06,3,1,2
14956,belong,3.3739803663681634e-05,3.122955413168725e-05,40,18,22
14957,belonged,6.496483935243052e-06,8.79948762826546e-06,10,3,7
14958,belonging,3.3739803663681634e-05,1.570104655239525e-05,31,19,12
14959,beloved,1.278340387257504e-05,2.6053384938589907e-05,24,8,16
14960,belt,1.48790438516857e-05,2.6053384938589907e-05,23,7,16
14961,bemoan,4.400843956132392e-06,3.6233184351681345e-06,4,2,2
14962,bench,1.48790438516857e-05,5.348708166200577e-06,12,7,5
14963,benchmark,1.6974683830796368e-05,2.087721574549256e-05,23,11,12
14964,bend,2.095639979110664e-07,1.2250267090330355e-05,11,0,11
14965,bending,2.3052039770217305e-06,3.6233184351681345e-06,3,1,2
14966,beneath,1.6974683830796368e-05,2.4327995207557487e-05,24,9,15
14967,beneficial,2.3052039770217305e-06,8.79948762826546e-06,7,2,5
14968,beneficiary,8.592123914353715e-06,5.348708166200577e-06,8,5,3
14969,benefit,0.00024120816159563723,0.00022102242454525643,266,128,138
14970,benefited,1.6974683830796368e-05,3.6233184351681345e-06,10,8,2
14971,benefiting,4.400843956132392e-06,1.2250267090330355e-05,10,2,8
14972,benign,8.592123914353715e-06,3.6233184351681345e-06,7,5,2
14973,bent,1.278340387257504e-05,8.79948762826546e-06,11,6,5
14974,berated,2.3052039770217305e-06,3.6233184351681345e-06,3,1,2
14975,beset,2.095639979110664e-07,5.348708166200577e-06,3,0,3
14976,beside,4.400843956132392e-06,8.79948762826546e-06,10,5,5
14977,besieged,8.592123914353715e-06,2.2602605476525032e-05,19,6,13
14978,besieging,2.3052039770217305e-06,3.6233184351681345e-06,3,1,2
14979,best,0.0002516863614911905,0.0003090173008279106,343,145,198
14980,bestiality,2.3052039770217305e-06,3.6233184351681345e-06,3,1,2
14981,bestknown,8.592123914353715e-06,5.348708166200577e-06,10,4,6
14982,bestowed,4.400843956132392e-06,1.8979287041356905e-06,3,2,1
14983,bestseller,2.095639979110664e-07,7.074097897233022e-06,4,0,4
14984,bestselling,6.496483935243052e-06,1.2250267090330355e-05,11,4,7
14985,bet,2.326160376812834e-05,2.2602605476525032e-05,27,14,13
14986,betray,6.496483935243052e-06,3.6233184351681345e-06,5,3,2
14987,betrayal,6.496483935243052e-06,3.6233184351681345e-06,5,3,2
14988,betrayed,1.48790438516857e-05,8.79948762826546e-06,12,7,5
14989,betraying,2.095639979110664e-07,5.348708166200577e-06,6,2,4
14990,better,0.00037532912025871974,0.00036768055168301384,428,195,233
14991,betting,2.116596378901769e-05,5.348708166200577e-06,14,10,4
14992,beverage,6.496483935243052e-06,7.074097897233022e-06,7,3,4
14993,beware,4.400843956132392e-06,1.7253897310324457e-07,3,2,1
14994,bewildered,4.400843956132392e-06,1.8979287041356905e-06,3,2,1
14995,beyond,0.00013223488268188294,9.334358444885519e-05,130,66,64
14996,bia,4.4218003559234974e-05,3.8131113055817005e-05,47,25,22
14997,biased,1.9070323809907035e-05,1.742643628342769e-05,20,9,11
14998,biblical,6.496483935243052e-06,7.074097897233022e-06,7,3,4
14999,bickering,4.400843956132392e-06,1.7253897310324457e-07,3,2,1
15000,bicycle,6.496483935243052e-06,1.2250267090330355e-05,10,3,7
15001,bid,0.0001783389622223174,0.0001382037174556987,185,96,89
15002,bidder,8.592123914353715e-06,1.8979287041356905e-06,5,4,1
15003,bidding,8.592123914353715e-06,8.79948762826546e-06,11,6,5
15004,big,0.0004256244797573756,0.0004349707511932791,514,231,283
15005,bigger,6.307876337123095e-05,7.954046660059569e-05,86,36,50
15006,biggest,0.000392094240091605,0.0003262711981382355,408,203,205
15007,bigmoney,6.496483935243052e-06,3.6233184351681345e-06,5,3,2
15008,bigot,8.592123914353715e-06,1.052487735929791e-05,10,4,6
15009,bigoted,4.400843956132392e-06,3.6233184351681345e-06,5,2,3
15010,bigotry,1.278340387257504e-05,1.570104655239525e-05,18,6,12
15011,bigtime,4.400843956132392e-06,1.8979287041356905e-06,3,2,1
15012,bike,2.5357243747239038e-05,2.4327995207557487e-05,27,12,15
15013,biker,4.400843956132392e-06,5.348708166200577e-06,5,2,3
15014,bikini,2.3052039770217305e-06,3.6233184351681345e-06,3,1,2
15015,bilateral,4.400843956132392e-06,1.570104655239525e-05,13,3,10
15016,bile,2.095639979110664e-07,3.6233184351681345e-06,4,0,4
15017,bill,0.0006959620370626512,0.0006782507032688539,793,354,439
15018,billboard,1.278340387257504e-05,1.2250267090330355e-05,14,6,8
15019,billed,4.400843956132392e-06,3.6233184351681345e-06,4,2,2
15020,billing,2.095639979110664e-07,7.074097897233022e-06,4,0,4
15021,billion,0.0006561448774595484,0.000573001929675875,722,348,374
15022,billionaire,0.00014480872255654665,9.161819471782287e-05,134,75,59
15023,billiondollar,1.0687763893464371e-05,3.6233184351681345e-06,7,5,2
15024,bin,0.00010708720293255492,5.5385010366141504e-05,92,53,39
15025,binary,6.496483935243052e-06,1.7253897310324457e-07,3,3,0
15026,binational,4.400843956132392e-06,1.8979287041356905e-06,3,2,1
15027,bind,6.496483935243052e-06,3.6233184351681345e-06,6,4,2
15028,binding,2.3052039770217305e-06,7.074097897233022e-06,5,1,4
15029,binge,4.400843956132392e-06,3.6233184351681345e-06,4,2,2
15030,bio,6.496483935243052e-06,1.7253897310324457e-07,3,3,0
15031,biodiversity,4.400843956132392e-06,8.79948762826546e-06,9,3,6
15032,biofuel,4.400843956132392e-06,8.79948762826546e-06,7,2,5
15033,biography,6.496483935243052e-06,5.348708166200577e-06,6,3,3
15034,biological,1.0687763893464371e-05,1.742643628342769e-05,17,5,12
15035,biologically,4.400843956132392e-06,1.8979287041356905e-06,3,2,1
15036,biologist,4.400843956132392e-06,1.052487735929791e-05,9,2,7
15037,biology,6.496483935243052e-06,1.8979287041356905e-06,4,3,1
15038,biomas,8.592123914353715e-06,1.7253897310324457e-07,4,4,0
15039,biometric,2.3052039770217305e-06,1.052487735929791e-05,7,1,6
15040,bionic,4.400843956132392e-06,1.8979287041356905e-06,3,2,1
15041,biotech,1.0687763893464371e-05,3.6233184351681345e-06,9,6,3
15042,bipartisan,4.840928351745632e-05,3.640572332478458e-05,49,23,26
15043,bipartisanship,6.496483935243052e-06,7.074097897233022e-06,8,3,5
15044,bird,6.098312339212028e-05,4.6758061710979285e-05,61,32,29
15045,birth,0.00012175668278632962,0.0001382037174556987,151,66,85
15046,birthday,3.583544364279237e-05,3.985650278684949e-05,47,19,28
15047,birther,1.0687763893464371e-05,3.6233184351681345e-06,7,5,2
15048,birthplace,4.400843956132392e-06,7.074097897233022e-06,6,2,4
15049,biscuit,2.3052039770217305e-06,7.074097897233022e-06,6,2,4
15050,bisexual,6.496483935243052e-06,3.6233184351681345e-06,6,3,3
15051,bishop,4.4218003559234974e-05,3.640572332478458e-05,49,21,28
15052,bison,2.3052039770217305e-06,7.074097897233022e-06,5,1,4
15053,bit,9.660900303700153e-05,0.0001019705331040174,113,49,64
15054,bitch,4.400843956132392e-06,1.570104655239525e-05,11,2,9
15055,bitcoin,8.592123914353715e-06,1.3975656821362803e-05,15,4,11
15056,bite,1.9070323809907035e-05,2.6053384938589907e-05,29,13,16
15057,bitten,2.3052039770217305e-06,5.348708166200577e-06,4,1,3
15058,bitter,1.9070323809907035e-05,1.3975656821362803e-05,20,10,10
15059,bittersweet,2.3052039770217305e-06,1.7253897310324457e-07,3,2,1
15060,bizarre,2.5357243747239038e-05,1.9151826014460126e-05,25,13,12
15061,black,0.0002181561218254202,0.0001951415785797695,245,116,129
15062,blacklist,2.954852370546031e-05,1.570104655239525e-05,23,14,9
15063,blacklisted,4.400843956132392e-06,1.8979287041356905e-06,5,2,3
15064,blacklisting,4.400843956132392e-06,5.348708166200577e-06,5,2,3
15065,blackmail,1.0687763893464371e-05,1.052487735929791e-05,14,5,9
15066,blackmailed,2.3052039770217305e-06,3.6233184351681345e-06,3,1,2
15067,blackmarket,4.400843956132392e-06,1.8979287041356905e-06,3,2,1
15068,blackout,1.48790438516857e-05,2.6053384938589907e-05,24,8,16
15069,blade,2.3052039770217305e-06,8.79948762826546e-06,6,1,5
15070,blame,0.00015109564249387862,0.0001278513790695043,161,82,79
15071,blamed,7.774824322500554e-05,7.436429740749831e-05,91,38,53
15072,blaming,2.326160376812834e-05,2.9504164400654783e-05,31,12,19
15073,blank,2.5357243747239038e-05,1.570104655239525e-05,22,12,10
15074,blanket,8.592123914353715e-06,2.4327995207557487e-05,18,4,14
15075,blasphemer,2.095639979110664e-07,3.6233184351681345e-06,3,0,3
15076,blasphemou,4.400843956132392e-06,1.8979287041356905e-06,5,3,2
15077,blasphemy,5.260056347567764e-05,4.6758061710979285e-05,59,27,32
15078,blast,0.00012385232276544028,0.00010714670229711469,137,65,72
15079,blasted,2.116596378901769e-05,2.087721574549256e-05,25,12,13
15080,blasting,2.3052039770217305e-06,3.6233184351681345e-06,5,2,3
15081,blatant,1.0687763893464371e-05,8.79948762826546e-06,11,5,6
15082,blatantly,1.278340387257504e-05,7.074097897233022e-06,10,6,4
15083,blaze,2.5357243747239038e-05,1.3975656821362803e-05,21,13,8
15084,bleach,4.400843956132392e-06,1.8979287041356905e-06,3,2,1
15085,bleaching,2.095639979110664e-07,1.052487735929791e-05,6,0,6
15086,bleak,6.496483935243052e-06,1.3975656821362803e-05,12,3,9
15087,bleed,6.496483935243052e-06,1.052487735929791e-05,10,3,7
15088,bleeding,8.592123914353715e-06,8.79948762826546e-06,9,4,5
15089,blessed,1.0687763893464371e-05,5.348708166200577e-06,9,6,3
15090,blessing,2.3052039770217305e-06,8.79948762826546e-06,7,1,6
15091,blew,2.326160376812834e-05,3.122955413168725e-05,31,12,19
15092,blight,2.095639979110664e-07,3.6233184351681345e-06,3,0,3
15093,blind,4.002672360101368e-05,3.985650278684949e-05,53,23,30
15094,blinded,6.496483935243052e-06,8.79948762826546e-06,8,3,5
15095,blindfolded,1.6974683830796368e-05,7.074097897233022e-06,14,9,5
15096,blinding,4.400843956132392e-06,3.6233184351681345e-06,6,3,3
15097,blindnes,2.095639979110664e-07,1.052487735929791e-05,6,0,6
15098,bling,8.592123914353715e-06,1.7253897310324457e-07,4,4,0
15099,blink,6.496483935243052e-06,7.074097897233022e-06,7,3,4
15100,blinking,2.3052039770217305e-06,3.6233184351681345e-06,3,1,2
15101,blistering,1.278340387257504e-05,5.348708166200577e-06,11,6,5
15102,blizzard,2.095639979110664e-07,5.348708166200577e-06,3,0,3
15103,bln,6.496483935243052e-06,5.348708166200577e-06,7,3,4
15104,bloated,2.3052039770217305e-06,3.6233184351681345e-06,3,1,2
15105,bloc,2.116596378901769e-05,1.3975656821362803e-05,20,10,10
15106,block,0.00024749508153296894,0.00021239547589009395,276,132,144
15107,blockade,7.774824322500554e-05,5.883578982820635e-05,78,39,39
15108,blockaded,2.095639979110664e-07,8.79948762826546e-06,5,0,5
15109,blockbuster,4.400843956132392e-06,7.074097897233022e-06,7,2,5
15110,blocked,0.00011966104280721883,8.4716635793693e-05,121,63,58
15111,blocking,5.6791843433898893e-05,4.50326719799468e-05,61,31,30
15112,blog,4.002672360101368e-05,5.1934230904076595e-05,52,21,31
15113,blogger,9.451336305789087e-05,6.056117955923882e-05,88,48,40
15114,blogging,4.400843956132392e-06,3.6233184351681345e-06,4,2,2
15115,blonde,4.400843956132392e-06,3.6233184351681345e-06,4,2,2
15116,blood,0.00011756540282810809,8.816741525575797e-05,119,61,58
15117,bloodbath,2.3052039770217305e-06,7.074097897233022e-06,7,1,6
15118,bloodied,1.0687763893464371e-05,5.348708166200577e-06,10,6,4
15119,bloodiest,8.592123914353715e-06,1.2250267090330355e-05,11,4,7
15120,bloodshed,1.48790438516857e-05,1.9151826014460126e-05,21,9,12
15121,bloodsoaked,2.095639979110664e-07,3.6233184351681345e-06,3,1,2
15122,bloodtesting,2.095639979110664e-07,5.348708166200577e-06,3,0,3
15123,bloody,1.9070323809907035e-05,4.1581892517881935e-05,34,10,24
15124,bloom,8.592123914353715e-06,1.052487735929791e-05,10,4,6
15125,blow,0.00012385232276544028,8.644202552472544e-05,121,63,58
15126,blower,2.095639979110664e-07,5.348708166200577e-06,3,0,3
15127,blowing,1.0687763893464371e-05,2.6053384938589907e-05,23,8,15
15128,blown,2.7452883726349685e-05,2.2602605476525032e-05,27,14,13
15129,blue,3.7931083621902995e-05,3.985650278684949e-05,48,22,26
15130,blueeyed,6.496483935243052e-06,1.7253897310324457e-07,3,3,0
15131,bluefin,6.496483935243052e-06,1.742643628342769e-05,16,3,13
15132,blueprint,2.3052039770217305e-06,7.074097897233022e-06,7,3,4
15133,bluff,8.592123914353715e-06,3.6233184351681345e-06,6,4,2
15134,blunder,6.496483935243052e-06,7.074097897233022e-06,8,3,5
15135,blunt,2.116596378901769e-05,1.052487735929791e-05,17,11,6
15136,blur,6.496483935243052e-06,5.348708166200577e-06,6,3,3
15137,blurring,2.3052039770217305e-06,1.8979287041356905e-06,3,2,1
15138,blush,4.400843956132392e-06,1.8979287041356905e-06,3,2,1
15139,bluster,6.496483935243052e-06,3.6233184351681345e-06,5,3,2
15140,bn,8.592123914353715e-06,3.6233184351681345e-06,6,4,2
15141,bo,8.403516316233764e-05,7.608968713853079e-05,91,41,50
15142,boar,6.496483935243052e-06,3.6233184351681345e-06,5,3,2
15143,board,0.0001154697628489974,0.00013302754826260141,151,62,89
15144,boarded,1.0687763893464371e-05,5.348708166200577e-06,8,5,3
15145,boarding,2.326160376812834e-05,7.074097897233022e-06,15,11,4
15146,boardroom,2.3052039770217305e-06,5.348708166200577e-06,5,1,4
15147,boast,2.116596378901769e-05,2.6053384938589907e-05,25,10,15
15148,boasted,1.6974683830796368e-05,1.2250267090330355e-05,16,9,7
15149,boasting,4.400843956132392e-06,1.8979287041356905e-06,4,3,1
15150,boat,0.00010289592297433347,9.679436391092026e-05,118,52,66
15151,bodily,8.592123914353715e-06,1.8979287041356905e-06,5,4,1
15152,body,0.000348085800530281,0.00034697587491062454,402,182,220
15153,bodyguard,6.496483935243052e-06,7.074097897233022e-06,8,4,4
15154,bog,4.400843956132392e-06,1.8979287041356905e-06,4,2,2
15155,bogu,1.278340387257504e-05,1.052487735929791e-05,12,6,6
15156,boil,8.592123914353715e-06,5.348708166200577e-06,10,5,5
15157,boiling,1.48790438516857e-05,7.074097897233022e-06,11,7,4
15158,bold,1.9070323809907035e-05,2.6053384938589907e-05,27,9,18
15159,boldly,2.3052039770217305e-06,7.074097897233022e-06,5,1,4
15160,bolivar,2.095639979110664e-07,7.074097897233022e-06,4,0,4
15161,bolster,1.278340387257504e-05,1.2250267090330355e-05,15,6,9
15162,bolstering,2.3052039770217305e-06,5.348708166200577e-06,5,1,4
15163,bom,1.9070323809907035e-05,3.6233184351681345e-06,12,10,2
15164,bomb,0.0003376076006347278,0.0003780328900692085,412,170,242
15165,bombard,8.592123914353715e-06,3.6233184351681345e-06,6,4,2
15166,bombarded,2.3052039770217305e-06,5.348708166200577e-06,4,1,3
15167,bombardment,2.095639979110664e-07,8.79948762826546e-06,6,1,5
15168,bombastic,4.400843956132392e-06,1.8979287041356905e-06,3,2,1
15169,bombed,2.5357243747239038e-05,2.087721574549256e-05,30,14,16
15170,bomber,0.00016157384238943198,0.00012612598933847184,160,81,79
15171,bombing,0.0001343305226609934,0.00016753534288325053,179,75,104
15172,bombshell,1.0687763893464371e-05,1.570104655239525e-05,15,5,10
15173,bonanza,4.400843956132392e-06,5.348708166200577e-06,5,2,3
15174,bond,3.1644163684570994e-05,3.640572332478458e-05,44,17,27
15175,bondage,4.400843956132392e-06,1.8979287041356905e-06,3,2,1
15176,bonded,4.400843956132392e-06,1.8979287041356905e-06,4,2,2
15177,bonding,2.3052039770217305e-06,3.6233184351681345e-06,3,1,2
15178,bone,5.260056347567764e-05,3.2954943862719716e-05,50,29,21
15179,bonu,7.355696326678427e-05,6.918812821440096e-05,82,38,44
15180,boo,4.400843956132392e-06,3.6233184351681345e-06,4,2,2
15181,booby,2.095639979110664e-07,5.348708166200577e-06,3,0,3
15182,booed,4.400843956132392e-06,8.79948762826546e-06,7,2,5
15183,book,0.0001741476822640959,0.0002089446964280291,226,89,137
15184,booked,4.400843956132392e-06,1.8979287041356905e-06,3,2,1
15185,booking,4.400843956132392e-06,5.348708166200577e-06,6,2,4
15186,booklet,2.3052039770217305e-06,3.6233184351681345e-06,3,1,2
15187,bookseller,1.0687763893464371e-05,3.6233184351681345e-06,9,6,3
15188,bookstore,4.400843956132392e-06,3.6233184351681345e-06,6,2,4
15189,boom,4.840928351745632e-05,3.468033359375216e-05,48,26,22
15190,boomer,4.400843956132392e-06,5.348708166200577e-06,5,2,3
15191,booming,2.326160376812834e-05,1.3975656821362803e-05,21,13,8
15192,boon,1.0687763893464371e-05,1.2250267090330355e-05,12,5,7
15193,boost,0.00012175668278632962,0.00011577365095227703,130,59,71
15194,boosted,4.400843956132392e-06,1.7253897310324457e-07,3,2,1
15195,booster,4.400843956132392e-06,5.348708166200577e-06,6,2,4
15196,boosting,2.116596378901769e-05,5.348708166200577e-06,13,10,3
15197,boot,1.48790438516857e-05,1.052487735929791e-05,15,8,7
15198,booted,1.6974683830796368e-05,3.6233184351681345e-06,11,9,2
15199,booth,8.592123914353715e-06,3.6233184351681345e-06,8,6,2
15200,booze,6.496483935243052e-06,1.8979287041356905e-06,4,3,1
15201,border,0.0004633459993813674,0.00043669614092431164,529,241,288
15202,bore,4.400843956132392e-06,3.6233184351681345e-06,5,2,3
15203,bored,4.400843956132392e-06,5.348708166200577e-06,5,2,3
15204,boredom,2.3052039770217305e-06,3.6233184351681345e-06,3,1,2
15205,boring,8.592123914353715e-06,1.570104655239525e-05,13,4,9
15206,born,0.00010918284291166549,0.0001036959228350498,119,55,64
15207,borne,2.095639979110664e-07,3.6233184351681345e-06,5,0,5
15208,borough,2.3052039770217305e-06,3.6233184351681345e-06,4,2,2
15209,borrow,8.592123914353715e-06,8.79948762826546e-06,13,6,7
15210,borrowed,4.400843956132392e-06,5.348708166200577e-06,5,2,3
15211,borrower,2.5357243747239038e-05,1.3975656821362803e-05,23,15,8
15212,borrowing,1.6974683830796368e-05,8.79948762826546e-06,13,8,5
15213,bos,2.116596378901769e-05,3.2954943862719716e-05,33,12,21
15214,boson,8.592123914353715e-06,1.8979287041356905e-06,5,4,1
15215,bot,6.496483935243052e-06,3.6233184351681345e-06,5,3,2
15216,botched,1.48790438516857e-05,1.9151826014460126e-05,18,7,11
15217,bother,1.6974683830796368e-05,8.79948762826546e-06,14,8,6
15218,bothered,8.592123914353715e-06,7.074097897233022e-06,8,4,4
15219,bottle,4.4218003559234974e-05,3.640572332478458e-05,45,22,23
15220,bottled,1.278340387257504e-05,1.2250267090330355e-05,14,6,8
15221,bottlenose,2.3052039770217305e-06,3.6233184351681345e-06,3,1,2
15222,bottom,5.4696203454788295e-05,6.401195902130366e-05,71,30,41
15223,bought,6.307876337123095e-05,3.985650278684949e-05,59,32,27
15224,bounce,4.400843956132392e-06,7.074097897233022e-06,6,2,4
15225,bouncing,2.3052039770217305e-06,5.348708166200577e-06,4,1,3
15226,bound,5.050492349656699e-05,4.8483451442011706e-05,56,25,31
15227,boundary,6.496483935243052e-06,1.570104655239525e-05,18,7,11
15228,boundles,4.400843956132392e-06,1.8979287041356905e-06,3,2,1
15229,bounty,1.278340387257504e-05,1.052487735929791e-05,12,6,6
15230,bouquet,2.3052039770217305e-06,3.6233184351681345e-06,3,1,2
15231,bout,2.3052039770217305e-06,3.6233184351681345e-06,4,1,3
15232,bow,1.48790438516857e-05,2.2602605476525032e-05,21,7,14
15233,bowing,4.400843956132392e-06,1.7253897310324457e-07,3,2,1
15234,bowl,2.3052039770217305e-06,1.052487735929791e-05,8,1,7
15235,box,5.050492349656699e-05,5.5385010366141504e-05,66,30,36
15236,boxer,4.400843956132392e-06,3.6233184351681345e-06,4,2,2
15237,boy,0.0002516863614911905,0.0002296493732004186,288,135,153
15238,boycott,8.403516316233764e-05,6.056117955923882e-05,81,42,39
15239,boycotted,2.3052039770217305e-06,1.7253897310324457e-07,3,1,2
15240,boycotting,8.592123914353715e-06,5.348708166200577e-06,7,4,3
15241,boyfriend,1.278340387257504e-05,8.79948762826546e-06,12,6,6
15242,bra,4.400843956132392e-06,3.6233184351681345e-06,5,3,2
15243,brace,1.48790438516857e-05,2.087721574549256e-05,21,9,12
15244,braced,6.496483935243052e-06,7.074097897233022e-06,7,3,4
15245,bracelet,2.3052039770217305e-06,3.6233184351681345e-06,5,2,3
15246,bracing,8.592123914353715e-06,1.8979287041356905e-06,5,4,1
15247,bracket,4.400843956132392e-06,1.052487735929791e-05,8,2,6
15248,brag,8.592123914353715e-06,1.2250267090330355e-05,12,5,7
15249,bragged,4.400843956132392e-06,7.074097897233022e-06,8,3,5
15250,bragging,1.0687763893464371e-05,3.6233184351681345e-06,7,5,2
15251,brain,9.03220830996695e-05,6.746273848336857e-05,88,45,43
15252,braindamaged,8.592123914353715e-06,1.8979287041356905e-06,6,5,1
15253,brainwashed,6.496483935243052e-06,3.6233184351681345e-06,6,4,2
15254,brainwashing,6.496483935243052e-06,1.8979287041356905e-06,5,4,1
15255,brake,8.592123914353715e-06,5.348708166200577e-06,8,4,4
15256,branch,3.583544364279237e-05,3.2954943862719716e-05,39,17,22
15257,brand,7.774824322500554e-05,0.00011922443041434203,123,43,80
15258,branded,1.6974683830796368e-05,2.4327995207557487e-05,23,9,14
15259,branding,1.278340387257504e-05,1.2250267090330355e-05,16,8,8
15260,brandishing,2.095639979110664e-07,5.348708166200577e-06,3,0,3
15261,brash,2.3052039770217305e-06,7.074097897233022e-06,5,1,4
15262,brave,1.6974683830796368e-05,2.777877466962238e-05,29,8,21
15263,bravely,2.095639979110664e-07,1.8979287041356905e-06,3,1,2
15264,bravery,2.3052039770217305e-06,1.052487735929791e-05,8,2,6
15265,brawl,4.400843956132392e-06,1.2250267090330355e-05,11,4,7
15266,brazenly,2.3052039770217305e-06,3.6233184351681345e-06,3,1,2
15267,breach,7.565260324589493e-05,6.918812821440096e-05,81,37,44
15268,breached,1.48790438516857e-05,2.6053384938589907e-05,22,7,15
15269,breaching,1.278340387257504e-05,5.348708166200577e-06,10,6,4
15270,bread,1.9070323809907035e-05,1.052487735929791e-05,15,9,6
15271,breadwinner,6.496483935243052e-06,1.8979287041356905e-06,4,3,1
15272,break,0.0002642602013658546,0.00025553021916590484,299,134,165
15273,breakaway,1.0687763893464371e-05,3.6233184351681345e-06,7,5,2
15274,breakdown,2.116596378901769e-05,7.074097897233022e-06,14,10,4
15275,breakfast,2.326160376812834e-05,1.2250267090330355e-05,19,11,8
15276,breakin,2.095639979110664e-07,5.348708166200577e-06,3,0,3
15277,breaking,5.050492349656699e-05,5.1934230904076595e-05,59,25,34
15278,breakout,2.3052039770217305e-06,3.6233184351681345e-06,3,1,2
15279,breakthrough,2.7452883726349685e-05,3.468033359375216e-05,40,17,23
15280,breakup,8.592123914353715e-06,5.348708166200577e-06,7,4,3
15281,breast,2.5357243747239038e-05,3.468033359375216e-05,37,13,24
15282,breastfeed,2.3052039770217305e-06,3.6233184351681345e-06,3,1,2
15283,breastfeeding,4.400843956132392e-06,1.8979287041356905e-06,3,2,1
15284,breath,2.116596378901769e-05,1.3975656821362803e-05,22,12,10
15285,breathe,1.278340387257504e-05,1.742643628342769e-05,16,6,10
15286,breathing,4.400843956132392e-06,1.2250267090330355e-05,10,3,7
15287,breathtaking,4.400843956132392e-06,3.6233184351681345e-06,4,2,2
15288,bred,4.400843956132392e-06,1.8979287041356905e-06,3,2,1
15289,breed,1.48790438516857e-05,1.052487735929791e-05,13,7,6
15290,breeding,8.592123914353715e-06,5.348708166200577e-06,8,4,4
15291,brew,2.095639979110664e-07,3.6233184351681345e-06,4,1,3
15292,brewer,4.400843956132392e-06,3.6233184351681345e-06,4,2,2
15293,brewing,1.278340387257504e-05,1.052487735929791e-05,13,6,7
15294,bribe,4.4218003559234974e-05,3.8131113055817005e-05,49,23,26
15295,bribed,2.3052039770217305e-06,5.348708166200577e-06,5,2,3
15296,bribery,3.583544364279237e-05,2.6053384938589907e-05,37,19,18
15297,bribing,8.592123914353715e-06,7.074097897233022e-06,8,4,4
15298,brick,1.0687763893464371e-05,2.087721574549256e-05,17,5,12
15299,brickandmortar,2.3052039770217305e-06,3.6233184351681345e-06,4,2,2
15300,bride,1.6974683830796368e-05,2.6053384938589907e-05,27,9,18
15301,bridge,4.212236358012434e-05,4.1581892517881935e-05,49,21,28
15302,brief,2.5357243747239038e-05,2.4327995207557487e-05,33,16,17
15303,briefed,6.496483935243052e-06,1.052487735929791e-05,9,3,6
15304,briefing,1.9070323809907035e-05,1.742643628342769e-05,22,9,13
15305,briefly,1.0687763893464371e-05,1.052487735929791e-05,12,5,7
15306,brigade,2.3052039770217305e-06,5.348708166200577e-06,6,2,4
15307,bright,1.9070323809907035e-05,2.6053384938589907e-05,24,9,15
15308,brighter,6.496483935243052e-06,8.79948762826546e-06,9,4,5
15309,brilliance,2.3052039770217305e-06,1.8979287041356905e-06,3,2,1
15310,brilliant,1.9070323809907035e-05,1.570104655239525e-05,20,10,10
15311,bring,0.00028102532119873944,0.00027450950620726186,318,147,171
15312,bringing,7.355696326678427e-05,7.091351794543343e-05,85,40,45
15313,brink,4.840928351745632e-05,4.1581892517881935e-05,54,26,28
15314,brisk,2.3052039770217305e-06,1.8979287041356905e-06,3,1,2
15315,british,2.3052039770217305e-06,3.6233184351681345e-06,3,1,2
15316,bro,4.400843956132392e-06,3.6233184351681345e-06,4,2,2
15317,broad,2.7452883726349685e-05,2.6053384938589907e-05,31,13,18
15318,broadband,2.7452883726349685e-05,1.3975656821362803e-05,26,14,12
15319,broadcast,3.583544364279237e-05,3.2954943862719716e-05,42,19,23
15320,broadcaster,1.9070323809907035e-05,2.087721574549256e-05,23,10,13
15321,broadcasting,1.6974683830796368e-05,8.79948762826546e-06,13,8,5
15322,broaden,6.496483935243052e-06,5.348708166200577e-06,7,4,3
15323,broader,1.6974683830796368e-05,2.9504164400654783e-05,29,11,18
15324,broadly,4.400843956132392e-06,5.348708166200577e-06,8,4,4
15325,broadside,2.095639979110664e-07,3.6233184351681345e-06,4,1,3
15326,broke,9.660900303700153e-05,7.263890767646595e-05,104,52,52
15327,broken,0.00010499156295344414,8.126585633162811e-05,110,61,49
15328,broker,1.6974683830796368e-05,1.742643628342769e-05,21,11,10
15329,brokerage,4.400843956132392e-06,1.8979287041356905e-06,3,2,1
15330,brokered,8.592123914353715e-06,1.8979287041356905e-06,5,4,1
15331,bronze,8.592123914353715e-06,1.3975656821362803e-05,12,4,8
15332,brothel,1.9070323809907035e-05,2.2602605476525032e-05,25,11,14
15333,brother,0.00012385232276544028,0.00010024514337298497,125,64,61
15334,brotherinlaw,8.592123914353715e-06,1.8979287041356905e-06,5,4,1
15335,brothers,4.400843956132392e-06,1.8979287041356905e-06,4,2,2
15336,brought,0.00010708720293255492,0.0001382037174556987,153,61,92
15337,brown,1.0687763893464371e-05,1.052487735929791e-05,11,5,6
15338,browser,2.095639979110664e-07,5.348708166200577e-06,4,1,3
15339,browsing,1.0687763893464371e-05,1.3975656821362803e-05,16,6,10
15340,bruise,4.400843956132392e-06,5.348708166200577e-06,6,2,4
15341,bruised,6.496483935243052e-06,3.6233184351681345e-06,5,3,2
15342,brunt,4.400843956132392e-06,5.348708166200577e-06,6,2,4
15343,brush,2.095639979110664e-07,7.074097897233022e-06,4,0,4
15344,brutal,7.984388320411623e-05,5.883578982820635e-05,86,43,43
15345,brutality,5.050492349656699e-05,3.2954943862719716e-05,47,25,22
15346,brutalized,6.496483935243052e-06,5.348708166200577e-06,6,3,3
15347,brutally,2.5357243747239038e-05,2.4327995207557487e-05,28,12,16
15348,bu,0.00015109564249387862,0.00011059748175917965,148,76,72
15349,bubble,1.9070323809907035e-05,1.742643628342769e-05,21,10,11
15350,buck,6.496483935243052e-06,1.2250267090330355e-05,12,4,8
15351,bucket,6.496483935243052e-06,7.074097897233022e-06,8,3,5
15352,buckle,4.400843956132392e-06,1.7253897310324457e-07,3,2,1
15353,budding,8.592123914353715e-06,1.2250267090330355e-05,11,4,7
15354,buddy,4.400843956132392e-06,1.2250267090330355e-05,11,4,7
15355,budge,2.3052039770217305e-06,3.6233184351681345e-06,3,1,2
15356,budged,2.095639979110664e-07,5.348708166200577e-06,3,0,3
15357,budget,0.0001783389622223174,0.00017443690180738014,200,91,109
15358,budgetary,4.400843956132392e-06,3.6233184351681345e-06,4,2,2
15359,budgeting,8.592123914353715e-06,3.6233184351681345e-06,7,4,3
15360,buff,2.3052039770217305e-06,5.348708166200577e-06,4,1,3
15361,buffalo,8.592123914353715e-06,3.6233184351681345e-06,7,4,3
15362,buffer,4.400843956132392e-06,1.3975656821362803e-05,11,2,9
15363,buffoon,2.3052039770217305e-06,1.8979287041356905e-06,3,1,2
15364,bug,1.48790438516857e-05,1.052487735929791e-05,13,7,6
15365,bugged,4.400843956132392e-06,3.6233184351681345e-06,5,2,3
15366,bugging,2.095639979110664e-07,8.79948762826546e-06,6,0,6
15367,build,0.00023072996170008382,0.00026760794728313193,293,119,174
15368,builder,6.496483935243052e-06,3.6233184351681345e-06,6,4,2
15369,building,0.00027054712130318646,0.0003124680802899761,347,151,196
15370,buildup,1.48790438516857e-05,3.6233184351681345e-06,9,7,2
15371,built,0.00013223488268188294,0.00010542131256608228,136,68,68
15372,bulb,6.496483935243052e-06,3.6233184351681345e-06,7,3,4
15373,bulge,2.095639979110664e-07,3.6233184351681345e-06,3,0,3
15374,bulk,8.592123914353715e-06,8.79948762826546e-06,9,4,5
15375,bull,1.278340387257504e-05,1.8979287041356905e-06,9,8,1
15376,bulldoze,6.496483935243052e-06,3.6233184351681345e-06,6,3,3
15377,bulldozed,8.592123914353715e-06,1.8979287041356905e-06,5,4,1
15378,bulldozer,1.0687763893464371e-05,2.087721574549256e-05,18,6,12
15379,bulldozing,2.3052039770217305e-06,1.8979287041356905e-06,3,2,1
15380,bullet,6.517440335034157e-05,6.401195902130366e-05,74,34,40
15381,bulletproof,4.400843956132392e-06,5.348708166200577e-06,6,2,4
15382,bullfighting,6.496483935243052e-06,1.8979287041356905e-06,4,3,1
15383,bullied,6.496483935243052e-06,2.4327995207557487e-05,20,4,16
15384,bullion,4.400843956132392e-06,1.8979287041356905e-06,3,2,1
15385,bullish,2.3052039770217305e-06,3.6233184351681345e-06,3,1,2
15386,bullshit,6.496483935243052e-06,5.348708166200577e-06,6,3,3
15387,bullst,2.3052039770217305e-06,3.6233184351681345e-06,3,1,2
15388,bully,1.6974683830796368e-05,2.9504164400654783e-05,29,9,20
15389,bullying,3.7931083621902995e-05,3.2954943862719716e-05,41,20,21
15390,bumblebee,2.095639979110664e-07,5.348708166200577e-06,3,0,3
15391,bumbling,2.3052039770217305e-06,1.8979287041356905e-06,3,1,2
15392,bump,4.400843956132392e-06,2.087721574549256e-05,15,3,12
15393,bumpy,2.3052039770217305e-06,3.6233184351681345e-06,3,1,2
15394,bunch,1.6974683830796368e-05,1.570104655239525e-05,19,8,11
15395,bundle,2.3052039770217305e-06,3.6233184351681345e-06,4,2,2
15396,bungalow,4.400843956132392e-06,1.8979287041356905e-06,3,2,1
15397,bungled,2.3052039770217305e-06,3.6233184351681345e-06,3,1,2
15398,bunker,1.278340387257504e-05,1.570104655239525e-05,16,7,9
15399,burden,2.5357243747239038e-05,4.50326719799468e-05,42,13,29
15400,bureau,2.116596378901769e-05,2.777877466962238e-05,28,10,18
15401,bureaucracy,1.278340387257504e-05,1.052487735929791e-05,12,6,6
15402,bureaucrat,1.0687763893464371e-05,1.2250267090330355e-05,14,6,8
15403,bureaucratic,8.592123914353715e-06,3.6233184351681345e-06,6,4,2
15404,burgeoning,6.496483935243052e-06,7.074097897233022e-06,7,3,4
15405,burger,6.496483935243052e-06,7.074097897233022e-06,9,4,5
15406,burial,1.278340387257504e-05,1.9151826014460126e-05,17,6,11
15407,buried,5.888748341300963e-05,5.5385010366141504e-05,65,30,35
15408,burka,1.48790438516857e-05,1.2250267090330355e-05,16,7,9
15409,burn,9.03220830996695e-05,5.3659620635109e-05,79,45,34
15410,burned,7.355696326678427e-05,5.3659620635109e-05,77,39,38
15411,burning,9.870464301611217e-05,6.401195902130366e-05,91,52,39
15412,burnout,4.400843956132392e-06,7.074097897233022e-06,6,2,4
15413,burnt,1.48790438516857e-05,1.052487735929791e-05,13,7,6
15414,burqa,2.326160376812834e-05,2.2602605476525032e-05,28,13,15
15415,burrito,6.496483935243052e-06,1.7253897310324457e-07,4,4,0
15416,burst,2.954852370546031e-05,3.122955413168725e-05,36,15,21
15417,bursting,2.095639979110664e-07,1.052487735929791e-05,6,0,6
15418,bury,2.116596378901769e-05,2.4327995207557487e-05,25,10,15
15419,burying,4.400843956132392e-06,3.6233184351681345e-06,6,2,4
15420,bush,1.48790438516857e-05,5.348708166200577e-06,12,9,3
15421,bushfire,2.3052039770217305e-06,5.348708166200577e-06,5,1,4
15422,busiest,2.3052039770217305e-06,7.074097897233022e-06,6,2,4
15423,busily,6.496483935243052e-06,1.7253897310324457e-07,3,3,0
15424,busines,0.0004696329193186995,0.0005954319961792964,627,254,373
15425,business,4.400843956132392e-06,1.8979287041356905e-06,3,2,1
15426,businessman,5.050492349656699e-05,4.50326719799468e-05,61,31,30
15427,bust,3.1644163684570994e-05,1.9151826014460126e-05,32,15,17
15428,busted,1.0687763893464371e-05,2.087721574549256e-05,19,6,13
15429,bustle,2.3052039770217305e-06,3.6233184351681345e-06,3,1,2
15430,bustling,2.095639979110664e-07,3.6233184351681345e-06,3,1,2
15431,busy,4.002672360101368e-05,3.8131113055817005e-05,45,20,25
15432,but,2.3052039770217305e-06,3.6233184351681345e-06,3,1,2
15433,butcher,2.3052039770217305e-06,5.348708166200577e-06,4,1,3
15434,butler,8.592123914353715e-06,5.348708166200577e-06,8,4,4
15435,butt,6.496483935243052e-06,7.074097897233022e-06,8,3,5
15436,butter,6.496483935243052e-06,1.8979287041356905e-06,5,3,2
15437,butterfly,1.278340387257504e-05,8.79948762826546e-06,12,6,6
15438,buttock,2.3052039770217305e-06,5.348708166200577e-06,4,1,3
15439,button,2.116596378901769e-05,1.742643628342769e-05,22,11,11
15440,buy,0.00018462588215964923,0.00019859235804183437,234,98,136
15441,buyback,2.3052039770217305e-06,1.8979287041356905e-06,3,1,2
15442,buyer,2.954852370546031e-05,2.9504164400654783e-05,34,17,17
15443,buying,0.00010080028299522283,9.506897417988779e-05,115,53,62
15444,buzz,4.400843956132392e-06,7.074097897233022e-06,7,3,4
15445,buzzed,4.400843956132392e-06,1.8979287041356905e-06,3,2,1
15446,buzzing,4.400843956132392e-06,8.79948762826546e-06,8,2,6
15447,bypas,4.400843956132392e-06,8.79948762826546e-06,7,2,5
15448,bypassing,6.496483935243052e-06,1.8979287041356905e-06,5,4,1
15449,bystander,6.496483935243052e-06,1.2250267090330355e-05,10,3,7
15450,cab,4.400843956132392e-06,1.3975656821362803e-05,11,2,9
15451,cabbage,2.3052039770217305e-06,1.8979287041356905e-06,3,1,2
15452,cabin,4.400843956132392e-06,7.074097897233022e-06,7,3,4
15453,cabinet,7.565260324589493e-05,5.3659620635109e-05,75,40,35
15454,cable,0.0001259479627445509,9.506897417988779e-05,131,62,69
15455,cache,4.400843956132392e-06,8.79948762826546e-06,8,3,5
15456,cadet,6.496483935243052e-06,3.6233184351681345e-06,6,4,2
15457,cadre,4.400843956132392e-06,1.7253897310324457e-07,4,2,2
15458,caesium,4.400843956132392e-06,3.6233184351681345e-06,4,2,2
15459,caf,6.496483935243052e-06,1.7253897310324457e-07,3,3,0
15460,cafe,1.48790438516857e-05,1.9151826014460126e-05,20,7,13
15461,cage,8.592123914353715e-06,2.2602605476525032e-05,18,4,14
15462,caged,6.496483935243052e-06,5.348708166200577e-06,7,3,4
15463,cake,8.592123914353715e-06,1.570104655239525e-05,13,4,9
15464,calamity,1.278340387257504e-05,5.348708166200577e-06,9,6,3
15465,calculate,4.400843956132392e-06,3.6233184351681345e-06,4,2,2
15466,calculated,1.0687763893464371e-05,1.8979287041356905e-06,8,6,2
15467,calculating,4.400843956132392e-06,1.8979287041356905e-06,3,2,1
15468,calculation,1.278340387257504e-05,1.2250267090330355e-05,13,6,7
15469,calculator,6.496483935243052e-06,1.8979287041356905e-06,4,3,1
15470,calendar,1.48790438516857e-05,1.742643628342769e-05,18,8,10
15471,calf,8.592123914353715e-06,1.052487735929791e-05,11,5,6
15472,caliphate,8.592123914353715e-06,8.79948762826546e-06,10,5,5
15473,call,0.0009432475545977088,0.0009060021477651364,1087,497,590
15474,called,0.0005157369988591341,0.00056955115021381,637,267,370
15475,caller,6.496483935243052e-06,7.074097897233022e-06,7,3,4
15476,calling,0.00024330380157474795,0.0002400017115866128,291,127,164
15477,callou,2.3052039770217305e-06,3.6233184351681345e-06,3,1,2
15478,calm,2.954852370546031e-05,3.122955413168725e-05,33,15,18
15479,calorie,2.3052039770217305e-06,3.6233184351681345e-06,4,1,3
15480,cam,6.496483935243052e-06,1.8979287041356905e-06,4,3,1
15481,came,0.00019510408205520246,0.00022619859373835345,253,104,149
15482,camel,8.592123914353715e-06,8.79948762826546e-06,10,4,6
15483,camera,0.00011127848289077625,0.00012612598933847184,143,60,83
15484,cameraman,2.7452883726349685e-05,5.348708166200577e-06,16,13,3
15485,camouflage,2.3052039770217305e-06,5.348708166200577e-06,4,1,3
15486,camp,0.00015947820241032126,0.0001951415785797695,205,84,121
15487,campaign,0.0007944571160808521,0.0008404373379859039,953,418,535
15488,campaigned,6.496483935243052e-06,1.3975656821362803e-05,12,4,8
15489,campaigner,4.212236358012434e-05,3.640572332478458e-05,47,21,26
15490,campaigning,2.326160376812834e-05,1.742643628342769e-05,23,11,12
15491,camping,4.400843956132392e-06,3.6233184351681345e-06,4,2,2
15492,campu,3.7931083621902995e-05,3.468033359375216e-05,45,20,25
15493,can,7.355696326678427e-05,7.091351794543343e-05,81,37,44
15494,canal,6.496483935243052e-06,1.742643628342769e-05,13,3,10
15495,canary,4.400843956132392e-06,3.6233184351681345e-06,4,2,2
15496,cancel,5.6791843433898893e-05,9.161819471782287e-05,92,32,60
15497,canceled,3.1644163684570994e-05,1.9151826014460126e-05,26,15,11
15498,canceling,8.592123914353715e-06,7.074097897233022e-06,9,4,5
15499,cancellation,1.0687763893464371e-05,8.79948762826546e-06,10,5,5
15500,cancelled,3.7931083621902995e-05,2.9504164400654783e-05,41,19,22
15501,cancelling,2.3052039770217305e-06,3.6233184351681345e-06,3,1,2
15502,cancer,0.00014900000251476814,0.00021584625535215864,228,83,145
15503,cancerou,2.3052039770217305e-06,5.348708166200577e-06,4,1,3
15504,candid,6.496483935243052e-06,5.348708166200577e-06,6,3,3
15505,candidacy,2.5357243747239038e-05,2.2602605476525032e-05,25,12,13
15506,candidate,0.0004989718790262485,0.0005160640685518042,612,276,336
15507,candle,2.095639979110664e-07,5.348708166200577e-06,3,0,3
15508,candor,2.3052039770217305e-06,1.8979287041356905e-06,3,1,2
15509,candy,8.592123914353715e-06,1.052487735929791e-05,11,4,7
15510,cane,2.3052039770217305e-06,8.79948762826546e-06,8,1,7
15511,canister,1.278340387257504e-05,8.79948762826546e-06,14,6,8
15512,cannabi,0.00010708720293255492,7.436429740749831e-05,103,56,47
15513,canned,4.400843956132392e-06,5.348708166200577e-06,5,2,3
15514,cannibal,1.0687763893464371e-05,1.8979287041356905e-06,7,6,1
15515,cannibalism,6.496483935243052e-06,7.074097897233022e-06,8,4,4
15516,cannon,2.954852370546031e-05,2.2602605476525032e-05,28,14,14
15517,cannot,0.0002600689214076331,0.00021239547589009395,270,131,139
15518,canoe,2.3052039770217305e-06,3.6233184351681345e-06,3,1,2
15519,canon,2.3052039770217305e-06,1.7253897310324457e-07,3,1,2
15520,cant,0.0003019817209898466,0.0003003903521727485,355,160,195
15521,canteen,2.3052039770217305e-06,3.6233184351681345e-06,3,1,2
15522,canton,4.400843956132392e-06,3.6233184351681345e-06,4,2,2
15523,canyon,2.3052039770217305e-06,3.6233184351681345e-06,5,2,3
15524,cap,4.4218003559234974e-05,3.2954943862719716e-05,44,23,21
15525,capability,2.116596378901769e-05,2.9504164400654783e-05,28,11,17
15526,capable,2.5357243747239038e-05,2.777877466962238e-05,33,14,19
15527,capacity,4.840928351745632e-05,5.3659620635109e-05,61,26,35
15528,capital,0.0002621645613867441,0.0002469032705107427,281,130,151
15529,capitalism,1.9070323809907035e-05,2.9504164400654783e-05,31,12,19
15530,capitalist,6.496483935243052e-06,1.2250267090330355e-05,13,5,8
15531,capitalization,2.3052039770217305e-06,1.8979287041356905e-06,3,1,2
15532,capitalize,6.496483935243052e-06,7.074097897233022e-06,8,4,4
15533,capped,6.496483935243052e-06,3.6233184351681345e-06,6,3,3
15534,capsized,4.400843956132392e-06,3.6233184351681345e-06,4,2,2
15535,capsule,1.48790438516857e-05,5.348708166200577e-06,11,7,4
15536,captain,2.116596378901769e-05,3.122955413168725e-05,30,10,20
15537,captive,2.5357243747239038e-05,3.2954943862719716e-05,33,13,20
15538,captivity,2.3052039770217305e-06,3.6233184351681345e-06,4,1,3
15539,captor,6.496483935243052e-06,1.2250267090330355e-05,11,3,8
15540,capture,6.307876337123095e-05,7.091351794543343e-05,77,34,43
15541,captured,0.00011337412286988677,9.161819471782287e-05,124,61,63
15542,capturing,6.496483935243052e-06,5.348708166200577e-06,9,4,5
15543,caput,1.48790438516857e-05,2.6053384938589907e-05,22,7,15
15544,car,0.00038161604019605166,0.00035560282356578675,426,196,230
15545,carat,4.400843956132392e-06,1.8979287041356905e-06,3,2,1
15546,carbon,8.403516316233764e-05,8.126585633162811e-05,93,40,53
15547,carcas,6.496483935243052e-06,7.074097897233022e-06,8,3,5
15548,carcinogen,2.3052039770217305e-06,3.6233184351681345e-06,4,2,2
15549,carcinogenic,2.3052039770217305e-06,3.6233184351681345e-06,4,1,3
15550,card,0.0002244430417627521,0.00016753534288325053,226,120,106
15551,cardboard,4.400843956132392e-06,3.6233184351681345e-06,4,2,2
15552,cardholder,2.3052039770217305e-06,3.6233184351681345e-06,3,1,2
15553,cardiac,2.095639979110664e-07,5.348708166200577e-06,3,0,3
15554,cardinal,2.116596378901769e-05,1.742643628342769e-05,20,10,10
15555,care,0.00040466807996626886,0.0004487738690415387,494,211,283
15556,cared,8.592123914353715e-06,5.348708166200577e-06,11,7,4
15557,career,8.193952318322689e-05,0.00011404826122124471,119,50,69
15558,careful,2.116596378901769e-05,2.777877466962238e-05,29,12,17
15559,carefully,1.278340387257504e-05,1.3975656821362803e-05,14,6,8
15560,caregiver,2.3052039770217305e-06,3.6233184351681345e-06,3,1,2
15561,careles,2.3052039770217305e-06,5.348708166200577e-06,5,1,4
15562,caretaker,4.400843956132392e-06,1.7253897310324457e-07,3,2,1
15563,cargo,2.5357243747239038e-05,3.122955413168725e-05,33,15,18
15564,caricature,4.400843956132392e-06,5.348708166200577e-06,5,2,3
15565,caring,8.592123914353715e-06,7.074097897233022e-06,8,4,4
15566,carmaker,6.496483935243052e-06,5.348708166200577e-06,7,3,4
15567,carnage,4.400843956132392e-06,1.052487735929791e-05,10,2,8
15568,carnivore,8.592123914353715e-06,1.8979287041356905e-06,5,4,1
15569,carpenter,2.3052039770217305e-06,1.8979287041356905e-06,3,2,1
15570,carpet,6.496483935243052e-06,1.570104655239525e-05,12,3,9
15571,carriage,2.3052039770217305e-06,5.348708166200577e-06,6,1,5
15572,carried,6.307876337123095e-05,8.299124606266055e-05,86,32,54
15573,carrier,4.4218003559234974e-05,3.985650278684949e-05,47,21,26
15574,carrot,4.400843956132392e-06,1.8979287041356905e-06,3,2,1
15575,carry,0.00010289592297433347,0.00013130215853156914,139,53,86
15576,carrying,0.0001154697628489974,0.00011749904068330962,135,58,77
15577,cart,4.400843956132392e-06,8.79948762826546e-06,7,2,5
15578,cartel,0.00010708720293255492,9.334358444885519e-05,112,55,57
15579,carton,4.400843956132392e-06,1.8979287041356905e-06,3,2,1
15580,cartoon,6.517440335034157e-05,3.985650278684949e-05,57,31,26
15581,cartoonist,1.6974683830796368e-05,1.3975656821362803e-05,17,8,9
15582,carved,1.0687763893464371e-05,8.79948762826546e-06,12,5,7
15583,carving,1.278340387257504e-05,8.79948762826546e-06,11,6,5
15584,case,0.0007399704766239747,0.0007075823286964053,869,400,469
15585,cash,0.0001531912824729893,0.00013130215853156914,171,85,86
15586,cashed,2.3052039770217305e-06,3.6233184351681345e-06,4,2,2
15587,cashier,2.3052039770217305e-06,3.6233184351681345e-06,3,1,2
15588,cashing,6.496483935243052e-06,1.7253897310324457e-07,3,3,0
15589,cashstrapped,2.3052039770217305e-06,5.348708166200577e-06,4,1,3
15590,casino,1.9070323809907035e-05,2.087721574549256e-05,24,9,15
15591,cast,6.72700433294523e-05,7.091351794543343e-05,80,34,46
15592,caste,1.6974683830796368e-05,1.052487735929791e-05,20,10,10
15593,casting,1.0687763893464371e-05,8.79948762826546e-06,12,5,7
15594,castle,2.3052039770217305e-06,5.348708166200577e-06,4,1,3
15595,castrated,4.400843956132392e-06,1.8979287041356905e-06,3,2,1
15596,castration,8.592123914353715e-06,7.074097897233022e-06,8,4,4
15597,casual,8.592123914353715e-06,7.074097897233022e-06,8,4,4
15598,casually,4.400843956132392e-06,7.074097897233022e-06,6,2,4
15599,casualty,5.888748341300963e-05,4.330728224891437e-05,59,30,29
15600,cat,6.098312339212028e-05,5.3659620635109e-05,67,32,35
15601,cataclysmic,2.095639979110664e-07,3.6233184351681345e-06,3,1,2
15602,catalog,2.3052039770217305e-06,5.348708166200577e-06,4,1,3
15603,catalogue,2.3052039770217305e-06,8.79948762826546e-06,6,1,5
15604,catalyst,4.400843956132392e-06,3.6233184351681345e-06,4,2,2
15605,catastrophe,2.5357243747239038e-05,3.2954943862719716e-05,35,14,21
15606,catastrophic,3.3739803663681634e-05,2.777877466962238e-05,35,16,19
15607,catch,6.72700433294523e-05,5.711040009717395e-05,69,32,37
15608,catching,1.9070323809907035e-05,1.052487735929791e-05,15,9,6
15609,categorically,2.3052039770217305e-06,5.348708166200577e-06,4,1,3
15610,category,2.326160376812834e-05,2.087721574549256e-05,24,12,12
15611,cater,2.3052039770217305e-06,3.6233184351681345e-06,5,3,2
15612,catering,2.3052039770217305e-06,3.6233184351681345e-06,3,1,2
15613,cathedral,1.0687763893464371e-05,7.074097897233022e-06,11,7,4
15614,catholic,6.496483935243052e-06,5.348708166200577e-06,6,3,3
15615,cattle,1.9070323809907035e-05,5.348708166200577e-06,17,11,6
15616,caucu,3.1644163684570994e-05,3.468033359375216e-05,37,16,21
15617,caught,0.00016995640230587486,0.00016235917369015308,199,85,114
15618,cause,0.00023911252161652657,0.0002486286602417749,296,131,165
15619,caused,0.0001343305226609934,0.0001278513790695043,151,69,82
15620,causing,8.822644312055891e-05,8.989280498679035e-05,106,47,59
15621,caution,6.496483935243052e-06,8.79948762826546e-06,9,4,5
15622,cautionary,8.592123914353715e-06,1.8979287041356905e-06,6,5,1
15623,cautioned,2.095639979110664e-07,5.348708166200577e-06,5,2,3
15624,cautiou,1.0687763893464371e-05,1.8979287041356905e-06,6,5,1
15625,cautiously,4.400843956132392e-06,3.6233184351681345e-06,4,2,2
15626,cave,2.7452883726349685e-05,4.50326719799468e-05,43,14,29
15627,caveat,4.400843956132392e-06,3.6233184351681345e-06,4,2,2
15628,caved,2.095639979110664e-07,8.79948762826546e-06,5,0,5
15629,caviar,8.592123914353715e-06,1.7253897310324457e-07,4,4,0
15630,caving,2.3052039770217305e-06,1.8979287041356905e-06,3,1,2
15631,cease,1.0687763893464371e-05,2.2602605476525032e-05,19,5,14
15632,ceased,2.095639979110664e-07,1.3975656821362803e-05,8,0,8
15633,ceasefire,7.146132328767358e-05,5.5385010366141504e-05,77,36,41
15634,ceasing,6.496483935243052e-06,1.7253897310324457e-07,3,3,0
15635,cede,4.400843956132392e-06,1.8979287041356905e-06,3,2,1
15636,ceded,2.3052039770217305e-06,3.6233184351681345e-06,3,1,2
15637,ceiling,1.278340387257504e-05,1.570104655239525e-05,15,6,9
15638,celebrate,7.355696326678427e-05,8.644202552472544e-05,90,36,54
15639,celebrated,2.116596378901769e-05,2.777877466962238e-05,29,11,18
15640,celebrating,2.5357243747239038e-05,2.777877466962238e-05,35,13,22
15641,celebration,2.7452883726349685e-05,3.2954943862719716e-05,37,14,23
15642,celebrity,3.7931083621902995e-05,2.6053384938589907e-05,37,20,17
15643,celibacy,2.3052039770217305e-06,3.6233184351681345e-06,4,2,2
15644,cell,0.0001385218026192147,0.0001382037174556987,156,72,84
15645,cellar,4.400843956132392e-06,1.8979287041356905e-06,3,2,1
15646,cellphone,3.1644163684570994e-05,2.9504164400654783e-05,35,16,19
15647,cement,4.400843956132392e-06,1.9151826014460126e-05,13,2,11
15648,cemented,2.095639979110664e-07,3.6233184351681345e-06,3,1,2
15649,cemetery,2.116596378901769e-05,1.3975656821362803e-05,20,12,8
15650,censor,5.260056347567764e-05,3.2954943862719716e-05,47,26,21
15651,censored,2.116596378901769e-05,1.3975656821362803e-05,20,10,10
15652,censoring,2.116596378901769e-05,8.79948762826546e-06,16,10,6
15653,censorship,6.936568330856297e-05,5.020884117304414e-05,69,35,34
15654,censu,1.9070323809907035e-05,1.2250267090330355e-05,20,12,8
15655,censure,2.3052039770217305e-06,7.074097897233022e-06,5,1,4
15656,cent,6.517440335034157e-05,7.608968713853079e-05,80,32,48
15657,center,0.00018881716211787043,0.0001295767688005365,174,94,80
15658,centered,1.0687763893464371e-05,3.6233184351681345e-06,7,5,2
15659,centerpiece,4.400843956132392e-06,1.7253897310324457e-07,3,2,1
15660,centerright,2.3052039770217305e-06,3.6233184351681345e-06,3,1,2
15661,central,0.00015947820241032126,0.0001571830044970555,179,80,99
15662,centre,7.984388320411623e-05,7.954046660059569e-05,91,40,51
15663,centreleft,2.3052039770217305e-06,3.6233184351681345e-06,3,1,2
15664,centrifuge,2.095639979110664e-07,8.79948762826546e-06,5,0,5
15665,centrist,6.496483935243052e-06,1.2250267090330355e-05,11,4,7
15666,centuriesold,2.095639979110664e-07,1.052487735929791e-05,6,0,6
15667,century,0.0001531912824729893,0.0001278513790695043,167,84,83
15668,centuryold,6.496483935243052e-06,1.8979287041356905e-06,5,3,2
15669,cereal,2.3052039770217305e-06,1.7253897310324457e-07,3,1,2
15670,cerebral,2.3052039770217305e-06,3.6233184351681345e-06,6,2,4
15671,ceremony,3.7931083621902995e-05,5.020884117304414e-05,56,20,36
15672,certain,8.403516316233764e-05,0.00011232287149021227,123,49,74
15673,certainly,5.6791843433898893e-05,5.883578982820635e-05,65,28,37
15674,certainty,2.3052039770217305e-06,3.6233184351681345e-06,3,1,2
15675,certificate,3.3739803663681634e-05,2.777877466962238e-05,33,17,16
15676,certification,1.0687763893464371e-05,8.79948762826546e-06,10,5,5
15677,certified,2.3052039770217305e-06,7.074097897233022e-06,6,2,4
15678,cervical,4.400843956132392e-06,3.6233184351681345e-06,5,2,3
15679,cesium,6.496483935243052e-06,5.348708166200577e-06,8,3,5
15680,cessation,2.095639979110664e-07,5.348708166200577e-06,3,0,3
15681,cetacean,4.400843956132392e-06,1.8979287041356905e-06,3,2,1
15682,chain,5.260056347567764e-05,5.711040009717395e-05,70,28,42
15683,chained,4.400843956132392e-06,1.052487735929791e-05,8,2,6
15684,chainsaw,6.496483935243052e-06,1.8979287041356905e-06,6,4,2
15685,chair,6.098312339212028e-05,6.056117955923882e-05,74,34,40
15686,chairman,5.4696203454788295e-05,7.781507686956326e-05,77,31,46
15687,chairmanship,2.3052039770217305e-06,5.348708166200577e-06,5,1,4
15688,challenge,0.00018672152213876006,0.00026243177809003493,272,100,172
15689,challenged,2.5357243747239038e-05,1.9151826014460126e-05,25,13,12
15690,challenger,1.48790438516857e-05,1.742643628342769e-05,18,7,11
15691,challenging,3.7931083621902995e-05,3.985650278684949e-05,47,19,28
15692,chamber,2.954852370546031e-05,3.985650278684949e-05,40,15,25
15693,champ,2.3052039770217305e-06,3.6233184351681345e-06,3,1,2
15694,champagne,2.3052039770217305e-06,3.6233184351681345e-06,4,1,3
15695,champion,2.5357243747239038e-05,3.8131113055817005e-05,36,14,22
15696,championed,4.400843956132392e-06,3.6233184351681345e-06,4,2,2
15697,championing,2.095639979110664e-07,5.348708166200577e-06,4,1,3
15698,championship,1.6974683830796368e-05,7.074097897233022e-06,15,8,7
15699,chance,0.00014900000251476814,0.0001485560558418934,174,73,101
15700,chancellor,1.0687763893464371e-05,1.742643628342769e-05,16,5,11
15701,change,0.0007986483960390736,0.0008645927942203583,981,425,556
15702,changed,0.00011127848289077625,9.334358444885519e-05,121,61,60
15703,changer,4.400843956132392e-06,5.348708166200577e-06,6,3,3
15704,changing,6.936568330856297e-05,7.781507686956326e-05,84,35,49
15705,channel,5.4696203454788295e-05,5.5385010366141504e-05,66,29,37
15706,channeled,2.095639979110664e-07,3.6233184351681345e-06,3,0,3
15707,channeling,4.400843956132392e-06,3.6233184351681345e-06,4,2,2
15708,chant,2.116596378901769e-05,1.570104655239525e-05,20,10,10
15709,chanted,4.400843956132392e-06,1.052487735929791e-05,8,2,6
15710,chanting,2.116596378901769e-05,1.052487735929791e-05,17,10,7
15711,chao,6.098312339212028e-05,6.401195902130366e-05,71,32,39
15712,chaotic,6.496483935243052e-06,8.79948762826546e-06,10,4,6
15713,chapel,6.496483935243052e-06,1.8979287041356905e-06,4,3,1
15714,chaplain,2.095639979110664e-07,7.074097897233022e-06,4,0,4
15715,chapter,1.6974683830796368e-05,1.742643628342769e-05,22,9,13
15716,character,4.002672360101368e-05,4.50326719799468e-05,52,21,31
15717,characterised,4.400843956132392e-06,1.8979287041356905e-06,3,2,1
15718,characteristic,1.0687763893464371e-05,5.348708166200577e-06,8,5,3
15719,characterize,2.3052039770217305e-06,3.6233184351681345e-06,4,2,2
15720,characterized,6.496483935243052e-06,1.052487735929791e-05,9,3,6
15721,charade,2.095639979110664e-07,5.348708166200577e-06,4,0,4
15722,charge,0.000459154719423146,0.00041599146415192246,524,248,276
15723,charged,0.00022863432172097337,0.00018996540938667205,246,121,125
15724,charger,2.3052039770217305e-06,5.348708166200577e-06,4,1,3
15725,charging,4.002672360101368e-05,2.6053384938589907e-05,35,20,15
15726,chariot,6.496483935243052e-06,1.7253897310324457e-07,3,3,0
15727,charitable,6.496483935243052e-06,1.570104655239525e-05,14,3,11
15728,charity,0.00010080028299522283,7.436429740749831e-05,97,48,49
15729,charm,6.496483935243052e-06,1.052487735929791e-05,10,4,6
15730,charred,2.095639979110664e-07,7.074097897233022e-06,4,0,4
15731,chart,2.7452883726349685e-05,1.9151826014460126e-05,27,15,12
15732,charter,3.1644163684570994e-05,1.570104655239525e-05,28,18,10
15733,chase,1.48790438516857e-05,1.2250267090330355e-05,16,8,8
15734,chased,1.48790438516857e-05,7.074097897233022e-06,11,7,4
15735,chasing,6.496483935243052e-06,5.348708166200577e-06,7,3,4
15736,chasm,2.3052039770217305e-06,5.348708166200577e-06,4,1,3
15737,chastise,2.095639979110664e-07,3.6233184351681345e-06,3,0,3
15738,chat,1.9070323809907035e-05,1.9151826014460126e-05,23,10,13
15739,chatroom,2.3052039770217305e-06,3.6233184351681345e-06,3,1,2
15740,chatter,6.496483935243052e-06,1.7253897310324457e-07,4,3,1
15741,cheap,5.4696203454788295e-05,2.2602605476525032e-05,46,29,17
15742,cheaper,4.840928351745632e-05,2.6053384938589907e-05,42,25,17
15743,cheapest,6.496483935243052e-06,3.6233184351681345e-06,6,3,3
15744,cheat,1.6974683830796368e-05,1.9151826014460126e-05,22,10,12
15745,cheated,2.095639979110664e-07,1.8979287041356905e-06,4,2,2
15746,cheating,2.116596378901769e-05,2.4327995207557487e-05,26,12,14
15747,check,0.00012175668278632962,0.00012440059960743937,147,66,81
15748,checked,1.48790438516857e-05,1.3975656821362803e-05,21,9,12
15749,checking,2.116596378901769e-05,2.087721574549256e-05,24,11,13
15750,checkpoint,1.0687763893464371e-05,1.570104655239525e-05,15,6,9
15751,cheeky,9.870464301611217e-05,8.644202552472544e-05,110,53,57
15752,cheer,1.0687763893464371e-05,1.9151826014460126e-05,20,6,14
15753,cheered,4.400843956132392e-06,7.074097897233022e-06,6,2,4
15754,cheering,2.5357243747239038e-05,1.2250267090330355e-05,19,12,7
15755,cheerleader,6.496483935243052e-06,5.348708166200577e-06,6,3,3
15756,cheese,1.278340387257504e-05,1.3975656821362803e-05,14,6,8
15757,chef,1.9070323809907035e-05,5.348708166200577e-06,13,10,3
15758,chemical,0.00012175668278632962,0.00017098612234531542,180,67,113
15759,chemist,2.095639979110664e-07,5.348708166200577e-06,3,0,3
15760,chemistry,6.496483935243052e-06,1.8979287041356905e-06,6,3,3
15761,chemotherapy,6.496483935243052e-06,3.6233184351681345e-06,5,3,2
15762,cherished,6.496483935243052e-06,1.8979287041356905e-06,4,3,1
15763,cherrypicking,2.3052039770217305e-06,3.6233184351681345e-06,3,1,2
15764,ches,1.278340387257504e-05,1.2250267090330355e-05,14,6,8
15765,chest,1.0687763893464371e-05,1.2250267090330355e-05,15,5,10
15766,chewing,8.592123914353715e-06,1.8979287041356905e-06,5,4,1
15767,chick,4.400843956132392e-06,1.7253897310324457e-07,3,2,1
15768,chicken,3.1644163684570994e-05,1.570104655239525e-05,27,15,12
15769,chide,4.400843956132392e-06,1.8979287041356905e-06,3,2,1
15770,chief,0.0004423895995902609,0.0004021883463036628,488,220,268
15771,child,0.0013162714708794072,0.001152732879302776,1445,691,754
15772,childbirth,2.095639979110664e-07,8.79948762826546e-06,7,0,7
15773,childcare,1.278340387257504e-05,3.6233184351681345e-06,10,7,3
15774,childhood,3.1644163684570994e-05,2.777877466962238e-05,33,16,17
15775,children,4.212236358012434e-05,4.1581892517881935e-05,49,23,26
15776,chill,4.400843956132392e-06,1.052487735929791e-05,11,4,7
15777,chilli,2.3052039770217305e-06,5.348708166200577e-06,4,1,3
15778,chilling,1.9070323809907035e-05,1.2250267090330355e-05,21,12,9
15779,chimed,2.3052039770217305e-06,3.6233184351681345e-06,3,1,2
15780,chimp,2.095639979110664e-07,5.348708166200577e-06,3,0,3
15781,chimpanzee,2.3052039770217305e-06,7.074097897233022e-06,6,1,5
15782,chin,2.3052039770217305e-06,1.8979287041356905e-06,3,2,1
15783,chip,2.7452883726349685e-05,2.087721574549256e-05,28,15,13
15784,chipped,2.3052039770217305e-06,3.6233184351681345e-06,3,1,2
15785,chlorine,2.3052039770217305e-06,8.79948762826546e-06,6,1,5
15786,chocolate,3.1644163684570994e-05,1.9151826014460126e-05,28,16,12
15787,choice,0.00014900000251476814,0.0001278513790695043,167,78,89
15788,choir,4.400843956132392e-06,5.348708166200577e-06,6,2,4
15789,choke,2.095639979110664e-07,5.348708166200577e-06,3,0,3
15790,choked,4.400843956132392e-06,5.348708166200577e-06,5,2,3
15791,choking,4.400843956132392e-06,1.052487735929791e-05,9,2,7
15792,cholera,2.5357243747239038e-05,2.2602605476525032e-05,25,12,13
15793,choose,8.403516316233764e-05,0.00010542131256608228,112,43,69
15794,choosing,2.5357243747239038e-05,2.9504164400654783e-05,30,13,17
15795,chop,2.3052039770217305e-06,8.79948762826546e-06,7,1,6
15796,chopped,4.400843956132392e-06,5.348708166200577e-06,6,2,4
15797,chopper,1.278340387257504e-05,8.79948762826546e-06,12,7,5
15798,chopping,8.592123914353715e-06,7.074097897233022e-06,8,4,4
15799,choru,1.0687763893464371e-05,1.3975656821362803e-05,13,5,8
15800,chose,2.116596378901769e-05,2.4327995207557487e-05,27,12,15
15801,chosen,2.116596378901769e-05,3.640572332478458e-05,33,12,21
15802,christian,2.3052039770217305e-06,3.6233184351681345e-06,3,1,2
15803,chronic,1.0687763893464371e-05,2.087721574549256e-05,18,5,13
15804,chronically,4.400843956132392e-06,3.6233184351681345e-06,4,2,2
15805,chronicle,2.095639979110664e-07,3.6233184351681345e-06,3,0,3
15806,chunk,2.116596378901769e-05,1.052487735929791e-05,17,10,7
15807,church,0.00018672152213876006,0.00017443690180738014,198,93,105
15808,churning,4.400843956132392e-06,1.7253897310324457e-07,3,3,0
15809,cigarette,4.002672360101368e-05,3.468033359375216e-05,43,22,21
15810,cinema,8.592123914353715e-06,3.6233184351681345e-06,8,4,4
15811,circle,2.326160376812834e-05,3.2954943862719716e-05,36,15,21
15812,circling,8.592123914353715e-06,3.6233184351681345e-06,6,4,2
15813,circu,1.278340387257504e-05,1.570104655239525e-05,20,9,11
15814,circuit,4.400843956132392e-06,8.79948762826546e-06,7,2,5
15815,circular,2.3052039770217305e-06,5.348708166200577e-06,4,1,3
15816,circulate,4.400843956132392e-06,1.8979287041356905e-06,3,2,1
15817,circulated,2.3052039770217305e-06,1.8979287041356905e-06,3,2,1
15818,circulating,6.496483935243052e-06,7.074097897233022e-06,7,3,4
15819,circulation,8.592123914353715e-06,1.3975656821362803e-05,12,4,8
15820,circumcised,2.3052039770217305e-06,5.348708166200577e-06,5,2,3
15821,circumcision,3.583544364279237e-05,2.087721574549256e-05,31,18,13
15822,circumstance,2.5357243747239038e-05,3.2954943862719716e-05,36,13,23
15823,circumvent,4.400843956132392e-06,3.6233184351681345e-06,6,3,3
15824,circumventing,4.400843956132392e-06,3.6233184351681345e-06,4,2,2
15825,citation,6.496483935243052e-06,1.7253897310324457e-07,3,3,0
15826,cite,1.6974683830796368e-05,3.468033359375216e-05,30,9,21
15827,cited,2.5357243747239038e-05,2.9504164400654783e-05,35,15,20
15828,citing,4.212236358012434e-05,5.020884117304414e-05,54,22,32
15829,citizen,0.00035856400042583424,0.00034697587491062454,417,189,228
15830,citizenship,7.774824322500554e-05,9.851975364195259e-05,97,40,57
15831,city,0.0007357791966657534,0.000830084999599709,919,392,527
15832,civic,2.116596378901769e-05,1.570104655239525e-05,20,10,10
15833,civil,0.00023072996170008382,0.0002382763218555804,276,120,156
15834,civilian,0.0002684514813240757,0.0002883126240555216,330,144,186
15835,civilisation,6.496483935243052e-06,7.074097897233022e-06,7,3,4
15836,civility,6.496483935243052e-06,8.79948762826546e-06,8,3,5
15837,civilization,1.6974683830796368e-05,1.9151826014460126e-05,20,9,11
15838,civilized,6.496483935243052e-06,7.074097897233022e-06,7,3,4
15839,claim,0.0006938663970835407,0.0007800486973997685,864,366,498
15840,claimed,0.00014271308257743603,0.0001382037174556987,169,74,95
15841,claiming,8.822644312055891e-05,5.711040009717395e-05,85,44,41
15842,clamoring,2.3052039770217305e-06,5.348708166200577e-06,4,1,3
15843,clamp,1.278340387257504e-05,3.6233184351681345e-06,10,7,3
15844,clampdown,4.400843956132392e-06,3.6233184351681345e-06,4,2,2
15845,clan,4.400843956132392e-06,1.8979287041356905e-06,3,2,1
15846,clandestine,1.278340387257504e-05,1.3975656821362803e-05,14,6,8
15847,clap,6.496483935243052e-06,1.8979287041356905e-06,5,3,2
15848,clapping,4.400843956132392e-06,1.8979287041356905e-06,3,2,1
15849,clarified,2.095639979110664e-07,7.074097897233022e-06,4,0,4
15850,clarify,1.0687763893464371e-05,5.348708166200577e-06,11,8,3
15851,clarity,1.0687763893464371e-05,5.348708166200577e-06,9,5,4
15852,clas,0.00014480872255654665,0.00016580995315221804,204,89,115
15853,clash,0.00012804360272366158,0.00013130215853156914,150,66,84
15854,clashed,1.0687763893464371e-05,1.9151826014460126e-05,16,5,11
15855,clashing,2.3052039770217305e-06,5.348708166200577e-06,4,1,3
15856,classaction,8.592123914353715e-06,5.348708166200577e-06,8,4,4
15857,classic,1.48790438516857e-05,2.087721574549256e-05,20,7,13
15858,classical,2.3052039770217305e-06,8.79948762826546e-06,6,1,5
15859,classified,5.4696203454788295e-05,4.1581892517881935e-05,55,29,26
15860,classify,8.592123914353715e-06,3.6233184351681345e-06,7,5,2
15861,classmate,1.0687763893464371e-05,5.348708166200577e-06,9,5,4
15862,classroom,1.278340387257504e-05,3.2954943862719716e-05,27,7,20
15863,classy,1.0687763893464371e-05,1.052487735929791e-05,11,5,6
15864,clause,1.48790438516857e-05,8.79948762826546e-06,14,8,6
15865,clean,0.00011127848289077625,0.0001347529379936339,138,55,83
15866,cleaned,2.3052039770217305e-06,5.348708166200577e-06,4,1,3
15867,cleaner,1.278340387257504e-05,8.79948762826546e-06,13,7,6
15868,cleaning,1.48790438516857e-05,1.3975656821362803e-05,17,8,9
15869,cleanse,4.400843956132392e-06,7.074097897233022e-06,6,2,4
15870,cleansing,2.7452883726349685e-05,1.9151826014460126e-05,26,15,11
15871,cleanup,8.592123914353715e-06,2.087721574549256e-05,19,4,15
15872,clear,0.00023911252161652657,0.00026933333701416437,300,128,172
15873,clearance,1.48790438516857e-05,1.570104655239525e-05,17,8,9
15874,cleared,2.326160376812834e-05,1.9151826014460126e-05,27,15,12
15875,clearer,1.0687763893464371e-05,5.348708166200577e-06,8,5,3
15876,clearest,4.400843956132392e-06,7.074097897233022e-06,6,2,4
15877,clearing,3.3739803663681634e-05,7.074097897233022e-06,21,17,4
15878,clearly,5.050492349656699e-05,4.50326719799468e-05,59,27,32
15879,cleavage,2.3052039770217305e-06,1.7253897310324457e-07,3,1,2
15880,clemency,4.400843956132392e-06,1.2250267090330355e-05,9,2,7
15881,clergy,1.48790438516857e-05,1.570104655239525e-05,19,7,12
15882,cleric,7.355696326678427e-05,7.608968713853079e-05,88,37,51
15883,clerical,1.0687763893464371e-05,7.074097897233022e-06,9,5,4
15884,clerk,1.0687763893464371e-05,1.052487735929791e-05,12,5,7
15885,clever,1.0687763893464371e-05,3.6233184351681345e-06,8,6,2
15886,cliché,4.400843956132392e-06,7.074097897233022e-06,6,2,4
15887,click,2.116596378901769e-05,2.2602605476525032e-05,26,11,15
15888,client,9.24177230787802e-05,7.608968713853079e-05,94,49,45
15889,cliff,2.116596378901769e-05,8.79948762826546e-06,15,10,5
15890,climate,0.0004926849590889169,0.0004625769868897986,557,260,297
15891,climatechange,4.400843956132392e-06,7.074097897233022e-06,6,2,4
15892,climaterelated,2.3052039770217305e-06,3.6233184351681345e-06,3,1,2
15893,climb,1.48790438516857e-05,1.742643628342769e-05,20,7,13
15894,climbed,8.592123914353715e-06,1.052487735929791e-05,11,4,7
15895,climber,1.6974683830796368e-05,1.2250267090330355e-05,15,8,7
15896,climbing,1.278340387257504e-05,8.79948762826546e-06,12,6,6
15897,clinch,6.496483935243052e-06,3.6233184351681345e-06,7,3,4
15898,cling,6.496483935243052e-06,1.7253897310324457e-07,3,3,0
15899,clinging,4.400843956132392e-06,3.6233184351681345e-06,5,3,2
15900,clinic,5.6791843433898893e-05,4.1581892517881935e-05,60,31,29
15901,clinical,1.0687763893464371e-05,1.052487735929791e-05,11,5,6
15902,clinically,4.400843956132392e-06,1.8979287041356905e-06,3,2,1
15903,clip,1.0687763893464371e-05,1.3975656821362803e-05,13,5,8
15904,cloak,2.3052039770217305e-06,7.074097897233022e-06,5,1,4
15905,clock,1.9070323809907035e-05,2.777877466962238e-05,27,9,18
15906,clocked,4.400843956132392e-06,1.8979287041356905e-06,3,2,1
15907,clogged,2.095639979110664e-07,7.074097897233022e-06,4,0,4
15908,clone,8.592123914353715e-06,1.8979287041356905e-06,8,4,4
15909,cloned,1.0687763893464371e-05,8.79948762826546e-06,10,5,5
15910,cloning,6.496483935243052e-06,3.6233184351681345e-06,6,3,3
15911,close,0.00033341632067650624,0.00026933333701416437,344,171,173
15912,closed,8.403516316233764e-05,8.299124606266055e-05,99,44,55
15913,closedcircuit,2.3052039770217305e-06,3.6233184351681345e-06,3,1,2
15914,closeddoor,4.400843956132392e-06,5.348708166200577e-06,7,2,5
15915,closely,2.954852370546031e-05,2.9504164400654783e-05,36,16,20
15916,closer,0.00010708720293255492,8.4716635793693e-05,112,57,55
15917,closest,2.116596378901769e-05,2.087721574549256e-05,24,10,14
15918,closet,8.592123914353715e-06,3.6233184351681345e-06,6,4,2
15919,closing,3.7931083621902995e-05,3.985650278684949e-05,48,21,27
15920,closure,3.3739803663681634e-05,3.122955413168725e-05,36,17,19
15921,cloth,6.496483935243052e-06,1.7253897310324457e-07,3,3,0
15922,clothe,3.7931083621902995e-05,4.6758061710979285e-05,48,20,28
15923,clothing,5.050492349656699e-05,2.9504164400654783e-05,42,25,17
15924,cloud,4.4218003559234974e-05,4.6758061710979285e-05,57,25,32
15925,clout,2.095639979110664e-07,3.6233184351681345e-06,3,0,3
15926,clown,8.592123914353715e-06,3.6233184351681345e-06,9,6,3
15927,club,4.002672360101368e-05,4.50326719799468e-05,49,20,29
15928,clue,1.9070323809907035e-05,1.052487735929791e-05,17,11,6
15929,clueles,2.3052039770217305e-06,3.6233184351681345e-06,6,2,4
15930,cluster,1.48790438516857e-05,1.742643628342769e-05,22,8,14
15931,clutter,2.095639979110664e-07,5.348708166200577e-06,3,0,3
15932,co,6.496483935243052e-06,1.8979287041356905e-06,4,3,1
15933,coach,2.116596378901769e-05,1.742643628342769e-05,22,11,11
15934,coaching,2.095639979110664e-07,7.074097897233022e-06,4,0,4
15935,coal,0.00012385232276544028,0.0001364783277246665,144,62,82
15936,coalfired,6.496483935243052e-06,1.742643628342769e-05,14,3,11
15937,coalition,7.984388320411623e-05,7.091351794543343e-05,95,43,52
15938,coalmine,2.3052039770217305e-06,1.8979287041356905e-06,3,2,1
15939,coast,0.00012175668278632962,0.00014337988664879628,152,60,92
15940,coastal,2.5357243747239038e-05,2.6053384938589907e-05,28,12,16
15941,coaster,2.3052039770217305e-06,5.348708166200577e-06,4,1,3
15942,coastguard,2.095639979110664e-07,3.6233184351681345e-06,4,1,3
15943,coastline,6.496483935243052e-06,7.074097897233022e-06,7,3,4
15944,coat,2.095639979110664e-07,5.348708166200577e-06,3,0,3
15945,coated,4.400843956132392e-06,3.6233184351681345e-06,5,3,2
15946,coattail,6.496483935243052e-06,1.7253897310324457e-07,3,3,0
15947,coauthor,4.400843956132392e-06,3.6233184351681345e-06,4,2,2
15948,coca,1.48790438516857e-05,1.3975656821362803e-05,15,7,8
15949,cocaine,5.260056347567764e-05,5.3659620635109e-05,68,32,36
15950,cockatoo,2.3052039770217305e-06,3.6233184351681345e-06,3,1,2
15951,cockpit,4.400843956132392e-06,8.79948762826546e-06,7,2,5
15952,cocktail,1.0687763893464371e-05,7.074097897233022e-06,10,5,5
15953,cocoa,2.3052039770217305e-06,3.6233184351681345e-06,3,1,2
15954,coconspirator,2.3052039770217305e-06,3.6233184351681345e-06,3,1,2
15955,cod,6.496483935243052e-06,3.6233184351681345e-06,5,3,2
15956,code,5.4696203454788295e-05,6.056117955923882e-05,68,28,40
15957,codebreaker,8.592123914353715e-06,1.8979287041356905e-06,6,4,2
15958,coded,2.3052039770217305e-06,3.6233184351681345e-06,3,1,2
15959,coding,2.3052039770217305e-06,7.074097897233022e-06,5,1,4
15960,coerced,1.0687763893464371e-05,7.074097897233022e-06,9,5,4
15961,coercion,2.095639979110664e-07,5.348708166200577e-06,3,0,3
15962,coercive,2.3052039770217305e-06,3.6233184351681345e-06,3,1,2
15963,coexist,2.3052039770217305e-06,3.6233184351681345e-06,5,1,4
15964,coexistence,8.592123914353715e-06,1.8979287041356905e-06,6,4,2
15965,coffee,4.212236358012434e-05,4.6758061710979285e-05,53,22,31
15966,coffer,1.48790438516857e-05,7.074097897233022e-06,12,7,5
15967,coffin,1.6974683830796368e-05,3.6233184351681345e-06,10,8,2
15968,cofounded,4.400843956132392e-06,1.8979287041356905e-06,3,2,1
15969,cofounder,1.9070323809907035e-05,2.6053384938589907e-05,27,11,16
15970,cognitive,2.095639979110664e-07,1.3975656821362803e-05,8,0,8
15971,coherent,4.400843956132392e-06,3.6233184351681345e-06,5,2,3
15972,cohort,4.400843956132392e-06,1.8979287041356905e-06,4,2,2
15973,cohost,6.496483935243052e-06,1.052487735929791e-05,10,4,6
15974,coin,4.212236358012434e-05,4.330728224891437e-05,47,22,25
15975,coincide,6.496483935243052e-06,1.052487735929791e-05,10,4,6
15976,coincidence,4.400843956132392e-06,7.074097897233022e-06,8,2,6
15977,coined,2.3052039770217305e-06,3.6233184351681345e-06,3,1,2
15978,coke,2.3052039770217305e-06,3.6233184351681345e-06,3,1,2
15979,cold,5.050492349656699e-05,5.020884117304414e-05,57,25,32
15980,coldblooded,4.400843956132392e-06,1.8979287041356905e-06,3,2,1
15981,coli,6.496483935243052e-06,1.8979287041356905e-06,4,3,1
15982,collaborate,8.592123914353715e-06,1.8979287041356905e-06,7,4,3
15983,collaborated,6.496483935243052e-06,1.8979287041356905e-06,5,3,2
15984,collaboration,1.6974683830796368e-05,1.3975656821362803e-05,19,8,11
15985,collaborative,2.3052039770217305e-06,7.074097897233022e-06,6,1,5
15986,collaborator,6.496483935243052e-06,5.348708166200577e-06,7,3,4
15987,collapse,0.0001741476822640959,0.0001278513790695043,181,92,89
15988,collapsed,4.002672360101368e-05,2.9504164400654783e-05,41,19,22
15989,collapsing,6.496483935243052e-06,1.2250267090330355e-05,13,5,8
15990,collateral,2.3052039770217305e-06,1.052487735929791e-05,8,2,6
15991,colleague,0.00010289592297433347,9.679436391092026e-05,112,54,58
15992,collect,3.1644163684570994e-05,1.570104655239525e-05,28,15,13
15993,collected,3.583544364279237e-05,3.122955413168725e-05,38,18,20
15994,collecting,1.9070323809907035e-05,2.6053384938589907e-05,26,10,16
15995,collection,2.954852370546031e-05,4.8483451442011706e-05,51,19,32
15996,collective,3.1644163684570994e-05,3.2954943862719716e-05,36,16,20
15997,collectively,8.592123914353715e-06,1.570104655239525e-05,14,5,9
15998,collector,1.278340387257504e-05,1.3975656821362803e-05,17,8,9
15999,college,0.0001552869224521,0.0001382037174556987,179,87,92
16000,collide,1.0687763893464371e-05,8.79948762826546e-06,10,5,5
16001,collision,1.48790438516857e-05,1.742643628342769e-05,17,7,10
16002,colluded,8.592123914353715e-06,1.052487735929791e-05,10,4,6
16003,colluding,8.592123914353715e-06,8.79948762826546e-06,9,4,5
16004,collusion,1.48790438516857e-05,1.2250267090330355e-05,18,11,7
16005,colonel,1.48790438516857e-05,1.052487735929791e-05,13,7,6
16006,colonial,1.6974683830796368e-05,3.6233184351681345e-06,11,9,2
16007,colonialism,6.496483935243052e-06,8.79948762826546e-06,8,3,5
16008,colonisation,6.496483935243052e-06,1.7253897310324457e-07,3,3,0
16009,colonization,4.400843956132392e-06,1.8979287041356905e-06,3,2,1
16010,colony,1.48790438516857e-05,2.087721574549256e-05,21,8,13
16011,color,5.260056347567764e-05,6.228656929027126e-05,71,29,42
16012,colored,2.3052039770217305e-06,5.348708166200577e-06,5,1,4
16013,colorful,6.496483935243052e-06,1.8979287041356905e-06,5,3,2
16014,colossal,2.3052039770217305e-06,3.6233184351681345e-06,3,1,2
16015,colour,1.0687763893464371e-05,5.348708166200577e-06,8,5,3
16016,coloured,4.400843956132392e-06,1.8979287041356905e-06,3,2,1
16017,column,3.3739803663681634e-05,2.4327995207557487e-05,33,16,17
16018,columnist,2.326160376812834e-05,1.052487735929791e-05,17,11,6
16019,coma,1.9070323809907035e-05,8.79948762826546e-06,15,9,6
16020,combat,0.00010499156295344414,0.00010542131256608228,118,55,63
16021,combatant,6.496483935243052e-06,8.79948762826546e-06,9,3,6
16022,combating,6.496483935243052e-06,1.052487735929791e-05,11,4,7
16023,combative,4.400843956132392e-06,7.074097897233022e-06,8,4,4
16024,combination,1.0687763893464371e-05,2.2602605476525032e-05,20,6,14
16025,combine,6.496483935243052e-06,2.087721574549256e-05,17,3,14
16026,combined,2.954852370546031e-05,4.50326719799468e-05,43,15,28
16027,combining,2.095639979110664e-07,5.348708166200577e-06,3,0,3
16028,come,0.0007860745561644094,0.0007489916822411843,917,425,492
16029,comeback,2.116596378901769e-05,1.2250267090330355e-05,20,11,9
16030,comedian,2.326160376812834e-05,2.4327995207557487e-05,26,11,15
16031,comedy,1.278340387257504e-05,1.3975656821362803e-05,15,7,8
16032,comet,2.116596378901769e-05,7.074097897233022e-06,17,10,7
16033,comfort,1.9070323809907035e-05,3.122955413168725e-05,29,10,19
16034,comfortable,1.6974683830796368e-05,1.742643628342769e-05,23,10,13
16035,comfortably,4.400843956132392e-06,1.7253897310324457e-07,4,4,0
16036,comforting,4.400843956132392e-06,1.8979287041356905e-06,3,2,1
16037,comic,1.278340387257504e-05,8.79948762826546e-06,13,7,6
16038,coming,0.00019929536201342395,0.0002313747629314509,252,110,142
16039,comm,2.095639979110664e-07,5.348708166200577e-06,3,0,3
16040,command,2.326160376812834e-05,2.087721574549256e-05,27,13,14
16041,commandant,2.3052039770217305e-06,3.6233184351681345e-06,3,1,2
16042,commander,0.00010918284291166549,9.161819471782287e-05,120,60,60
16043,commanderinchief,4.400843956132392e-06,8.79948762826546e-06,8,3,5
16044,commanding,2.095639979110664e-07,5.348708166200577e-06,3,0,3
16045,commando,1.6974683830796368e-05,2.4327995207557487e-05,27,10,17
16046,commemorate,8.592123914353715e-06,1.2250267090330355e-05,13,5,8
16047,commemorating,6.496483935243052e-06,3.6233184351681345e-06,6,3,3
16048,commemoration,8.592123914353715e-06,7.074097897233022e-06,11,7,4
16049,commence,2.3052039770217305e-06,5.348708166200577e-06,4,1,3
16050,commencement,4.400843956132392e-06,1.8979287041356905e-06,3,2,1
16051,commendable,2.095639979110664e-07,5.348708166200577e-06,3,0,3
16052,comment,0.00019091280209698145,0.0002400017115866128,259,102,157
16053,commentary,1.0687763893464371e-05,1.3975656821362803e-05,15,5,10
16054,commentator,1.48790438516857e-05,1.9151826014460126e-05,20,7,13
16055,commenter,2.095639979110664e-07,7.074097897233022e-06,6,0,6
16056,commerce,8.592123914353715e-06,7.074097897233022e-06,12,6,6
16057,commercial,7.565260324589493e-05,7.608968713853079e-05,88,38,50
16058,commercialization,6.496483935243052e-06,1.7253897310324457e-07,3,3,0
16059,commission,6.307876337123095e-05,5.3659620635109e-05,69,35,34
16060,commissioned,6.496483935243052e-06,1.052487735929791e-05,12,4,8
16061,commissioner,1.6974683830796368e-05,1.3975656821362803e-05,21,8,13
16062,commit,8.193952318322689e-05,6.918812821440096e-05,82,41,41
16063,commitment,6.936568330856297e-05,6.228656929027126e-05,77,35,42
16064,committed,0.00010708720293255492,7.608968713853079e-05,107,57,50
16065,committee,0.00013013924270277222,0.00013130215853156914,147,65,82
16066,committing,1.6974683830796368e-05,2.6053384938589907e-05,26,8,18
16067,commodity,1.278340387257504e-05,1.2250267090330355e-05,13,6,7
16068,common,0.00014061744259832545,0.00012094982014537423,154,75,79
16069,commonly,1.278340387257504e-05,1.3975656821362803e-05,15,6,9
16070,commonplace,2.095639979110664e-07,5.348708166200577e-06,3,0,3
16071,commonsense,8.592123914353715e-06,7.074097897233022e-06,8,4,4
16072,commonwealth,8.592123914353715e-06,1.8979287041356905e-06,7,5,2
16073,communal,6.496483935243052e-06,5.348708166200577e-06,6,3,3
16074,communicate,2.116596378901769e-05,1.9151826014460126e-05,23,11,12
16075,communicating,8.592123914353715e-06,1.2250267090330355e-05,11,4,7
16076,communication,0.00012385232276544028,8.126585633162811e-05,120,63,57
16077,communism,4.400843956132392e-06,8.79948762826546e-06,7,2,5
16078,communist,2.5357243747239038e-05,2.777877466962238e-05,29,12,17
16079,community,0.0003376076006347278,0.0004228930230760523,446,176,270
16080,commutation,2.095639979110664e-07,3.6233184351681345e-06,4,0,4
16081,commute,1.0687763893464371e-05,3.6233184351681345e-06,8,6,2
16082,commuted,2.3052039770217305e-06,1.8979287041356905e-06,3,2,1
16083,commuter,4.400843956132392e-06,5.348708166200577e-06,6,3,3
16084,compact,2.095639979110664e-07,7.074097897233022e-06,5,1,4
16085,companion,1.0687763893464371e-05,3.6233184351681345e-06,7,5,2
16086,company,0.0009222911548066023,0.0009888208548546938,1139,494,645
16087,comparable,2.095639979110664e-07,7.074097897233022e-06,4,0,4
16088,compare,1.48790438516857e-05,2.2602605476525032e-05,25,10,15
16089,compared,4.6313643538345614e-05,6.746273848336857e-05,72,25,47
16090,comparing,1.48790438516857e-05,5.348708166200577e-06,13,10,3
16091,comparison,1.9070323809907035e-05,3.122955413168725e-05,31,11,20
16092,compas,4.400843956132392e-06,5.348708166200577e-06,5,2,3
16093,compassion,1.48790438516857e-05,1.570104655239525e-05,19,9,10
16094,compassionate,6.496483935243052e-06,1.3975656821362803e-05,12,3,9
16095,compatible,6.496483935243052e-06,1.8979287041356905e-06,4,3,1
16096,compatriot,4.400843956132392e-06,3.6233184351681345e-06,5,2,3
16097,compel,1.0687763893464371e-05,1.052487735929791e-05,11,5,6
16098,compelled,8.592123914353715e-06,7.074097897233022e-06,9,4,5
16099,compelling,1.6974683830796368e-05,1.052487735929791e-05,16,9,7
16100,compensate,8.592123914353715e-06,3.6233184351681345e-06,8,4,4
16101,compensated,2.3052039770217305e-06,8.79948762826546e-06,7,1,6
16102,compensation,5.050492349656699e-05,6.573734875233614e-05,70,26,44
16103,compete,8.592123914353715e-06,1.3975656821362803e-05,13,5,8
16104,competence,2.3052039770217305e-06,3.6233184351681345e-06,4,1,3
16105,competent,2.3052039770217305e-06,5.348708166200577e-06,4,1,3
16106,competing,1.6974683830796368e-05,1.742643628342769e-05,19,8,11
16107,competition,4.4218003559234974e-05,2.2602605476525032e-05,36,21,15
16108,competitive,1.278340387257504e-05,3.122955413168725e-05,27,7,20
16109,competitor,2.954852370546031e-05,1.570104655239525e-05,24,14,10
16110,compile,2.3052039770217305e-06,3.6233184351681345e-06,3,1,2
16111,compiled,6.496483935243052e-06,1.052487735929791e-05,9,3,6
16112,complacency,1.0687763893464371e-05,1.8979287041356905e-06,6,5,1
16113,complain,2.326160376812834e-05,2.9504164400654783e-05,31,13,18
16114,complained,3.3739803663681634e-05,4.1581892517881935e-05,46,19,27
16115,complaining,1.9070323809907035e-05,1.570104655239525e-05,18,9,9
16116,complaint,9.03220830996695e-05,8.816741525575797e-05,102,48,54
16117,complement,2.3052039770217305e-06,3.6233184351681345e-06,3,1,2
16118,complete,9.03220830996695e-05,9.334358444885519e-05,109,47,62
16119,completed,2.5357243747239038e-05,1.742643628342769e-05,23,12,11
16120,completely,0.00010289592297433347,6.401195902130366e-05,98,53,45
16121,completing,6.496483935243052e-06,1.7253897310324457e-07,3,3,0
16122,completion,2.3052039770217305e-06,3.6233184351681345e-06,4,2,2
16123,complex,5.260056347567764e-05,6.228656929027126e-05,73,28,45
16124,complexity,6.496483935243052e-06,1.3975656821362803e-05,12,3,9
16125,compliance,1.0687763893464371e-05,1.570104655239525e-05,14,5,9
16126,complicate,6.496483935243052e-06,8.79948762826546e-06,8,3,5
16127,complicated,4.212236358012434e-05,4.8483451442011706e-05,56,24,32
16128,complication,6.496483935243052e-06,7.074097897233022e-06,10,5,5
16129,complicit,1.9070323809907035e-05,2.087721574549256e-05,23,10,13
16130,complicity,1.6974683830796368e-05,1.570104655239525e-05,17,8,9
16131,compliment,6.496483935243052e-06,7.074097897233022e-06,8,3,5
16132,comply,1.9070323809907035e-05,2.777877466962238e-05,27,10,17
16133,complying,4.400843956132392e-06,3.6233184351681345e-06,4,2,2
16134,component,8.592123914353715e-06,7.074097897233022e-06,11,6,5
16135,composer,2.095639979110664e-07,3.6233184351681345e-06,4,0,4
16136,composite,2.3052039770217305e-06,3.6233184351681345e-06,3,1,2
16137,composition,4.400843956132392e-06,5.348708166200577e-06,6,3,3
16138,compound,2.7452883726349685e-05,2.9504164400654783e-05,33,15,18
16139,comprehend,2.3052039770217305e-06,1.7253897310324457e-07,3,2,1
16140,comprehensive,3.1644163684570994e-05,2.4327995207557487e-05,31,16,15
16141,comprehensively,2.3052039770217305e-06,3.6233184351681345e-06,3,1,2
16142,comprise,2.095639979110664e-07,7.074097897233022e-06,4,0,4
16143,comprised,2.3052039770217305e-06,5.348708166200577e-06,4,1,3
16144,compromise,4.4218003559234974e-05,3.8131113055817005e-05,48,23,25
16145,compromised,1.48790438516857e-05,7.074097897233022e-06,13,8,5
16146,compulsive,2.095639979110664e-07,5.348708166200577e-06,3,0,3
16147,compulsory,2.5357243747239038e-05,1.9151826014460126e-05,27,14,13
16148,computer,0.00012175668278632962,0.00014510527637982858,162,68,94
16149,computing,2.3052039770217305e-06,8.79948762826546e-06,7,1,6
16150,con,1.48790438516857e-05,1.3975656821362803e-05,16,8,8
16151,conceal,4.400843956132392e-06,8.79948762826546e-06,7,2,5
16152,concealed,1.9070323809907035e-05,1.2250267090330355e-05,17,9,8
16153,concealing,2.3052039770217305e-06,1.8979287041356905e-06,3,2,1
16154,concede,1.48790438516857e-05,1.570104655239525e-05,17,8,9
16155,conceded,4.400843956132392e-06,3.6233184351681345e-06,4,2,2
16156,conceived,2.3052039770217305e-06,5.348708166200577e-06,4,1,3
16157,concentrate,1.278340387257504e-05,3.6233184351681345e-06,8,6,2
16158,concentrated,6.496483935243052e-06,5.348708166200577e-06,7,3,4
16159,concentration,3.7931083621902995e-05,2.087721574549256e-05,32,19,13
16160,concept,4.002672360101368e-05,2.777877466962238e-05,41,22,19
16161,conception,2.3052039770217305e-06,3.6233184351681345e-06,3,1,2
16162,concern,0.0001741476822640959,0.0002313747629314509,235,93,142
16163,concerned,8.822644312055891e-05,9.851975364195259e-05,114,46,68
16164,concerning,1.48790438516857e-05,2.087721574549256e-05,23,7,16
16165,concert,3.583544364279237e-05,2.777877466962238e-05,35,17,18
16166,concerted,2.095639979110664e-07,1.8979287041356905e-06,4,2,2
16167,concession,1.278340387257504e-05,2.2602605476525032e-05,22,6,16
16168,conclude,1.48790438516857e-05,2.6053384938589907e-05,30,9,21
16169,concluded,2.7452883726349685e-05,2.9504164400654783e-05,35,16,19
16170,concluding,2.3052039770217305e-06,3.6233184351681345e-06,3,1,2
16171,conclusion,2.5357243747239038e-05,4.330728224891437e-05,41,14,27
16172,concrete,2.326160376812834e-05,3.2954943862719716e-05,32,13,19
16173,condemn,0.00011966104280721883,0.00010887209202814718,135,67,68
16174,condemnation,2.5357243747239038e-05,2.4327995207557487e-05,28,13,15
16175,condemned,5.6791843433898893e-05,5.1934230904076595e-05,65,29,36
16176,condemning,2.954852370546031e-05,2.6053384938589907e-05,33,15,18
16177,condition,0.00014061744259832545,0.00017443690180738014,188,74,114
16178,conditioning,4.400843956132392e-06,1.7253897310324457e-07,3,3,0
16179,condolence,8.592123914353715e-06,7.074097897233022e-06,8,4,4
16180,condom,2.5357243747239038e-05,2.9504164400654783e-05,43,18,25
16181,condone,6.496483935243052e-06,5.348708166200577e-06,6,3,3
16182,condoning,4.400843956132392e-06,7.074097897233022e-06,7,3,4
16183,conduct,5.888748341300963e-05,6.228656929027126e-05,71,31,40
16184,conducted,3.1644163684570994e-05,4.330728224891437e-05,45,15,30
16185,conducting,1.9070323809907035e-05,2.9504164400654783e-05,28,9,19
16186,cone,4.400843956132392e-06,5.348708166200577e-06,5,2,3
16187,confab,2.3052039770217305e-06,3.6233184351681345e-06,3,1,2
16188,conference,0.0001343305226609934,0.0001364783277246665,157,74,83
16189,confes,8.592123914353715e-06,3.6233184351681345e-06,6,4,2
16190,confess,4.400843956132392e-06,3.6233184351681345e-06,4,2,2
16191,confessed,1.48790438516857e-05,8.79948762826546e-06,16,9,7
16192,confessing,4.400843956132392e-06,1.8979287041356905e-06,3,2,1
16193,confession,1.9070323809907035e-05,2.4327995207557487e-05,25,10,15
16194,confidence,2.5357243747239038e-05,3.640572332478458e-05,36,13,23
16195,confident,2.326160376812834e-05,2.9504164400654783e-05,31,11,20
16196,confidential,2.116596378901769e-05,2.087721574549256e-05,23,10,13
16197,confidentiality,2.3052039770217305e-06,3.6233184351681345e-06,3,1,2
16198,confined,6.496483935243052e-06,1.052487735929791e-05,9,3,6
16199,confinement,1.6974683830796368e-05,2.2602605476525032e-05,22,8,14
16200,confirm,0.00016157384238943198,0.00016063378395912072,186,85,101
16201,confirmation,4.002672360101368e-05,4.50326719799468e-05,57,24,33
16202,confirmed,0.00015109564249387862,0.00012267520987640663,159,81,78
16203,confirming,1.278340387257504e-05,7.074097897233022e-06,10,6,4
16204,confiscate,1.48790438516857e-05,1.052487735929791e-05,13,7,6
16205,confiscated,2.5357243747239038e-05,1.052487735929791e-05,20,13,7
16206,confiscating,4.400843956132392e-06,1.8979287041356905e-06,4,3,1
16207,confiscation,6.496483935243052e-06,1.7253897310324457e-07,3,3,0
16208,conflate,2.095639979110664e-07,3.6233184351681345e-06,3,1,2
16209,conflict,0.0002516863614911905,0.00023482554239351563,285,128,157
16210,conflicted,6.496483935243052e-06,3.6233184351681345e-06,5,3,2
16211,conflicting,2.095639979110664e-07,7.074097897233022e-06,4,0,4
16212,confront,3.3739803663681634e-05,3.640572332478458e-05,45,19,26
16213,confrontation,1.48790438516857e-05,3.2954943862719716e-05,29,10,19
16214,confronted,1.6974683830796368e-05,1.2250267090330355e-05,16,8,8
16215,confronting,2.3052039770217305e-06,1.2250267090330355e-05,8,1,7
16216,confuse,8.592123914353715e-06,1.8979287041356905e-06,5,4,1
16217,confused,2.326160376812834e-05,1.9151826014460126e-05,27,13,14
16218,confusing,1.278340387257504e-05,5.348708166200577e-06,12,8,4
16219,confusion,1.9070323809907035e-05,1.570104655239525e-05,20,11,9
16220,congestion,4.400843956132392e-06,1.8979287041356905e-06,3,2,1
16221,conglomerate,6.496483935243052e-06,7.074097897233022e-06,8,3,5
16222,congratulate,4.400843956132392e-06,5.348708166200577e-06,5,2,3
16223,congres,1.48790438516857e-05,1.2250267090330355e-05,15,8,7
16224,congressional,7.355696326678427e-05,9.506897417988779e-05,100,40,60
16225,congressman,7.984388320411623e-05,8.816741525575797e-05,94,40,54
16226,congresswoman,1.9070323809907035e-05,3.122955413168725e-05,30,11,19
16227,connect,2.5357243747239038e-05,4.330728224891437e-05,41,12,29
16228,connected,4.4218003559234974e-05,4.50326719799468e-05,53,26,27
16229,connecting,8.592123914353715e-06,8.79948762826546e-06,10,5,5
16230,connection,7.984388320411623e-05,8.4716635793693e-05,95,40,55
16231,conquer,4.400843956132392e-06,7.074097897233022e-06,7,3,4
16232,conquest,4.400843956132392e-06,5.348708166200577e-06,8,4,4
16233,conscience,1.9070323809907035e-05,1.052487735929791e-05,16,10,6
16234,conscientiou,4.400843956132392e-06,5.348708166200577e-06,5,2,3
16235,consciou,2.3052039770217305e-06,1.052487735929791e-05,7,1,6
16236,consciousnes,1.0687763893464371e-05,8.79948762826546e-06,10,5,5
16237,conscription,4.400843956132392e-06,8.79948762826546e-06,8,3,5
16238,consecutive,1.0687763893464371e-05,1.742643628342769e-05,17,6,11
16239,consensu,2.7452883726349685e-05,1.9151826014460126e-05,26,14,12
16240,consensual,4.400843956132392e-06,5.348708166200577e-06,6,2,4
16241,consent,3.3739803663681634e-05,2.9504164400654783e-05,35,17,18
16242,consented,2.095639979110664e-07,5.348708166200577e-06,3,0,3
16243,consequence,8.403516316233764e-05,8.816741525575797e-05,101,45,56
16244,conservation,1.278340387257504e-05,2.777877466962238e-05,23,6,17
16245,conservationist,1.9070323809907035e-05,1.2250267090330355e-05,17,9,8
16246,conservatism,1.6974683830796368e-05,1.3975656821362803e-05,20,10,10
16247,conservative,0.00021186920188808795,0.0002382763218555804,261,111,150
16248,consider,0.00020348664197164515,0.0001347529379936339,192,105,87
16249,considerable,8.592123914353715e-06,1.3975656821362803e-05,12,4,8
16250,considerably,4.400843956132392e-06,7.074097897233022e-06,6,2,4
16251,consideration,1.278340387257504e-05,2.2602605476525032e-05,20,7,13
16252,considered,0.00010289592297433347,0.00011059748175917965,120,51,69
16253,considering,0.00010289592297433347,0.0001295767688005365,133,52,81
16254,consist,2.3052039770217305e-06,1.3975656821362803e-05,10,1,9
16255,consistency,2.3052039770217305e-06,5.348708166200577e-06,4,1,3
16256,consistent,1.6974683830796368e-05,1.742643628342769e-05,23,11,12
16257,consistently,8.592123914353715e-06,1.3975656821362803e-05,14,5,9
16258,consolidate,1.0687763893464371e-05,1.8979287041356905e-06,7,5,2
16259,consolidating,4.400843956132392e-06,1.8979287041356905e-06,4,3,1
16260,consortium,2.3052039770217305e-06,1.052487735929791e-05,7,1,6
16261,conspicuou,6.496483935243052e-06,1.8979287041356905e-06,5,4,1
16262,conspiracy,8.822644312055891e-05,7.781507686956326e-05,100,47,53
16263,conspiratorial,2.095639979110664e-07,1.8979287041356905e-06,3,1,2
16264,conspired,6.496483935243052e-06,5.348708166200577e-06,6,3,3
16265,conspiring,1.278340387257504e-05,7.074097897233022e-06,12,6,6
16266,constant,1.278340387257504e-05,2.4327995207557487e-05,22,6,16
16267,constantly,1.6974683830796368e-05,1.2250267090330355e-05,16,9,7
16268,constellation,2.3052039770217305e-06,3.6233184351681345e-06,3,1,2
16269,constituent,1.48790438516857e-05,2.6053384938589907e-05,26,10,16
16270,constitute,1.278340387257504e-05,1.3975656821362803e-05,15,6,9
16271,constitution,4.212236358012434e-05,4.50326719799468e-05,50,24,26
16272,constitutional,9.451336305789087e-05,6.228656929027126e-05,87,48,39
16273,constitutionality,4.400843956132392e-06,3.6233184351681345e-06,4,2,2
16274,constitutionally,8.592123914353715e-06,3.6233184351681345e-06,6,4,2
16275,constraint,2.095639979110664e-07,5.348708166200577e-06,3,0,3
16276,construct,1.48790438516857e-05,7.074097897233022e-06,13,8,5
16277,constructed,4.400843956132392e-06,5.348708166200577e-06,7,4,3
16278,constructing,4.400843956132392e-06,7.074097897233022e-06,6,2,4
16279,construction,6.936568330856297e-05,0.00010542131256608228,110,39,71
16280,constructive,8.592123914353715e-06,1.8979287041356905e-06,5,4,1
16281,consul,6.496483935243052e-06,1.7253897310324457e-07,3,3,0
16282,consulate,1.6974683830796368e-05,2.6053384938589907e-05,23,8,15
16283,consult,6.496483935243052e-06,1.8979287041356905e-06,5,4,1
16284,consultant,2.116596378901769e-05,1.742643628342769e-05,20,10,10
16285,consultation,2.3052039770217305e-06,5.348708166200577e-06,4,1,3
16286,consulted,6.496483935243052e-06,3.6233184351681345e-06,5,3,2
16287,consulting,6.496483935243052e-06,5.348708166200577e-06,8,4,4
16288,consume,2.5357243747239038e-05,8.79948762826546e-06,18,13,5
16289,consumed,1.6974683830796368e-05,8.79948762826546e-06,13,8,5
16290,consumer,0.00015738256243121094,0.00016926073261428268,196,81,115
16291,consuming,1.0687763893464371e-05,5.348708166200577e-06,10,5,5
16292,consumption,5.050492349656699e-05,4.1581892517881935e-05,55,28,27
16293,contact,7.565260324589493e-05,6.573734875233614e-05,84,41,43
16294,contacted,6.496483935243052e-06,5.348708166200577e-06,8,5,3
16295,contacting,2.3052039770217305e-06,1.8979287041356905e-06,3,1,2
16296,contagion,6.496483935243052e-06,1.8979287041356905e-06,5,3,2
16297,contagiou,6.496483935243052e-06,3.6233184351681345e-06,5,3,2
16298,contain,7.774824322500554e-05,6.746273848336857e-05,85,42,43
16299,contained,3.3739803663681634e-05,2.2602605476525032e-05,31,16,15
16300,container,2.326160376812834e-05,2.4327995207557487e-05,26,11,15
16301,containing,5.888748341300963e-05,4.8483451442011706e-05,60,31,29
16302,containment,2.3052039770217305e-06,1.570104655239525e-05,11,1,10
16303,contaminate,2.3052039770217305e-06,5.348708166200577e-06,4,1,3
16304,contaminated,2.7452883726349685e-05,2.777877466962238e-05,34,16,18
16305,contaminating,1.0687763893464371e-05,7.074097897233022e-06,9,5,4
16306,contamination,1.48790438516857e-05,1.570104655239525e-05,21,10,11
16307,contemplate,4.400843956132392e-06,7.074097897233022e-06,6,2,4
16308,contemplated,4.400843956132392e-06,3.6233184351681345e-06,4,2,2
16309,contemporary,8.592123914353715e-06,1.8979287041356905e-06,5,4,1
16310,contempt,1.6974683830796368e-05,1.742643628342769e-05,20,9,11
16311,contend,1.48790438516857e-05,1.2250267090330355e-05,14,7,7
16312,contender,3.1644163684570994e-05,2.777877466962238e-05,40,20,20
16313,contending,6.496483935243052e-06,1.8979287041356905e-06,5,3,2
16314,content,0.00011756540282810809,0.00010542131256608228,126,59,67
16315,contentiou,1.278340387257504e-05,1.3975656821362803e-05,17,7,10
16316,contest,5.4696203454788295e-05,3.985650278684949e-05,53,27,26
16317,contestant,4.400843956132392e-06,7.074097897233022e-06,7,3,4
16318,contested,2.326160376812834e-05,1.9151826014460126e-05,25,12,13
16319,context,1.6974683830796368e-05,1.9151826014460126e-05,20,8,12
16320,continent,2.954852370546031e-05,3.122955413168725e-05,34,16,18
16321,contingency,2.3052039770217305e-06,1.8979287041356905e-06,3,1,2
16322,continual,4.400843956132392e-06,1.8979287041356905e-06,3,2,1
16323,continually,8.592123914353715e-06,5.348708166200577e-06,8,4,4
16324,continuation,2.095639979110664e-07,7.074097897233022e-06,5,0,5
16325,continue,0.000348085800530281,0.00044704847931050624,477,188,289
16326,continued,5.260056347567764e-05,6.056117955923882e-05,68,28,40
16327,continuing,5.050492349656699e-05,4.6758061710979285e-05,57,27,30
16328,continuity,2.095639979110664e-07,3.6233184351681345e-06,3,1,2
16329,continuou,6.496483935243052e-06,5.348708166200577e-06,6,3,3
16330,contraception,2.7452883726349685e-05,1.570104655239525e-05,26,15,11
16331,contraceptive,6.496483935243052e-06,8.79948762826546e-06,10,4,6
16332,contract,9.451336305789087e-05,9.334358444885519e-05,107,51,56
16333,contracted,1.0687763893464371e-05,1.3975656821362803e-05,14,6,8
16334,contracting,6.496483935243052e-06,8.79948762826546e-06,9,3,6
16335,contractor,5.4696203454788295e-05,5.020884117304414e-05,57,26,31
16336,contradict,2.116596378901769e-05,1.3975656821362803e-05,20,11,9
16337,contradicted,2.095639979110664e-07,5.348708166200577e-06,3,0,3
16338,contradicting,6.496483935243052e-06,7.074097897233022e-06,7,3,4
16339,contradiction,6.496483935243052e-06,7.074097897233022e-06,7,3,4
16340,contrarian,6.496483935243052e-06,1.8979287041356905e-06,4,3,1
16341,contrary,1.0687763893464371e-05,2.4327995207557487e-05,24,8,16
16342,contrast,2.954852370546031e-05,8.79948762826546e-06,25,16,9
16343,contravene,4.400843956132392e-06,1.8979287041356905e-06,3,2,1
16344,contribute,3.3739803663681634e-05,3.468033359375216e-05,42,19,23
16345,contributed,1.278340387257504e-05,8.79948762826546e-06,13,8,5
16346,contributing,1.48790438516857e-05,1.9151826014460126e-05,21,8,13
16347,contribution,4.840928351745632e-05,6.056117955923882e-05,62,24,38
16348,contributor,8.592123914353715e-06,2.087721574549256e-05,17,4,13
16349,control,0.0003837116801751621,0.0004228930230760523,482,201,281
16350,controlled,2.326160376812834e-05,2.4327995207557487e-05,27,13,14
16351,controller,6.496483935243052e-06,3.6233184351681345e-06,6,4,2
16352,controlling,1.9070323809907035e-05,3.6233184351681345e-06,13,9,4
16353,controversial,0.00020139100199253443,0.0002020431375038992,241,102,139
16354,controversy,7.355696326678427e-05,6.401195902130366e-05,80,38,42
16355,conundrum,4.400843956132392e-06,5.348708166200577e-06,5,2,3
16356,convene,6.496483935243052e-06,3.6233184351681345e-06,6,4,2
16357,convened,2.3052039770217305e-06,8.79948762826546e-06,7,1,6
16358,convenience,6.496483935243052e-06,8.79948762826546e-06,9,3,6
16359,convenient,4.400843956132392e-06,1.2250267090330355e-05,9,2,7
16360,conveniently,4.400843956132392e-06,1.7253897310324457e-07,4,2,2
16361,convention,6.098312339212028e-05,8.816741525575797e-05,96,33,63
16362,conventional,2.326160376812834e-05,2.777877466962238e-05,28,12,16
16363,converge,6.496483935243052e-06,1.7253897310324457e-07,4,3,1
16364,conversation,0.00010499156295344414,8.989280498679035e-05,111,54,57
16365,conversion,6.496483935243052e-06,5.348708166200577e-06,7,4,3
16366,convert,2.954852370546031e-05,2.4327995207557487e-05,31,15,16
16367,converted,4.400843956132392e-06,1.3975656821362803e-05,10,2,8
16368,converting,4.400843956132392e-06,7.074097897233022e-06,6,2,4
16369,convey,4.400843956132392e-06,5.348708166200577e-06,5,2,3
16370,conveyed,6.496483935243052e-06,1.8979287041356905e-06,4,3,1
16371,convict,1.9070323809907035e-05,2.9504164400654783e-05,27,10,17
16372,convicted,0.0001762433222432067,0.00011577365095227703,177,96,81
16373,convicting,2.3052039770217305e-06,3.6233184351681345e-06,3,1,2
16374,conviction,5.6791843433898893e-05,6.056117955923882e-05,68,28,40
16375,convince,1.9070323809907035e-05,2.2602605476525032e-05,25,9,16
16376,convinced,3.1644163684570994e-05,3.8131113055817005e-05,40,16,24
16377,convincing,1.278340387257504e-05,2.087721574549256e-05,19,6,13
16378,convoluted,6.496483935243052e-06,7.074097897233022e-06,7,3,4
16379,convoy,4.212236358012434e-05,3.8131113055817005e-05,44,22,22
16380,cook,1.9070323809907035e-05,7.074097897233022e-06,16,9,7
16381,cooked,4.400843956132392e-06,3.6233184351681345e-06,4,2,2
16382,cooker,2.095639979110664e-07,3.6233184351681345e-06,3,1,2
16383,cooking,1.6974683830796368e-05,5.348708166200577e-06,12,9,3
16384,cookout,4.400843956132392e-06,1.8979287041356905e-06,3,2,1
16385,cooky,4.400843956132392e-06,7.074097897233022e-06,8,3,5
16386,cool,3.1644163684570994e-05,2.6053384938589907e-05,32,15,17
16387,cooler,4.400843956132392e-06,5.348708166200577e-06,5,2,3
16388,cooling,8.592123914353715e-06,1.742643628342769e-05,14,4,10
16389,cooperate,2.954852370546031e-05,2.087721574549256e-05,28,14,14
16390,cooperated,2.3052039770217305e-06,3.6233184351681345e-06,5,2,3
16391,cooperating,8.592123914353715e-06,7.074097897233022e-06,9,5,4
16392,cooperation,6.098312339212028e-05,4.1581892517881935e-05,60,33,27
16393,cooperative,4.400843956132392e-06,1.8979287041356905e-06,4,2,2
16394,coordinate,2.3052039770217305e-06,8.79948762826546e-06,6,1,5
16395,coordinated,1.9070323809907035e-05,1.570104655239525e-05,19,9,10
16396,coordinating,6.496483935243052e-06,5.348708166200577e-06,7,3,4
16397,coordination,6.496483935243052e-06,3.6233184351681345e-06,5,3,2
16398,coordinator,6.496483935243052e-06,5.348708166200577e-06,6,3,3
16399,cop,9.660900303700153e-05,8.816741525575797e-05,112,50,62
16400,copay,4.400843956132392e-06,1.8979287041356905e-06,3,2,1
16401,cope,1.6974683830796368e-05,1.2250267090330355e-05,18,8,10
16402,copied,8.592123914353715e-06,7.074097897233022e-06,8,4,4
16403,copilot,4.400843956132392e-06,5.348708166200577e-06,5,2,3
16404,coping,2.3052039770217305e-06,3.6233184351681345e-06,4,1,3
16405,copper,2.3052039770217305e-06,1.9151826014460126e-05,15,2,13
16406,copy,4.212236358012434e-05,4.6758061710979285e-05,55,22,33
16407,copycat,8.592123914353715e-06,5.348708166200577e-06,8,5,3
16408,copying,4.400843956132392e-06,1.8979287041356905e-06,3,2,1
16409,copyright,8.822644312055891e-05,6.228656929027126e-05,89,46,43
16410,copyrighted,8.592123914353715e-06,7.074097897233022e-06,10,4,6
16411,coral,3.583544364279237e-05,2.2602605476525032e-05,35,19,16
16412,cord,6.496483935243052e-06,1.8979287041356905e-06,8,5,3
16413,core,4.840928351745632e-05,6.746273848336857e-05,70,27,43
16414,corn,1.48790438516857e-05,1.9151826014460126e-05,21,8,13
16415,corner,3.583544364279237e-05,2.4327995207557487e-05,33,18,15
16416,cornerstone,4.400843956132392e-06,5.348708166200577e-06,5,2,3
16417,coronaviru,5.6791843433898893e-05,5.1934230904076595e-05,59,28,31
16418,corp,4.400843956132392e-06,3.6233184351681345e-06,4,2,2
16419,corporate,0.00013223488268188294,0.0001347529379936339,154,72,82
16420,corporation,7.565260324589493e-05,9.334358444885519e-05,99,39,60
16421,corps,1.9070323809907035e-05,1.2250267090330355e-05,18,10,8
16422,corpse,1.9070323809907035e-05,8.79948762826546e-06,14,9,5
16423,correct,1.6974683830796368e-05,3.122955413168725e-05,31,9,22
16424,corrected,6.496483935243052e-06,3.6233184351681345e-06,6,3,3
16425,correcting,2.095639979110664e-07,5.348708166200577e-06,3,0,3
16426,correction,1.0687763893464371e-05,1.2250267090330355e-05,14,5,9
16427,correctional,2.3052039770217305e-06,1.052487735929791e-05,8,1,7
16428,corrective,2.095639979110664e-07,5.348708166200577e-06,3,0,3
16429,correctly,1.278340387257504e-05,1.052487735929791e-05,12,6,6
16430,correctnes,4.400843956132392e-06,7.074097897233022e-06,7,3,4
16431,correspond,2.3052039770217305e-06,5.348708166200577e-06,4,1,3
16432,correspondence,8.592123914353715e-06,7.074097897233022e-06,8,4,4
16433,correspondent,2.5357243747239038e-05,1.742643628342769e-05,23,12,11
16434,corresponding,2.3052039770217305e-06,3.6233184351681345e-06,3,1,2
16435,corridor,1.0687763893464371e-05,1.8979287041356905e-06,7,5,2
16436,corrosive,2.3052039770217305e-06,5.348708166200577e-06,4,1,3
16437,corrupt,6.098312339212028e-05,6.746273848336857e-05,73,31,42
16438,corrupted,2.3052039770217305e-06,7.074097897233022e-06,5,1,4
16439,corrupting,4.400843956132392e-06,8.79948762826546e-06,7,2,5
16440,corruption,0.0002244430417627521,0.00017788768126944505,233,111,122
16441,cosmetic,1.0687763893464371e-05,8.79948762826546e-06,10,5,5
16442,cosmic,8.592123914353715e-06,3.6233184351681345e-06,6,4,2
16443,cosponsored,2.3052039770217305e-06,5.348708166200577e-06,4,1,3
16444,cost,0.00032503376076006407,0.00036768055168301384,408,174,234
16445,costeffective,2.3052039770217305e-06,3.6233184351681345e-06,3,1,2
16446,costing,1.9070323809907035e-05,1.570104655239525e-05,19,10,9
16447,costliest,2.3052039770217305e-06,1.8979287041356905e-06,3,1,2
16448,costly,1.48790438516857e-05,1.742643628342769e-05,19,8,11
16449,costume,6.496483935243052e-06,1.570104655239525e-05,13,3,10
16450,cosy,2.3052039770217305e-06,3.6233184351681345e-06,3,1,2
16451,cotton,1.48790438516857e-05,7.074097897233022e-06,12,7,5
16452,couch,8.592123914353715e-06,1.8979287041356905e-06,5,4,1
16453,cough,4.400843956132392e-06,3.6233184351681345e-06,6,4,2
16454,could,0.0015572700684771327,0.0015978834299091474,1855,830,1025
16455,couldn,1.0687763893464371e-05,1.2250267090330355e-05,13,5,8
16456,couldve,2.3052039770217305e-06,5.348708166200577e-06,4,1,3
16457,council,6.517440335034157e-05,6.573734875233614e-05,76,37,39
16458,councillor,1.278340387257504e-05,8.79948762826546e-06,12,7,5
16459,counsel,6.098312339212028e-05,5.711040009717395e-05,72,35,37
16460,counseling,1.0687763893464371e-05,3.6233184351681345e-06,7,5,2
16461,counselor,4.400843956132392e-06,1.9151826014460126e-05,15,4,11
16462,count,5.888748341300963e-05,9.334358444885519e-05,95,35,60
16463,countdown,6.496483935243052e-06,5.348708166200577e-06,6,3,3
16464,counted,1.0687763893464371e-05,1.742643628342769e-05,16,5,11
16465,counter,3.7931083621902995e-05,3.2954943862719716e-05,42,19,23
16466,counterattack,4.400843956132392e-06,5.348708166200577e-06,5,2,3
16467,counterfeit,4.400843956132392e-06,1.570104655239525e-05,12,3,9
16468,countering,2.095639979110664e-07,8.79948762826546e-06,6,0,6
16469,counterintuitive,2.3052039770217305e-06,5.348708166200577e-06,4,1,3
16470,counterpart,3.3739803663681634e-05,2.4327995207557487e-05,32,17,15
16471,counterproductive,8.592123914353715e-06,7.074097897233022e-06,9,4,5
16472,counterrevolution,2.095639979110664e-07,5.348708166200577e-06,3,0,3
16473,counterterror,2.3052039770217305e-06,5.348708166200577e-06,4,1,3
16474,counterterrorism,1.278340387257504e-05,1.742643628342769e-05,18,7,11
16475,counterweight,4.400843956132392e-06,3.6233184351681345e-06,4,2,2
16476,counting,2.5357243747239038e-05,1.3975656821362803e-05,21,13,8
16477,countles,8.592123914353715e-06,1.3975656821362803e-05,17,6,11
16478,country,0.002097945183087684,0.0019222566993432456,2342,1102,1240
16479,countryman,6.496483935243052e-06,1.7253897310324457e-07,7,4,3
16480,countryside,2.095639979110664e-07,5.348708166200577e-06,5,1,4
16481,county,5.6791843433898893e-05,4.330728224891437e-05,56,28,28
16482,coup,7.774824322500554e-05,7.436429740749831e-05,93,44,49
16483,couple,0.00018462588215964923,0.00014337988664879628,195,103,92
16484,coupled,6.496483935243052e-06,1.7253897310324457e-07,3,3,0
16485,coupon,8.592123914353715e-06,7.074097897233022e-06,12,6,6
16486,courage,3.583544364279237e-05,4.1581892517881935e-05,44,19,25
16487,courageou,4.400843956132392e-06,1.052487735929791e-05,13,3,10
16488,course,0.00013642616264010403,0.0001485560558418934,172,75,97
16489,court,0.0008803783552243891,0.0008680435736824232,1027,453,574
16490,courted,2.3052039770217305e-06,5.348708166200577e-06,5,2,3
16491,courtesy,1.278340387257504e-05,5.348708166200577e-06,9,6,3
16492,courthouse,1.278340387257504e-05,1.8979287041356905e-06,7,6,1
16493,courting,2.3052039770217305e-06,3.6233184351681345e-06,4,2,2
16494,courtmartial,2.095639979110664e-07,5.348708166200577e-06,4,1,3
16495,courtroom,2.3052039770217305e-06,1.3975656821362803e-05,12,2,10
16496,cousin,1.9070323809907035e-05,2.087721574549256e-05,23,9,14
16497,cover,0.00013223488268188294,0.0001278513790695043,149,68,81
16498,coverage,0.00010918284291166549,0.00011577365095227703,130,58,72
16499,covered,5.888748341300963e-05,5.5385010366141504e-05,62,29,33
16500,covering,4.6313643538345614e-05,4.6758061710979285e-05,53,24,29
16501,covert,2.326160376812834e-05,1.742643628342769e-05,23,11,12
16502,covertly,6.496483935243052e-06,5.348708166200577e-06,6,3,3
16503,coverup,4.212236358012434e-05,3.2954943862719716e-05,41,21,20
16504,coveted,2.3052039770217305e-06,1.052487735929791e-05,8,1,7
16505,covfefe,4.400843956132392e-06,1.8979287041356905e-06,3,2,1
16506,cow,2.326160376812834e-05,2.087721574549256e-05,27,13,14
16507,coward,2.095639979110664e-07,1.3975656821362803e-05,10,2,8
16508,cowardice,8.592123914353715e-06,3.6233184351681345e-06,6,4,2
16509,cowardly,4.400843956132392e-06,1.8979287041356905e-06,4,2,2
16510,cowboy,4.400843956132392e-06,1.8979287041356905e-06,3,2,1
16511,cowed,4.400843956132392e-06,1.8979287041356905e-06,3,2,1
16512,coworker,1.6974683830796368e-05,1.3975656821362803e-05,16,8,8
16513,cozy,4.400843956132392e-06,5.348708166200577e-06,5,2,3
16514,crab,2.3052039770217305e-06,3.6233184351681345e-06,3,1,2
16515,crack,7.355696326678427e-05,7.263890767646595e-05,87,41,46
16516,crackdown,0.00012175668278632962,0.00011577365095227703,145,65,80
16517,cracked,1.0687763893464371e-05,1.2250267090330355e-05,12,5,7
16518,cracking,1.6974683830796368e-05,1.3975656821362803e-05,18,10,8
16519,craft,1.0687763893464371e-05,1.3975656821362803e-05,13,5,8
16520,crafted,2.3052039770217305e-06,7.074097897233022e-06,5,1,4
16521,crafting,2.095639979110664e-07,5.348708166200577e-06,4,0,4
16522,cranberry,2.095639979110664e-07,5.348708166200577e-06,3,0,3
16523,crane,4.400843956132392e-06,7.074097897233022e-06,7,3,4
16524,crap,1.48790438516857e-05,1.3975656821362803e-05,16,7,9
16525,crappy,2.3052039770217305e-06,1.2250267090330355e-05,10,3,7
16526,crash,0.00020767792192986646,0.00016235917369015308,222,109,113
16527,crashed,2.5357243747239038e-05,3.985650278684949e-05,36,13,23
16528,crashing,8.592123914353715e-06,8.79948762826546e-06,10,5,5
16529,crater,8.592123914353715e-06,1.8979287041356905e-06,5,4,1
16530,crave,2.3052039770217305e-06,3.6233184351681345e-06,3,1,2
16531,craving,2.095639979110664e-07,5.348708166200577e-06,3,0,3
16532,crawl,2.3052039770217305e-06,7.074097897233022e-06,5,1,4
16533,crawling,4.400843956132392e-06,3.6233184351681345e-06,4,2,2
16534,craze,4.400843956132392e-06,3.6233184351681345e-06,6,3,3
16535,crazy,5.888748341300963e-05,3.8131113055817005e-05,51,29,22
16536,cream,1.0687763893464371e-05,1.2250267090330355e-05,14,6,8
16537,create,0.00016786076232676425,0.00021239547589009395,225,91,134
16538,created,9.451336305789087e-05,0.0001520068353039585,143,49,94
16539,creating,9.660900303700153e-05,9.851975364195259e-05,118,55,63
16540,creation,2.326160376812834e-05,3.468033359375216e-05,40,15,25
16541,creationism,2.3052039770217305e-06,5.348708166200577e-06,5,1,4
16542,creationist,6.496483935243052e-06,5.348708166200577e-06,6,3,3
16543,creative,4.002672360101368e-05,3.640572332478458e-05,40,19,21
16544,creativity,6.496483935243052e-06,1.742643628342769e-05,14,3,11
16545,creator,1.9070323809907035e-05,2.2602605476525032e-05,25,9,16
16546,creature,2.954852370546031e-05,2.777877466962238e-05,35,14,21
16547,credence,2.3052039770217305e-06,1.8979287041356905e-06,3,1,2
16548,credential,2.3052039770217305e-06,1.570104655239525e-05,10,1,9
16549,credibility,2.326160376812834e-05,3.468033359375216e-05,34,13,21
16550,credible,1.6974683830796368e-05,2.6053384938589907e-05,30,12,18
16551,credit,0.0003019817209898466,0.0002607063883590024,326,161,165
16552,credited,1.0687763893464371e-05,1.2250267090330355e-05,12,5,7
16553,creditor,8.592123914353715e-06,8.79948762826546e-06,10,5,5
16554,creed,2.3052039770217305e-06,1.8979287041356905e-06,3,1,2
16555,creep,1.48790438516857e-05,8.79948762826546e-06,13,7,6
16556,creepy,2.3052039770217305e-06,1.8979287041356905e-06,3,2,1
16557,crematorium,4.400843956132392e-06,3.6233184351681345e-06,4,2,2
16558,crew,7.146132328767358e-05,8.989280498679035e-05,90,34,56
16559,cricket,2.095639979110664e-07,1.2250267090330355e-05,7,0,7
16560,cried,8.592123914353715e-06,1.742643628342769e-05,15,5,10
16561,crime,0.0005199282788173553,0.000510887899358707,615,273,342
16562,criminal,0.0003019817209898466,0.00025553021916590484,318,159,159
16563,criminalise,6.496483935243052e-06,1.052487735929791e-05,10,3,7
16564,criminalising,2.3052039770217305e-06,3.6233184351681345e-06,4,1,3
16565,criminality,2.095639979110664e-07,7.074097897233022e-06,5,0,5
16566,criminalization,4.400843956132392e-06,5.348708166200577e-06,5,2,3
16567,criminalize,8.592123914353715e-06,1.052487735929791e-05,13,4,9
16568,criminalized,6.496483935243052e-06,1.7253897310324457e-07,3,3,0
16569,criminalizing,1.0687763893464371e-05,8.79948762826546e-06,10,5,5
16570,criminally,4.400843956132392e-06,7.074097897233022e-06,7,2,5
16571,cripple,6.496483935243052e-06,5.348708166200577e-06,8,5,3
16572,crippled,1.48790438516857e-05,1.570104655239525e-05,21,9,12
16573,crippling,8.592123914353715e-06,5.348708166200577e-06,8,5,3
16574,crisi,0.0004968762390471381,0.0005350433555931611,595,262,333
16575,crisp,8.592123914353715e-06,1.8979287041356905e-06,6,5,1
16576,criterion,2.3052039770217305e-06,8.79948762826546e-06,7,1,6
16577,critic,0.0001259479627445509,0.00011232287149021227,148,73,75
16578,critical,7.984388320411623e-05,0.00012612598933847184,130,47,83
16579,critically,2.116596378901769e-05,1.742643628342769e-05,22,10,12
16580,criticise,1.48790438516857e-05,2.777877466962238e-05,27,8,19
16581,criticised,2.5357243747239038e-05,2.6053384938589907e-05,30,13,17
16582,criticising,4.400843956132392e-06,1.3975656821362803e-05,11,2,9
16583,criticism,0.0001343305226609934,0.00011577365095227703,142,72,70
16584,criticize,5.260056347567764e-05,4.50326719799468e-05,55,28,27
16585,criticized,7.565260324589493e-05,7.091351794543343e-05,86,40,46
16586,criticizing,2.326160376812834e-05,3.640572332478458e-05,38,13,25
16587,critique,1.278340387257504e-05,8.79948762826546e-06,12,7,5
16588,crocodile,1.0687763893464371e-05,1.9151826014460126e-05,16,5,11
16589,crony,1.0687763893464371e-05,3.6233184351681345e-06,9,6,3
16590,crook,6.496483935243052e-06,3.6233184351681345e-06,6,3,3
16591,crooked,8.592123914353715e-06,1.8979287041356905e-06,6,4,2
16592,crop,7.146132328767358e-05,8.126585633162811e-05,87,38,49
16593,cros,3.583544364279237e-05,5.1934230904076595e-05,53,18,35
16594,crossborder,6.496483935243052e-06,5.348708166200577e-06,8,3,5
16595,crossbow,8.592123914353715e-06,1.7253897310324457e-07,5,4,1
16596,crossed,2.5357243747239038e-05,2.6053384938589907e-05,31,13,18
16597,crosshair,2.095639979110664e-07,5.348708166200577e-06,3,0,3
16598,crossing,4.4218003559234974e-05,6.573734875233614e-05,63,23,40
16599,crossparty,2.3052039770217305e-06,3.6233184351681345e-06,3,1,2
16600,crosspost,4.400843956132392e-06,1.8979287041356905e-06,3,2,1
16601,crossroad,2.095639979110664e-07,3.6233184351681345e-06,3,0,3
16602,crowd,0.00013223488268188294,8.989280498679035e-05,128,67,61
16603,crowded,1.278340387257504e-05,2.2602605476525032e-05,20,6,14
16604,crowdfunding,8.592123914353715e-06,7.074097897233022e-06,12,4,8
16605,crown,8.592123914353715e-06,1.570104655239525e-05,16,5,11
16606,crucial,3.583544364279237e-05,5.1934230904076595e-05,52,21,31
16607,crucible,2.3052039770217305e-06,1.8979287041356905e-06,4,3,1
16608,crucified,6.496483935243052e-06,1.7253897310324457e-07,3,3,0
16609,crucifixion,4.400843956132392e-06,5.348708166200577e-06,5,2,3
16610,crucify,2.095639979110664e-07,7.074097897233022e-06,5,1,4
16611,crude,3.3739803663681634e-05,2.777877466962238e-05,43,19,24
16612,cruel,2.326160376812834e-05,2.2602605476525032e-05,30,11,19
16613,cruelty,1.278340387257504e-05,2.4327995207557487e-05,24,10,14
16614,cruise,3.583544364279237e-05,3.2954943862719716e-05,38,17,21
16615,cruiser,2.3052039770217305e-06,7.074097897233022e-06,5,1,4
16616,cruising,4.400843956132392e-06,3.6233184351681345e-06,4,2,2
16617,crumble,6.496483935243052e-06,7.074097897233022e-06,9,4,5
16618,crumbling,1.6974683830796368e-05,1.052487735929791e-05,17,10,7
16619,crunch,4.400843956132392e-06,7.074097897233022e-06,8,3,5
16620,crusade,8.592123914353715e-06,7.074097897233022e-06,12,5,7
16621,crusader,6.496483935243052e-06,3.6233184351681345e-06,6,4,2
16622,crush,2.116596378901769e-05,1.570104655239525e-05,22,13,9
16623,crushed,4.400843956132392e-06,1.2250267090330355e-05,11,3,8
16624,crushing,1.0687763893464371e-05,7.074097897233022e-06,10,5,5
16625,crust,6.496483935243052e-06,1.8979287041356905e-06,4,3,1
16626,cry,5.6791843433898893e-05,5.020884117304414e-05,66,32,34
16627,crystal,1.278340387257504e-05,1.052487735929791e-05,12,6,6
16628,csuite,2.095639979110664e-07,5.348708166200577e-06,3,0,3
16629,cub,1.278340387257504e-05,1.3975656821362803e-05,15,6,9
16630,cubic,6.496483935243052e-06,1.3975656821362803e-05,11,3,8
16631,cubicle,4.400843956132392e-06,3.6233184351681345e-06,4,2,2
16632,cucumber,4.400843956132392e-06,3.6233184351681345e-06,4,2,2
16633,cue,6.496483935243052e-06,1.7253897310324457e-07,4,4,0
16634,cuff,2.3052039770217305e-06,3.6233184351681345e-06,3,1,2
16635,cull,6.496483935243052e-06,3.6233184351681345e-06,5,3,2
16636,culminate,2.095639979110664e-07,5.348708166200577e-06,3,0,3
16637,culmination,2.095639979110664e-07,5.348708166200577e-06,3,0,3
16638,culpable,2.3052039770217305e-06,8.79948762826546e-06,7,2,5
16639,culprit,1.48790438516857e-05,1.570104655239525e-05,16,7,9
16640,cult,2.5357243747239038e-05,2.087721574549256e-05,24,12,12
16641,cultivating,2.3052039770217305e-06,3.6233184351681345e-06,4,1,3
16642,cultivation,1.6974683830796368e-05,1.052487735929791e-05,14,8,6
16643,cultural,4.002672360101368e-05,4.50326719799468e-05,50,22,28
16644,culturally,8.592123914353715e-06,5.348708166200577e-06,8,4,4
16645,culture,0.00012804360272366158,0.0001520068353039585,165,66,99
16646,cup,1.278340387257504e-05,1.2250267090330355e-05,15,6,9
16647,cupcake,6.496483935243052e-06,1.7253897310324457e-07,4,4,0
16648,curb,6.307876337123095e-05,4.1581892517881935e-05,63,32,31
16649,curbed,4.400843956132392e-06,1.7253897310324457e-07,4,3,1
16650,curbing,2.095639979110664e-07,8.79948762826546e-06,6,1,5
16651,cure,3.583544364279237e-05,4.330728224891437e-05,47,18,29
16652,cured,6.496483935243052e-06,5.348708166200577e-06,9,4,5
16653,curfew,2.7452883726349685e-05,8.79948762826546e-06,18,13,5
16654,curiosity,4.400843956132392e-06,3.6233184351681345e-06,4,2,2
16655,curiou,8.592123914353715e-06,8.79948762826546e-06,9,4,5
16656,currency,0.00012175668278632962,0.00010887209202814718,133,62,71
16657,current,0.0001825302421805385,0.00016580995315221804,206,96,110
16658,currently,0.00010080028299522283,0.00010714670229711469,123,55,68
16659,curriculum,1.48790438516857e-05,8.79948762826546e-06,13,7,6
16660,curse,4.400843956132392e-06,1.2250267090330355e-05,9,2,7
16661,cursed,6.496483935243052e-06,5.348708166200577e-06,6,3,3
16662,cursing,6.496483935243052e-06,1.8979287041356905e-06,4,3,1
16663,curtail,4.400843956132392e-06,8.79948762826546e-06,8,2,6
16664,curtailing,2.3052039770217305e-06,1.8979287041356905e-06,3,2,1
16665,curtain,6.496483935243052e-06,1.052487735929791e-05,11,5,6
16666,curve,6.496483935243052e-06,1.052487735929791e-05,9,3,6
16667,cushion,6.496483935243052e-06,3.6233184351681345e-06,5,3,2
16668,cusp,4.400843956132392e-06,3.6233184351681345e-06,5,3,2
16669,custodian,2.3052039770217305e-06,3.6233184351681345e-06,3,1,2
16670,custody,6.517440335034157e-05,7.608968713853079e-05,82,34,48
16671,custom,2.5357243747239038e-05,1.742643628342769e-05,23,13,10
16672,customary,2.095639979110664e-07,5.348708166200577e-06,3,0,3
16673,customer,0.00019929536201342395,0.0001968669683108019,226,102,124
16674,cut,0.0005220239187964661,0.0005057117301656093,586,264,322
16675,cutback,4.400843956132392e-06,3.6233184351681345e-06,4,2,2
16676,cute,6.496483935243052e-06,2.2602605476525032e-05,17,3,14
16677,cutest,4.400843956132392e-06,1.8979287041356905e-06,3,2,1
16678,cutoff,2.3052039770217305e-06,5.348708166200577e-06,4,1,3
16679,cutthroat,2.095639979110664e-07,3.6233184351681345e-06,3,1,2
16680,cutting,6.098312339212028e-05,7.091351794543343e-05,74,30,44
16681,cyanide,1.278340387257504e-05,5.348708166200577e-06,12,8,4
16682,cyber,4.840928351745632e-05,4.50326719799468e-05,52,25,27
16683,cyberattack,1.0687763893464371e-05,3.122955413168725e-05,23,5,18
16684,cybercrime,4.400843956132392e-06,7.074097897233022e-06,7,2,5
16685,cyberespionage,2.3052039770217305e-06,3.6233184351681345e-06,4,2,2
16686,cybersecurity,8.592123914353715e-06,1.2250267090330355e-05,15,5,10
16687,cyberspace,6.496483935243052e-06,1.7253897310324457e-07,4,3,1
16688,cyberspying,4.400843956132392e-06,1.7253897310324457e-07,4,4,0
16689,cyberstalking,2.095639979110664e-07,3.6233184351681345e-06,3,0,3
16690,cyberwar,2.3052039770217305e-06,3.6233184351681345e-06,3,1,2
16691,cyberwarfare,8.592123914353715e-06,1.8979287041356905e-06,6,5,1
16692,cycle,3.7931083621902995e-05,4.50326719799468e-05,48,19,29
16693,cyclist,1.48790438516857e-05,7.074097897233022e-06,13,8,5
16694,cyclone,6.496483935243052e-06,7.074097897233022e-06,7,3,4
16695,cynical,2.3052039770217305e-06,1.570104655239525e-05,10,1,9
16696,cynicism,4.400843956132392e-06,1.8979287041356905e-06,3,2,1
16697,cyst,2.3052039770217305e-06,3.6233184351681345e-06,3,1,2
16698,czar,2.3052039770217305e-06,7.074097897233022e-06,5,1,4
16699,dIvoire,2.3052039770217305e-06,3.6233184351681345e-06,4,1,3
16700,da,6.496483935243052e-06,8.79948762826546e-06,8,3,5
16701,dad,4.212236358012434e-05,4.6758061710979285e-05,49,20,29
16702,daddy,2.3052039770217305e-06,8.79948762826546e-06,6,1,5
16703,dai,2.3052039770217305e-06,5.348708166200577e-06,4,1,3
16704,daily,9.24177230787802e-05,8.299124606266055e-05,101,48,53
16705,dairy,1.278340387257504e-05,7.074097897233022e-06,12,7,5
16706,dam,5.050492349656699e-05,3.8131113055817005e-05,51,25,26
16707,damage,0.00015947820241032126,0.0001382037174556987,183,90,93
16708,damaged,4.4218003559234974e-05,4.6758061710979285e-05,53,24,29
16709,damaging,2.5357243747239038e-05,4.1581892517881935e-05,40,15,25
16710,damn,1.278340387257504e-05,1.570104655239525e-05,17,7,10
16711,damned,2.095639979110664e-07,5.348708166200577e-06,6,1,5
16712,damning,1.0687763893464371e-05,1.9151826014460126e-05,18,6,12
16713,dance,2.326160376812834e-05,1.570104655239525e-05,22,11,11
16714,dancer,2.3052039770217305e-06,1.8979287041356905e-06,3,1,2
16715,dancing,2.116596378901769e-05,1.3975656821362803e-05,22,11,11
16716,danger,0.00010289592297433347,7.091351794543343e-05,104,58,46
16717,dangerou,0.00015947820241032126,0.0001571830044970555,188,84,104
16718,dangerously,1.0687763893464371e-05,1.052487735929791e-05,11,5,6
16719,dangling,2.095639979110664e-07,3.6233184351681345e-06,3,0,3
16720,dare,8.592123914353715e-06,1.742643628342769e-05,17,4,13
16721,dared,6.496483935243052e-06,7.074097897233022e-06,7,3,4
16722,daring,8.592123914353715e-06,1.052487735929791e-05,11,5,6
16723,dark,7.774824322500554e-05,8.4716635793693e-05,96,43,53
16724,darker,6.496483935243052e-06,1.8979287041356905e-06,5,3,2
16725,darkest,4.400843956132392e-06,7.074097897233022e-06,7,3,4
16726,darknes,1.0687763893464371e-05,1.570104655239525e-05,16,6,10
16727,darkskinned,4.400843956132392e-06,1.8979287041356905e-06,3,2,1
16728,darling,2.3052039770217305e-06,1.052487735929791e-05,7,1,6
16729,darn,4.400843956132392e-06,7.074097897233022e-06,6,2,4
16730,dart,2.095639979110664e-07,5.348708166200577e-06,3,0,3
16731,dashed,2.095639979110664e-07,5.348708166200577e-06,3,0,3
16732,database,3.7931083621902995e-05,4.50326719799468e-05,51,20,31
16733,date,7.355696326678427e-05,7.091351794543343e-05,86,38,48
16734,dated,1.0687763893464371e-05,1.8979287041356905e-06,6,5,1
16735,dating,2.7452883726349685e-05,3.2954943862719716e-05,34,14,20
16736,datum,0.000459154719423146,0.00035732821329681935,474,236,238
16737,daughter,0.00020767792192986646,0.00022102242454525643,246,104,142
16738,daunting,4.400843956132392e-06,1.570104655239525e-05,13,3,10
16739,dawn,1.6974683830796368e-05,1.052487735929791e-05,17,9,8
16740,dawning,2.095639979110664e-07,3.6233184351681345e-06,3,1,2
16741,day,0.001444105509605157,0.0014857330973920386,1717,760,957
16742,daycare,2.3052039770217305e-06,3.6233184351681345e-06,4,2,2
16743,daylight,1.278340387257504e-05,1.2250267090330355e-05,15,6,9
16744,daytime,4.400843956132392e-06,1.8979287041356905e-06,3,2,1
16745,daytoday,4.400843956132392e-06,8.79948762826546e-06,8,3,5
16746,de,8.613080314144832e-05,5.711040009717395e-05,81,46,35
16747,deGrasse,4.400843956132392e-06,1.2250267090330355e-05,9,2,7
16748,dead,0.0006184233578355568,0.0005799034886000049,709,323,386
16749,deadlier,4.400843956132392e-06,1.8979287041356905e-06,3,2,1
16750,deadliest,1.48790438516857e-05,3.122955413168725e-05,28,9,19
16751,deadline,5.260056347567764e-05,3.640572332478458e-05,52,27,25
16752,deadlock,1.0687763893464371e-05,1.7253897310324457e-07,5,5,0
16753,deadly,0.00014061744259832545,0.0001589083942280881,172,74,98
16754,deadpan,2.3052039770217305e-06,1.8979287041356905e-06,3,2,1
16755,deaf,4.400843956132392e-06,1.2250267090330355e-05,10,2,8
16756,deafening,2.3052039770217305e-06,5.348708166200577e-06,5,2,3
16757,deal,0.0005387890386293515,0.00056955115021381,656,283,373
16758,dealer,3.1644163684570994e-05,1.3975656821362803e-05,28,18,10
16759,dealing,5.888748341300963e-05,6.056117955923882e-05,70,30,40
16760,dealmaker,4.400843956132392e-06,1.8979287041356905e-06,3,2,1
16761,dealt,1.0687763893464371e-05,1.570104655239525e-05,17,5,12
16762,dear,8.592123914353715e-06,8.79948762826546e-06,10,4,6
16763,death,0.0010647946733861279,0.0010078001418960508,1224,569,655
16764,debacle,6.496483935243052e-06,1.2250267090330355e-05,12,4,8
16765,debate,0.000348085800530281,0.000302115741903781,381,185,196
16766,debated,4.400843956132392e-06,7.074097897233022e-06,8,2,6
16767,debating,1.278340387257504e-05,8.79948762826546e-06,12,6,6
16768,debilitating,4.400843956132392e-06,5.348708166200577e-06,5,2,3
16769,debit,1.278340387257504e-05,5.348708166200577e-06,10,6,4
16770,debris,1.278340387257504e-05,2.2602605476525032e-05,19,6,13
16771,debt,0.00023701688163741595,0.00032109502894513814,334,129,205
16772,debtor,6.496483935243052e-06,1.8979287041356905e-06,4,3,1
16773,debunk,2.3052039770217305e-06,5.348708166200577e-06,5,2,3
16774,debunked,4.400843956132392e-06,8.79948762826546e-06,7,2,5
16775,debut,6.496483935243052e-06,1.2250267090330355e-05,12,4,8
16776,decade,0.0003019817209898466,0.00032109502894513814,367,159,208
16777,decadelong,4.400843956132392e-06,1.7253897310324457e-07,3,3,0
16778,decadeslong,8.592123914353715e-06,1.2250267090330355e-05,13,6,7
16779,decadesold,2.3052039770217305e-06,1.3975656821362803e-05,10,1,9
16780,decapitate,6.496483935243052e-06,3.6233184351681345e-06,5,3,2
16781,decapitated,1.6974683830796368e-05,1.9151826014460126e-05,20,9,11
16782,decay,6.496483935243052e-06,3.6233184351681345e-06,6,3,3
16783,deceased,2.3052039770217305e-06,8.79948762826546e-06,6,1,5
16784,deceitful,6.496483935243052e-06,1.8979287041356905e-06,4,3,1
16785,deceive,4.400843956132392e-06,3.6233184351681345e-06,4,2,2
16786,deceived,8.592123914353715e-06,5.348708166200577e-06,7,4,3
16787,deceiving,6.496483935243052e-06,1.8979287041356905e-06,4,3,1
16788,decency,8.592123914353715e-06,8.79948762826546e-06,10,5,5
16789,decent,8.592123914353715e-06,2.2602605476525032e-05,17,4,13
16790,deception,2.3052039770217305e-06,3.6233184351681345e-06,4,1,3
16791,decide,0.00010708720293255492,0.00010024514337298497,124,56,68
16792,decided,0.00013013924270277222,0.0001295767688005365,153,68,85
16793,decidedly,2.3052039770217305e-06,3.6233184351681345e-06,3,1,2
16794,deciding,1.0687763893464371e-05,1.2250267090330355e-05,13,6,7
16795,decimate,4.400843956132392e-06,1.8979287041356905e-06,3,2,1
16796,decimated,2.3052039770217305e-06,3.6233184351681345e-06,3,1,2
16797,decision,0.0003397032406138383,0.00038838522845540324,440,188,252
16798,decisionmaking,8.592123914353715e-06,1.3975656821362803e-05,12,4,8
16799,decisive,6.496483935243052e-06,1.570104655239525e-05,14,4,10
16800,decisively,2.095639979110664e-07,7.074097897233022e-06,5,1,4
16801,deck,1.0687763893464371e-05,5.348708166200577e-06,9,5,4
16802,declaration,2.326160376812834e-05,2.6053384938589907e-05,30,12,18
16803,declare,0.0001531912824729893,0.00017443690180738014,196,85,111
16804,declared,0.00013013924270277222,0.0001382037174556987,154,67,87
16805,declaring,2.326160376812834e-05,1.742643628342769e-05,27,13,14
16806,declassified,1.6974683830796368e-05,1.2250267090330355e-05,17,10,7
16807,declassify,2.095639979110664e-07,3.6233184351681345e-06,3,1,2
16808,decline,9.24177230787802e-05,7.954046660059569e-05,96,47,49
16809,declined,3.583544364279237e-05,2.777877466962238e-05,38,19,19
16810,declining,1.9070323809907035e-05,2.6053384938589907e-05,29,10,19
16811,decoration,6.496483935243052e-06,1.7253897310324457e-07,4,3,1
16812,decorum,4.400843956132392e-06,3.6233184351681345e-06,4,2,2
16813,decrease,1.6974683830796368e-05,1.3975656821362803e-05,17,8,9
16814,decreased,2.3052039770217305e-06,1.8979287041356905e-06,3,2,1
16815,decree,1.48790438516857e-05,2.9504164400654783e-05,25,8,17
16816,decreed,2.3052039770217305e-06,3.6233184351681345e-06,3,1,2
16817,decried,2.3052039770217305e-06,1.052487735929791e-05,7,1,6
16818,decriminalisation,6.496483935243052e-06,3.6233184351681345e-06,5,3,2
16819,decriminalise,6.496483935243052e-06,1.2250267090330355e-05,10,3,7
16820,decriminalised,4.400843956132392e-06,1.8979287041356905e-06,3,2,1
16821,decriminalising,4.400843956132392e-06,5.348708166200577e-06,5,2,3
16822,decriminalization,6.496483935243052e-06,2.6053384938589907e-05,23,4,19
16823,decriminalize,1.278340387257504e-05,2.087721574549256e-05,19,6,13
16824,decriminalized,4.400843956132392e-06,3.6233184351681345e-06,5,3,2
16825,decriminalizing,8.592123914353715e-06,7.074097897233022e-06,11,5,6
16826,decry,6.496483935243052e-06,1.570104655239525e-05,12,3,9
16827,decrying,2.3052039770217305e-06,5.348708166200577e-06,6,2,4
16828,decrypt,4.400843956132392e-06,7.074097897233022e-06,6,2,4
16829,dedicate,1.0687763893464371e-05,3.6233184351681345e-06,7,5,2
16830,dedicated,4.002672360101368e-05,3.640572332478458e-05,44,19,25
16831,dedication,1.0687763893464371e-05,7.074097897233022e-06,9,5,4
16832,deducted,6.496483935243052e-06,1.8979287041356905e-06,4,3,1
16833,deductible,4.400843956132392e-06,7.074097897233022e-06,8,2,6
16834,deduction,1.0687763893464371e-05,8.79948762826546e-06,11,5,6
16835,deed,2.095639979110664e-07,8.79948762826546e-06,6,0,6
16836,deem,6.496483935243052e-06,1.3975656821362803e-05,13,4,9
16837,deemed,3.583544364279237e-05,2.9504164400654783e-05,41,22,19
16838,deep,0.00011127848289077625,8.816741525575797e-05,118,60,58
16839,deepen,2.954852370546031e-05,1.570104655239525e-05,25,15,10
16840,deepening,2.3052039770217305e-06,1.052487735929791e-05,9,1,8
16841,deeper,3.583544364279237e-05,4.50326719799468e-05,50,22,28
16842,deepest,8.592123914353715e-06,8.79948762826546e-06,10,4,6
16843,deeply,6.936568330856297e-05,7.954046660059569e-05,84,35,49
16844,deepred,2.095639979110664e-07,3.6233184351681345e-06,3,1,2
16845,deepsea,6.496483935243052e-06,3.6233184351681345e-06,6,4,2
16846,deepseated,4.400843956132392e-06,1.8979287041356905e-06,3,2,1
16847,deface,2.3052039770217305e-06,3.6233184351681345e-06,3,1,2
16848,defaced,8.592123914353715e-06,7.074097897233022e-06,9,5,4
16849,defacto,6.496483935243052e-06,3.6233184351681345e-06,5,3,2
16850,defamation,1.48790438516857e-05,5.348708166200577e-06,10,7,3
16851,defaming,8.592123914353715e-06,1.8979287041356905e-06,5,4,1
16852,default,3.583544364279237e-05,3.8131113055817005e-05,46,22,24
16853,defaulted,4.400843956132392e-06,3.6233184351681345e-06,4,2,2
16854,defeat,5.888748341300963e-05,7.954046660059569e-05,81,32,49
16855,defeated,2.5357243747239038e-05,2.4327995207557487e-05,31,16,15
16856,defeating,6.496483935243052e-06,1.3975656821362803e-05,14,5,9
16857,defect,4.6313643538345614e-05,2.9504164400654783e-05,44,24,20
16858,defected,1.48790438516857e-05,1.3975656821362803e-05,18,8,10
16859,defecting,8.592123914353715e-06,1.052487735929791e-05,11,4,7
16860,defection,6.496483935243052e-06,1.8979287041356905e-06,7,3,4
16861,defective,4.400843956132392e-06,3.6233184351681345e-06,4,2,2
16862,defector,2.7452883726349685e-05,3.2954943862719716e-05,34,13,21
16863,defence,7.984388320411623e-05,4.330728224891437e-05,68,39,29
16864,defend,0.0001385218026192147,0.00011922443041434203,147,72,75
16865,defendant,2.5357243747239038e-05,2.087721574549256e-05,26,13,13
16866,defended,4.212236358012434e-05,3.8131113055817005e-05,48,22,26
16867,defender,2.116596378901769e-05,1.9151826014460126e-05,26,12,14
16868,defending,2.116596378901769e-05,3.985650278684949e-05,37,11,26
16869,defense,0.0001741476822640959,0.0001589083942280881,192,88,104
16870,defenseles,6.496483935243052e-06,1.8979287041356905e-06,4,3,1
16871,defensive,1.0687763893464371e-05,1.3975656821362803e-05,16,7,9
16872,defer,2.3052039770217305e-06,5.348708166200577e-06,4,1,3
16873,deference,8.592123914353715e-06,5.348708166200577e-06,8,5,3
16874,deferred,2.3052039770217305e-06,7.074097897233022e-06,6,1,5
16875,defiance,1.9070323809907035e-05,7.074097897233022e-06,19,11,8
16876,defiant,1.0687763893464371e-05,1.3975656821362803e-05,15,6,9
16877,deficiency,2.3052039770217305e-06,1.7253897310324457e-07,3,2,1
16878,deficit,5.888748341300963e-05,5.3659620635109e-05,70,37,33
16879,defied,2.116596378901769e-05,1.3975656821362803e-05,21,10,11
16880,define,2.116596378901769e-05,2.6053384938589907e-05,29,13,16
16881,defined,1.6974683830796368e-05,1.9151826014460126e-05,25,11,14
16882,defining,1.278340387257504e-05,7.074097897233022e-06,12,6,6
16883,definite,2.3052039770217305e-06,3.6233184351681345e-06,3,1,2
16884,definitely,1.48790438516857e-05,1.570104655239525e-05,21,8,13
16885,definition,1.278340387257504e-05,2.2602605476525032e-05,21,6,15
16886,definitive,6.496483935243052e-06,7.074097897233022e-06,7,3,4
16887,deflation,2.3052039770217305e-06,1.8979287041356905e-06,4,3,1
16888,deforestation,3.1644163684570994e-05,2.6053384938589907e-05,30,15,15
16889,deforested,4.400843956132392e-06,1.7253897310324457e-07,3,2,1
16890,deformity,6.496483935243052e-06,3.6233184351681345e-06,5,3,2
16891,defrauded,6.496483935243052e-06,1.052487735929791e-05,9,3,6
16892,defrauding,4.400843956132392e-06,1.8979287041356905e-06,5,2,3
16893,defund,6.496483935243052e-06,1.8979287041356905e-06,4,3,1
16894,defunding,2.3052039770217305e-06,5.348708166200577e-06,6,2,4
16895,defuse,6.496483935243052e-06,3.6233184351681345e-06,5,3,2
16896,defused,2.095639979110664e-07,5.348708166200577e-06,3,0,3
16897,defy,4.002672360101368e-05,4.8483451442011706e-05,53,23,30
16898,defying,1.278340387257504e-05,1.742643628342769e-05,17,7,10
16899,degradation,8.592123914353715e-06,5.348708166200577e-06,8,4,4
16900,degraded,8.592123914353715e-06,3.6233184351681345e-06,7,4,3
16901,degrading,6.496483935243052e-06,7.074097897233022e-06,8,3,5
16902,degree,6.517440335034157e-05,7.436429740749831e-05,82,33,49
16903,dehumanizing,2.3052039770217305e-06,3.6233184351681345e-06,3,1,2
16904,dehydration,4.400843956132392e-06,1.8979287041356905e-06,3,2,1
16905,del,6.496483935243052e-06,1.7253897310324457e-07,3,3,0
16906,delay,4.4218003559234974e-05,5.5385010366141504e-05,55,23,32
16907,delayed,2.5357243747239038e-05,2.6053384938589907e-05,31,15,16
16908,delaying,4.400843956132392e-06,7.074097897233022e-06,8,3,5
16909,delegate,5.050492349656699e-05,4.8483451442011706e-05,62,25,37
16910,delegation,2.326160376812834e-05,2.087721574549256e-05,25,12,13
16911,delegitimize,2.3052039770217305e-06,3.6233184351681345e-06,3,1,2
16912,delete,1.9070323809907035e-05,1.742643628342769e-05,19,9,10
16913,deleted,2.326160376812834e-05,1.9151826014460126e-05,23,11,12
16914,deleting,1.0687763893464371e-05,8.79948762826546e-06,11,5,6
16915,deletion,6.496483935243052e-06,3.6233184351681345e-06,5,3,2
16916,deliberate,1.278340387257504e-05,1.742643628342769e-05,17,6,11
16917,deliberately,4.002672360101368e-05,2.9504164400654783e-05,41,20,21
16918,deliberation,2.3052039770217305e-06,5.348708166200577e-06,5,1,4
16919,delicacy,8.592123914353715e-06,1.8979287041356905e-06,5,4,1
16920,delicate,1.0687763893464371e-05,3.6233184351681345e-06,8,6,2
16921,delight,4.400843956132392e-06,7.074097897233022e-06,9,3,6
16922,delighted,4.400843956132392e-06,3.6233184351681345e-06,4,2,2
16923,deliver,7.984388320411623e-05,7.954046660059569e-05,94,43,51
16924,delivered,4.212236358012434e-05,6.401195902130366e-05,62,21,41
16925,delivering,1.9070323809907035e-05,2.4327995207557487e-05,23,9,14
16926,delivery,3.7931083621902995e-05,5.020884117304414e-05,53,19,34
16927,delta,4.400843956132392e-06,1.8979287041356905e-06,3,2,1
16928,delusion,2.3052039770217305e-06,1.8979287041356905e-06,4,2,2
16929,delusional,2.3052039770217305e-06,3.6233184351681345e-06,3,1,2
16930,demagogue,4.400843956132392e-06,1.7253897310324457e-07,3,2,1
16931,demagoguery,2.3052039770217305e-06,5.348708166200577e-06,4,1,3
16932,demand,0.00036904220032138744,0.00026243177809003493,372,195,177
16933,demanded,4.4218003559234974e-05,4.50326719799468e-05,50,21,29
16934,demanding,9.451336305789087e-05,7.954046660059569e-05,100,50,50
16935,demean,2.3052039770217305e-06,3.6233184351681345e-06,3,1,2
16936,demeaning,6.496483935243052e-06,1.8979287041356905e-06,5,3,2
16937,dementia,4.400843956132392e-06,5.348708166200577e-06,7,2,5
16938,demise,1.0687763893464371e-05,7.074097897233022e-06,11,7,4
16939,demo,8.592123914353715e-06,1.7253897310324457e-07,4,4,0
16940,democracy,0.00018043460220142793,0.00022619859373835345,239,96,143
16941,democratic,7.146132328767358e-05,5.1934230904076595e-05,73,37,36
16942,democratically,4.400843956132392e-06,3.6233184351681345e-06,4,2,2
16943,demographic,2.326160376812834e-05,1.3975656821362803e-05,22,12,10
16944,demolish,2.326160376812834e-05,2.4327995207557487e-05,29,12,17
16945,demolished,4.400843956132392e-06,1.2250267090330355e-05,9,2,7
16946,demolishing,1.278340387257504e-05,5.348708166200577e-06,9,6,3
16947,demolition,1.6974683830796368e-05,1.3975656821362803e-05,18,8,10
16948,demon,2.3052039770217305e-06,5.348708166200577e-06,5,1,4
16949,demonizing,4.400843956132392e-06,1.8979287041356905e-06,3,2,1
16950,demonstrate,5.050492349656699e-05,4.1581892517881935e-05,52,25,27
16951,demonstrated,1.6974683830796368e-05,1.3975656821362803e-05,19,8,11
16952,demonstrating,1.6974683830796368e-05,8.79948762826546e-06,14,8,6
16953,demonstration,9.870464301611217e-05,9.851975364195259e-05,114,51,63
16954,demonstrator,6.72700433294523e-05,5.711040009717395e-05,71,33,38
16955,dengue,2.3052039770217305e-06,5.348708166200577e-06,4,1,3
16956,denial,4.002672360101368e-05,5.3659620635109e-05,54,19,35
16957,denied,0.00011337412286988677,9.506897417988779e-05,123,61,62
16958,denier,2.7452883726349685e-05,2.087721574549256e-05,26,13,13
16959,denounce,1.6974683830796368e-05,3.2954943862719716e-05,34,9,25
16960,denounced,2.326160376812834e-05,2.2602605476525032e-05,28,12,16
16961,denouncing,1.48790438516857e-05,5.348708166200577e-06,13,9,4
16962,dense,2.3052039770217305e-06,5.348708166200577e-06,4,1,3
16963,densely,1.278340387257504e-05,1.7253897310324457e-07,7,6,1
16964,dental,6.496483935243052e-06,1.8979287041356905e-06,4,3,1
16965,dentist,4.400843956132392e-06,7.074097897233022e-06,9,4,5
16966,denunciation,2.3052039770217305e-06,1.8979287041356905e-06,3,2,1
16967,deny,0.00014271308257743603,0.00017271151207634748,181,73,108
16968,denying,3.7931083621902995e-05,2.777877466962238e-05,36,18,18
16969,depart,2.3052039770217305e-06,3.6233184351681345e-06,3,1,2
16970,departed,4.400843956132392e-06,1.8979287041356905e-06,3,2,1
16971,departing,6.496483935243052e-06,3.6233184351681345e-06,6,3,3
16972,department,6.307876337123095e-05,7.263890767646595e-05,87,39,48
16973,departure,1.9070323809907035e-05,1.570104655239525e-05,20,10,10
16974,depend,2.954852370546031e-05,4.330728224891437e-05,40,15,25
16975,dependence,1.0687763893464371e-05,1.2250267090330355e-05,14,7,7
16976,dependency,2.3052039770217305e-06,7.074097897233022e-06,5,1,4
16977,dependent,1.0687763893464371e-05,3.6233184351681345e-06,9,6,3
16978,depending,2.095639979110664e-07,1.052487735929791e-05,7,0,7
16979,depict,8.592123914353715e-06,3.6233184351681345e-06,7,4,3
16980,depicted,1.0687763893464371e-05,3.6233184351681345e-06,8,5,3
16981,depicting,1.0687763893464371e-05,1.2250267090330355e-05,15,5,10
16982,depiction,4.400843956132392e-06,3.6233184351681345e-06,6,2,4
16983,depleted,2.3052039770217305e-06,7.074097897233022e-06,6,2,4
16984,depletion,4.400843956132392e-06,1.8979287041356905e-06,4,2,2
16985,deplorable,8.592123914353715e-06,3.6233184351681345e-06,7,5,2
16986,deplore,2.3052039770217305e-06,3.6233184351681345e-06,3,1,2
16987,deploy,4.4218003559234974e-05,4.330728224891437e-05,56,24,32
16988,deployed,4.4218003559234974e-05,3.985650278684949e-05,51,24,27
16989,deploying,1.48790438516857e-05,1.2250267090330355e-05,17,8,9
16990,deployment,2.954852370546031e-05,1.3975656821362803e-05,24,14,10
16991,deport,2.116596378901769e-05,3.8131113055817005e-05,33,10,23
16992,deportation,5.6791843433898893e-05,4.50326719799468e-05,59,28,31
16993,deported,2.326160376812834e-05,3.122955413168725e-05,37,15,22
16994,deportee,2.095639979110664e-07,5.348708166200577e-06,3,0,3
16995,deporting,8.592123914353715e-06,1.2250267090330355e-05,12,5,7
16996,deposed,6.496483935243052e-06,1.8979287041356905e-06,4,3,1
16997,deposit,2.5357243747239038e-05,1.9151826014460126e-05,28,14,14
16998,deposited,6.496483935243052e-06,1.8979287041356905e-06,4,3,1
16999,deposition,6.496483935243052e-06,1.8979287041356905e-06,4,3,1
17000,depositor,2.3052039770217305e-06,5.348708166200577e-06,5,1,4
17001,depot,1.0687763893464371e-05,3.6233184351681345e-06,9,6,3
17002,depravity,2.095639979110664e-07,5.348708166200577e-06,3,0,3
17003,depressed,2.3052039770217305e-06,8.79948762826546e-06,6,1,5
17004,depressing,8.592123914353715e-06,1.052487735929791e-05,11,4,7
17005,depression,2.326160376812834e-05,2.087721574549256e-05,25,11,14
17006,deprivation,1.48790438516857e-05,8.79948762826546e-06,12,7,5
17007,deprive,2.3052039770217305e-06,5.348708166200577e-06,6,2,4
17008,deprived,8.592123914353715e-06,8.79948762826546e-06,9,4,5
17009,depriving,8.592123914353715e-06,5.348708166200577e-06,9,5,4
17010,dept,4.400843956132392e-06,1.8979287041356905e-06,3,2,1
17011,depth,2.5357243747239038e-05,1.742643628342769e-05,23,13,10
17012,deputy,5.4696203454788295e-05,6.228656929027126e-05,68,28,40
17013,der,4.400843956132392e-06,3.6233184351681345e-06,6,2,4
17014,derail,2.116596378901769e-05,1.3975656821362803e-05,21,10,11
17015,derailed,4.400843956132392e-06,7.074097897233022e-06,7,3,4
17016,deregulate,2.095639979110664e-07,3.6233184351681345e-06,3,0,3
17017,deregulation,2.3052039770217305e-06,8.79948762826546e-06,6,1,5
17018,derivative,1.0687763893464371e-05,1.052487735929791e-05,11,5,6
17019,derived,4.400843956132392e-06,1.8979287041356905e-06,3,2,1
17020,derogatory,8.592123914353715e-06,1.052487735929791e-05,10,4,6
17021,desalination,1.278340387257504e-05,3.6233184351681345e-06,8,6,2
17022,descend,8.592123914353715e-06,1.570104655239525e-05,15,4,11
17023,descendant,6.496483935243052e-06,8.79948762826546e-06,10,4,6
17024,descended,1.48790438516857e-05,8.79948762826546e-06,12,7,5
17025,descending,1.0687763893464371e-05,5.348708166200577e-06,9,6,3
17026,descent,1.6974683830796368e-05,8.79948762826546e-06,14,9,5
17027,describe,6.098312339212028e-05,5.5385010366141504e-05,73,34,39
17028,described,0.00010708720293255492,7.781507686956326e-05,105,58,47
17029,describing,1.278340387257504e-05,2.4327995207557487e-05,22,6,16
17030,description,2.3052039770217305e-06,8.79948762826546e-06,7,1,6
17031,desecrating,2.095639979110664e-07,3.6233184351681345e-06,3,0,3
17032,desecration,2.095639979110664e-07,8.79948762826546e-06,5,0,5
17033,desert,4.002672360101368e-05,2.4327995207557487e-05,40,23,17
17034,deserted,4.400843956132392e-06,1.8979287041356905e-06,4,2,2
17035,deserter,8.592123914353715e-06,5.348708166200577e-06,7,4,3
17036,desertification,6.496483935243052e-06,1.8979287041356905e-06,4,3,1
17037,desertion,8.592123914353715e-06,1.7253897310324457e-07,5,4,1
17038,deserve,7.355696326678427e-05,7.954046660059569e-05,92,41,51
17039,deserved,4.400843956132392e-06,7.074097897233022e-06,7,3,4
17040,deserving,4.400843956132392e-06,7.074097897233022e-06,6,2,4
17041,design,4.4218003559234974e-05,4.6758061710979285e-05,56,23,33
17042,designate,1.0687763893464371e-05,7.074097897233022e-06,11,6,5
17043,designated,1.0687763893464371e-05,5.348708166200577e-06,11,8,3
17044,designation,8.592123914353715e-06,5.348708166200577e-06,8,4,4
17045,designed,4.840928351745632e-05,6.401195902130366e-05,66,25,41
17046,designer,1.0687763893464371e-05,1.2250267090330355e-05,14,7,7
17047,designing,2.095639979110664e-07,1.8979287041356905e-06,3,2,1
17048,desirable,4.400843956132392e-06,1.8979287041356905e-06,3,2,1
17049,desire,1.6974683830796368e-05,1.9151826014460126e-05,23,9,14
17050,desired,4.400843956132392e-06,3.6233184351681345e-06,6,3,3
17051,desk,1.6974683830796368e-05,2.087721574549256e-05,22,9,13
17052,despair,1.278340387257504e-05,1.2250267090330355e-05,14,7,7
17053,desperate,4.840928351745632e-05,3.985650278684949e-05,53,26,27
17054,desperately,1.48790438516857e-05,2.2602605476525032e-05,21,7,14
17055,desperation,1.0687763893464371e-05,3.6233184351681345e-06,9,6,3
17056,despicable,6.496483935243052e-06,8.79948762826546e-06,8,3,5
17057,despised,2.3052039770217305e-06,5.348708166200577e-06,4,1,3
17058,despite,0.0002747384012614078,0.0002727841164762295,326,148,178
17059,despot,6.496483935243052e-06,3.6233184351681345e-06,5,3,2
17060,destabilise,2.095639979110664e-07,7.074097897233022e-06,4,0,4
17061,destabilize,8.592123914353715e-06,1.052487735929791e-05,10,4,6
17062,destabilizing,4.400843956132392e-06,7.074097897233022e-06,6,2,4
17063,destination,2.954852370546031e-05,2.6053384938589907e-05,29,14,15
17064,destined,6.496483935243052e-06,1.742643628342769e-05,13,3,10
17065,destroy,0.00010708720293255492,0.0001589083942280881,155,59,96
17066,destroyed,0.0001259479627445509,0.0001019705331040174,131,68,63
17067,destroyer,8.592123914353715e-06,1.052487735929791e-05,10,4,6
17068,destroying,5.260056347567764e-05,3.468033359375216e-05,54,30,24
17069,destruction,7.355696326678427e-05,6.228656929027126e-05,80,40,40
17070,destructive,2.326160376812834e-05,2.087721574549256e-05,28,13,15
17071,detail,0.00012804360272366158,0.00012267520987640663,155,67,88
17072,detailed,1.278340387257504e-05,2.087721574549256e-05,20,7,13
17073,detailing,1.6974683830796368e-05,1.9151826014460126e-05,21,9,12
17074,detain,4.4218003559234974e-05,3.8131113055817005e-05,43,21,22
17075,detained,0.00014061744259832545,9.161819471782287e-05,137,72,65
17076,detainee,6.936568330856297e-05,4.1581892517881935e-05,63,36,27
17077,detaining,1.0687763893464371e-05,7.074097897233022e-06,10,5,5
17078,detat,4.400843956132392e-06,1.8979287041356905e-06,5,3,2
17079,detect,2.954852370546031e-05,2.6053384938589907e-05,34,18,16
17080,detected,4.4218003559234974e-05,4.1581892517881935e-05,46,22,24
17081,detecting,6.496483935243052e-06,3.6233184351681345e-06,5,3,2
17082,detection,2.3052039770217305e-06,8.79948762826546e-06,7,1,6
17083,detective,8.592123914353715e-06,1.2250267090330355e-05,12,5,7
17084,detector,2.326160376812834e-05,1.3975656821362803e-05,19,11,8
17085,detention,0.0001154697628489974,0.00011922443041434203,139,60,79
17086,deter,1.0687763893464371e-05,2.9504164400654783e-05,26,6,20
17087,detergent,2.3052039770217305e-06,5.348708166200577e-06,4,1,3
17088,deteriorate,2.3052039770217305e-06,1.8979287041356905e-06,3,1,2
17089,deteriorated,2.3052039770217305e-06,3.6233184351681345e-06,3,1,2
17090,deteriorating,1.0687763893464371e-05,1.8979287041356905e-06,7,5,2
17091,deterioration,6.496483935243052e-06,8.79948762826546e-06,8,3,5
17092,determination,1.0687763893464371e-05,8.79948762826546e-06,10,5,5
17093,determine,5.050492349656699e-05,5.5385010366141504e-05,60,25,35
17094,determined,3.3739803663681634e-05,3.468033359375216e-05,43,20,23
17095,determining,6.496483935243052e-06,1.3975656821362803e-05,11,3,8
17096,deterrence,2.095639979110664e-07,5.348708166200577e-06,3,0,3
17097,deterrent,6.496483935243052e-06,5.348708166200577e-06,6,3,3
17098,detonate,6.496483935243052e-06,3.6233184351681345e-06,6,4,2
17099,detonated,8.592123914353715e-06,3.6233184351681345e-06,6,4,2
17100,detonating,2.3052039770217305e-06,3.6233184351681345e-06,3,1,2
17101,detox,2.3052039770217305e-06,3.6233184351681345e-06,3,1,2
17102,detractor,4.400843956132392e-06,3.6233184351681345e-06,4,2,2
17103,detrimental,4.400843956132392e-06,1.8979287041356905e-06,3,2,1
17104,devaluation,4.400843956132392e-06,1.8979287041356905e-06,3,2,1
17105,devalue,2.3052039770217305e-06,5.348708166200577e-06,4,1,3
17106,devalued,2.3052039770217305e-06,1.8979287041356905e-06,4,1,3
17107,devastate,1.0687763893464371e-05,7.074097897233022e-06,9,5,4
17108,devastated,1.9070323809907035e-05,1.9151826014460126e-05,21,10,11
17109,devastating,6.72700433294523e-05,6.228656929027126e-05,72,34,38
17110,devastation,4.400843956132392e-06,1.742643628342769e-05,14,3,11
17111,develop,6.936568330856297e-05,6.918812821440096e-05,82,38,44
17112,developed,7.355696326678427e-05,8.299124606266055e-05,89,37,52
17113,developer,1.48790438516857e-05,1.570104655239525e-05,19,8,11
17114,developing,8.613080314144832e-05,8.989280498679035e-05,104,45,59
17115,development,0.00011966104280721883,0.0001589083942280881,161,61,100
17116,deviant,2.3052039770217305e-06,3.6233184351681345e-06,3,1,2
17117,device,0.00010289592297433347,8.816741525575797e-05,109,54,55
17118,devil,1.278340387257504e-05,1.052487735929791e-05,14,6,8
17119,devised,4.400843956132392e-06,1.8979287041356905e-06,3,2,1
17120,devising,4.400843956132392e-06,1.8979287041356905e-06,3,2,1
17121,devolved,4.400843956132392e-06,3.6233184351681345e-06,4,2,2
17122,devote,4.400843956132392e-06,3.6233184351681345e-06,5,3,2
17123,devoted,2.116596378901769e-05,2.087721574549256e-05,22,10,12
17124,devout,2.095639979110664e-07,5.348708166200577e-06,3,0,3
17125,diabetes,4.400843956132392e-06,2.4327995207557487e-05,16,2,14
17126,diagnose,4.400843956132392e-06,1.8979287041356905e-06,3,2,1
17127,diagnosed,2.326160376812834e-05,1.742643628342769e-05,24,12,12
17128,diagnosi,6.496483935243052e-06,1.742643628342769e-05,14,4,10
17129,dial,8.592123914353715e-06,1.7253897310324457e-07,5,5,0
17130,dialect,4.400843956132392e-06,7.074097897233022e-06,6,2,4
17131,dialogue,1.9070323809907035e-05,2.777877466962238e-05,26,10,16
17132,diamond,2.954852370546031e-05,4.50326719799468e-05,44,17,27
17133,diaper,4.400843956132392e-06,7.074097897233022e-06,6,2,4
17134,diarrhea,2.095639979110664e-07,3.6233184351681345e-06,3,1,2
17135,diary,2.3052039770217305e-06,7.074097897233022e-06,7,2,5
17136,diaspora,2.3052039770217305e-06,3.6233184351681345e-06,3,1,2
17137,dictate,1.278340387257504e-05,8.79948762826546e-06,12,6,6
17138,dictated,4.400843956132392e-06,7.074097897233022e-06,6,2,4
17139,dictator,6.098312339212028e-05,6.918812821440096e-05,73,31,42
17140,dictatorial,4.400843956132392e-06,3.6233184351681345e-06,4,2,2
17141,dictatorship,2.116596378901769e-05,2.777877466962238e-05,30,11,19
17142,dictionary,2.095639979110664e-07,5.348708166200577e-06,4,0,4
17143,didn,7.146132328767358e-05,4.50326719799468e-05,67,38,29
17144,die,0.00019300844207609195,0.00016926073261428268,214,101,113
17145,died,0.0002621645613867441,0.0002934887932486187,340,147,193
17146,diehard,2.3052039770217305e-06,5.348708166200577e-06,5,2,3
17147,dieoff,8.592123914353715e-06,8.79948762826546e-06,9,4,5
17148,diesel,1.278340387257504e-05,1.2250267090330355e-05,15,6,9
17149,diet,1.48790438516857e-05,1.052487735929791e-05,14,7,7
17150,dietary,2.3052039770217305e-06,8.79948762826546e-06,6,1,5
17151,differ,4.400843956132392e-06,5.348708166200577e-06,6,2,4
17152,difference,8.822644312055891e-05,0.00013302754826260141,132,50,82
17153,different,0.00019929536201342395,0.00025898099862796983,275,108,167
17154,differentiate,2.3052039770217305e-06,1.052487735929791e-05,7,1,6
17155,differentiator,4.400843956132392e-06,3.6233184351681345e-06,4,2,2
17156,differently,1.9070323809907035e-05,1.3975656821362803e-05,21,12,9
17157,difficult,9.451336305789087e-05,0.00012094982014537423,129,49,80
17158,difficulty,1.0687763893464371e-05,8.79948762826546e-06,13,6,7
17159,dig,1.9070323809907035e-05,3.122955413168725e-05,29,10,19
17160,digging,1.0687763893464371e-05,1.570104655239525e-05,15,5,10
17161,digit,2.3052039770217305e-06,1.8979287041356905e-06,4,2,2
17162,digital,6.307876337123095e-05,6.746273848336857e-05,73,33,40
17163,digitally,6.496483935243052e-06,5.348708166200577e-06,6,3,3
17164,dignified,2.3052039770217305e-06,5.348708166200577e-06,4,1,3
17165,dignitary,2.3052039770217305e-06,3.6233184351681345e-06,3,1,2
17166,dignity,2.7452883726349685e-05,1.9151826014460126e-05,26,13,13
17167,dilemma,1.278340387257504e-05,8.79948762826546e-06,12,7,5
17168,diligent,2.3052039770217305e-06,5.348708166200577e-06,5,1,4
17169,dim,4.400843956132392e-06,5.348708166200577e-06,5,2,3
17170,dime,2.3052039770217305e-06,7.074097897233022e-06,5,1,4
17171,diminish,8.592123914353715e-06,3.6233184351681345e-06,7,4,3
17172,diminished,4.400843956132392e-06,3.6233184351681345e-06,5,2,3
17173,diminishing,4.400843956132392e-06,8.79948762826546e-06,7,2,5
17174,diner,8.592123914353715e-06,1.8979287041356905e-06,6,5,1
17175,dingo,4.400843956132392e-06,3.6233184351681345e-06,4,2,2
17176,dining,1.0687763893464371e-05,7.074097897233022e-06,9,5,4
17177,dinner,2.954852370546031e-05,2.777877466962238e-05,34,15,19
17178,dinosaur,1.48790438516857e-05,3.2954943862719716e-05,27,7,20
17179,diocese,6.496483935243052e-06,5.348708166200577e-06,6,3,3
17180,dioxide,2.116596378901769e-05,1.742643628342769e-05,22,10,12
17181,dioxin,2.3052039770217305e-06,7.074097897233022e-06,6,2,4
17182,dip,1.6974683830796368e-05,1.052487735929791e-05,14,8,6
17183,diploma,2.3052039770217305e-06,8.79948762826546e-06,6,1,5
17184,diplomacy,1.48790438516857e-05,2.6053384938589907e-05,26,9,17
17185,diplomat,0.0001343305226609934,0.00011059748175917965,139,69,70
17186,diplomatic,0.00010708720293255492,8.989280498679035e-05,115,55,60
17187,dipped,6.496483935243052e-06,1.8979287041356905e-06,4,3,1
17188,dire,1.9070323809907035e-05,2.087721574549256e-05,22,9,13
17189,direct,8.193952318322689e-05,7.608968713853079e-05,90,43,47
17190,directed,3.1644163684570994e-05,1.570104655239525e-05,25,16,9
17191,direction,4.002672360101368e-05,3.468033359375216e-05,48,23,25
17192,directive,6.496483935243052e-06,1.052487735929791e-05,12,4,8
17193,directly,8.613080314144832e-05,7.781507686956326e-05,95,44,51
17194,director,0.00016366948236854273,0.00016580995315221804,183,82,101
17195,dirt,8.592123914353715e-06,1.2250267090330355e-05,12,5,7
17196,dirtiest,2.3052039770217305e-06,3.6233184351681345e-06,3,1,2
17197,dirty,3.3739803663681634e-05,3.2954943862719716e-05,42,18,24
17198,disability,5.050492349656699e-05,2.777877466962238e-05,51,26,25
17199,disable,2.095639979110664e-07,3.6233184351681345e-06,3,0,3
17200,disabled,2.7452883726349685e-05,3.640572332478458e-05,40,15,25
17201,disabling,2.3052039770217305e-06,1.8979287041356905e-06,3,2,1
17202,disadvantage,6.496483935243052e-06,7.074097897233022e-06,8,3,5
17203,disadvantaged,4.400843956132392e-06,1.8979287041356905e-06,3,2,1
17204,disaffected,2.3052039770217305e-06,3.6233184351681345e-06,4,1,3
17205,disagree,2.5357243747239038e-05,2.087721574549256e-05,28,16,12
17206,disagreed,2.3052039770217305e-06,1.8979287041356905e-06,3,2,1
17207,disagreement,1.0687763893464371e-05,1.2250267090330355e-05,12,5,7
17208,disappear,3.7931083621902995e-05,2.9504164400654783e-05,38,18,20
17209,disappearance,2.326160376812834e-05,2.777877466962238e-05,27,11,16
17210,disappeared,5.260056347567764e-05,4.8483451442011706e-05,61,28,33
17211,disappearing,8.592123914353715e-06,8.79948762826546e-06,13,6,7
17212,disappoint,2.3052039770217305e-06,5.348708166200577e-06,4,1,3
17213,disappointed,1.6974683830796368e-05,1.9151826014460126e-05,23,9,14
17214,disappointing,4.400843956132392e-06,5.348708166200577e-06,6,2,4
17215,disappointment,2.095639979110664e-07,1.3975656821362803e-05,8,0,8
17216,disapproval,2.095639979110664e-07,7.074097897233022e-06,4,0,4
17217,disapprove,8.592123914353715e-06,3.6233184351681345e-06,7,5,2
17218,disapproved,2.3052039770217305e-06,3.6233184351681345e-06,3,1,2
17219,disarm,2.095639979110664e-07,5.348708166200577e-06,4,1,3
17220,disarmament,6.496483935243052e-06,7.074097897233022e-06,7,3,4
17221,disarmed,2.3052039770217305e-06,1.8979287041356905e-06,3,1,2
17222,disarray,1.278340387257504e-05,1.052487735929791e-05,14,7,7
17223,disaster,0.00020348664197164515,0.00017098612234531542,218,102,116
17224,disastrou,1.278340387257504e-05,1.742643628342769e-05,18,7,11
17225,disavow,4.400843956132392e-06,1.8979287041356905e-06,4,2,2
17226,disbelief,2.3052039770217305e-06,1.052487735929791e-05,7,1,6
17227,discard,6.496483935243052e-06,3.6233184351681345e-06,5,3,2
17228,discarded,4.400843956132392e-06,7.074097897233022e-06,7,2,5
17229,discharge,4.400843956132392e-06,7.074097897233022e-06,8,2,6
17230,discharged,8.592123914353715e-06,1.8979287041356905e-06,6,4,2
17231,disciplinary,4.400843956132392e-06,1.8979287041356905e-06,5,3,2
17232,discipline,1.278340387257504e-05,1.742643628342769e-05,17,6,11
17233,disciplined,1.278340387257504e-05,7.074097897233022e-06,11,7,4
17234,disclose,3.3739803663681634e-05,3.8131113055817005e-05,43,19,24
17235,disclosed,2.116596378901769e-05,1.742643628342769e-05,21,10,11
17236,disclosing,4.400843956132392e-06,3.6233184351681345e-06,6,3,3
17237,disclosure,3.7931083621902995e-05,3.640572332478458e-05,44,21,23
17238,disco,2.3052039770217305e-06,3.6233184351681345e-06,3,1,2
17239,discomfort,2.3052039770217305e-06,5.348708166200577e-06,4,1,3
17240,disconnect,1.48790438516857e-05,3.6233184351681345e-06,11,9,2
17241,disconnected,8.592123914353715e-06,1.2250267090330355e-05,11,4,7
17242,disconnection,2.3052039770217305e-06,7.074097897233022e-06,6,2,4
17243,discontent,1.278340387257504e-05,7.074097897233022e-06,10,6,4
17244,discontinued,4.400843956132392e-06,3.6233184351681345e-06,4,2,2
17245,discord,2.3052039770217305e-06,3.6233184351681345e-06,3,1,2
17246,discount,1.278340387257504e-05,1.3975656821362803e-05,15,6,9
17247,discounted,4.400843956132392e-06,1.8979287041356905e-06,3,2,1
17248,discourage,6.496483935243052e-06,3.6233184351681345e-06,6,3,3
17249,discouraged,2.3052039770217305e-06,1.7253897310324457e-07,3,2,1
17250,discouraging,2.3052039770217305e-06,7.074097897233022e-06,6,1,5
17251,discourse,1.278340387257504e-05,1.8979287041356905e-06,8,6,2
17252,discover,5.260056347567764e-05,5.883578982820635e-05,62,26,36
17253,discovered,0.0001971997220343134,0.00017271151207634748,213,103,110
17254,discovering,6.496483935243052e-06,1.052487735929791e-05,11,4,7
17255,discovery,6.517440335034157e-05,7.954046660059569e-05,82,33,49
17256,discredit,1.278340387257504e-05,7.074097897233022e-06,13,7,6
17257,discredited,4.400843956132392e-06,1.8979287041356905e-06,3,2,1
17258,discrepancy,2.095639979110664e-07,1.052487735929791e-05,6,0,6
17259,discretion,2.3052039770217305e-06,5.348708166200577e-06,5,1,4
17260,discriminate,2.326160376812834e-05,2.2602605476525032e-05,25,12,13
17261,discriminated,6.496483935243052e-06,1.8979287041356905e-06,4,3,1
17262,discriminating,6.496483935243052e-06,7.074097897233022e-06,9,3,6
17263,discrimination,7.146132328767358e-05,0.00010542131256608228,104,37,67
17264,discriminatory,1.48790438516857e-05,2.4327995207557487e-05,22,8,14
17265,discu,6.72700433294523e-05,9.506897417988779e-05,93,37,56
17266,discussed,2.326160376812834e-05,2.777877466962238e-05,36,17,19
17267,discussing,2.326160376812834e-05,2.777877466962238e-05,31,12,19
17268,discussion,5.6791843433898893e-05,6.573734875233614e-05,69,29,40
17269,disdain,4.400843956132392e-06,5.348708166200577e-06,6,2,4
17270,disease,0.00016157384238943198,0.0001485560558418934,187,90,97
17271,disenfranchise,4.400843956132392e-06,5.348708166200577e-06,5,2,3
17272,disenfranchised,2.3052039770217305e-06,8.79948762826546e-06,6,1,5
17273,disenfranchisement,2.3052039770217305e-06,1.7253897310324457e-07,4,2,2
17274,disgrace,1.278340387257504e-05,1.052487735929791e-05,14,7,7
17275,disgraced,8.592123914353715e-06,1.052487735929791e-05,12,5,7
17276,disgraceful,8.592123914353715e-06,2.2602605476525032e-05,20,5,15
17277,disgruntled,2.095639979110664e-07,7.074097897233022e-06,4,0,4
17278,disguise,2.3052039770217305e-06,8.79948762826546e-06,7,2,5
17279,disguised,1.48790438516857e-05,2.087721574549256e-05,22,7,15
17280,disgust,2.3052039770217305e-06,5.348708166200577e-06,5,2,3
17281,disgusted,1.0687763893464371e-05,3.6233184351681345e-06,8,6,2
17282,disgusting,1.48790438516857e-05,2.087721574549256e-05,19,7,12
17283,dish,1.48790438516857e-05,8.79948762826546e-06,13,8,5
17284,dishonest,8.592123914353715e-06,1.3975656821362803e-05,13,4,9
17285,disillusioned,2.3052039770217305e-06,7.074097897233022e-06,5,1,4
17286,disinformation,2.3052039770217305e-06,1.8979287041356905e-06,4,1,3
17287,disingenuou,2.3052039770217305e-06,7.074097897233022e-06,5,1,4
17288,disintegrated,2.3052039770217305e-06,1.8979287041356905e-06,3,2,1
17289,disintegrating,4.400843956132392e-06,1.8979287041356905e-06,3,2,1
17290,dislike,6.496483935243052e-06,1.8979287041356905e-06,5,3,2
17291,disliked,2.3052039770217305e-06,3.6233184351681345e-06,4,1,3
17292,dismal,6.496483935243052e-06,1.2250267090330355e-05,11,3,8
17293,dismantle,1.6974683830796368e-05,1.9151826014460126e-05,21,10,11
17294,dismantled,6.496483935243052e-06,7.074097897233022e-06,7,3,4
17295,dismantling,8.592123914353715e-06,1.570104655239525e-05,13,4,9
17296,dismay,1.0687763893464371e-05,3.6233184351681345e-06,7,5,2
17297,dismayed,4.400843956132392e-06,8.79948762826546e-06,7,2,5
17298,dismembered,4.400843956132392e-06,1.052487735929791e-05,9,3,6
17299,dismis,6.496483935243052e-06,1.3975656821362803e-05,15,6,9
17300,dismiss,1.9070323809907035e-05,1.742643628342769e-05,20,10,10
17301,dismissal,8.592123914353715e-06,1.2250267090330355e-05,12,4,8
17302,dismissed,4.212236358012434e-05,5.1934230904076595e-05,55,21,34
17303,dismissing,1.0687763893464371e-05,1.8979287041356905e-06,8,6,2
17304,disobedience,6.496483935243052e-06,3.6233184351681345e-06,5,3,2
17305,disobey,2.095639979110664e-07,7.074097897233022e-06,5,0,5
17306,disobeying,8.592123914353715e-06,1.7253897310324457e-07,4,4,0
17307,disorder,1.48790438516857e-05,3.985650278684949e-05,34,8,26
17308,disparage,4.400843956132392e-06,1.8979287041356905e-06,3,2,1
17309,disparaged,2.3052039770217305e-06,3.6233184351681345e-06,3,1,2
17310,disparaging,4.400843956132392e-06,3.6233184351681345e-06,5,2,3
17311,disparity,1.278340387257504e-05,1.742643628342769e-05,22,7,15
17312,dispatch,4.400843956132392e-06,5.348708166200577e-06,7,4,3
17313,dispatched,6.496483935243052e-06,1.7253897310324457e-07,4,3,1
17314,dispel,4.400843956132392e-06,1.8979287041356905e-06,3,2,1
17315,dispensary,2.3052039770217305e-06,1.8979287041356905e-06,3,2,1
17316,dispense,2.095639979110664e-07,8.79948762826546e-06,5,0,5
17317,disperse,1.0687763893464371e-05,8.79948762826546e-06,10,5,5
17318,dispersed,2.3052039770217305e-06,5.348708166200577e-06,4,1,3
17319,displace,2.3052039770217305e-06,8.79948762826546e-06,6,1,5
17320,displaced,2.326160376812834e-05,2.2602605476525032e-05,27,12,15
17321,displacement,4.400843956132392e-06,1.052487735929791e-05,8,2,6
17322,display,4.4218003559234974e-05,4.8483451442011706e-05,55,24,31
17323,displayed,6.496483935243052e-06,1.2250267090330355e-05,10,3,7
17324,displaying,4.400843956132392e-06,5.348708166200577e-06,6,2,4
17325,displeasure,2.3052039770217305e-06,3.6233184351681345e-06,3,1,2
17326,disposal,4.400843956132392e-06,8.79948762826546e-06,7,2,5
17327,disposing,2.3052039770217305e-06,3.6233184351681345e-06,3,1,2
17328,disproportionate,1.278340387257504e-05,8.79948762826546e-06,11,6,5
17329,disproportionately,1.9070323809907035e-05,1.3975656821362803e-05,19,9,10
17330,dispute,8.403516316233764e-05,7.608968713853079e-05,94,41,53
17331,disputed,4.212236358012434e-05,4.330728224891437e-05,55,22,33
17332,disputing,4.400843956132392e-06,1.8979287041356905e-06,3,2,1
17333,disqualified,2.3052039770217305e-06,1.7253897310324457e-07,3,2,1
17334,disqualify,4.400843956132392e-06,3.6233184351681345e-06,4,2,2
17335,disregard,1.48790438516857e-05,1.570104655239525e-05,18,9,9
17336,disregarded,2.095639979110664e-07,5.348708166200577e-06,3,0,3
17337,disrespect,6.496483935243052e-06,1.8979287041356905e-06,4,3,1
17338,disrespectful,2.3052039770217305e-06,5.348708166200577e-06,5,1,4
17339,disrupt,2.326160376812834e-05,1.570104655239525e-05,21,11,10
17340,disrupted,1.0687763893464371e-05,8.79948762826546e-06,11,5,6
17341,disrupting,8.592123914353715e-06,1.570104655239525e-05,14,5,9
17342,disruption,1.48790438516857e-05,2.087721574549256e-05,21,9,12
17343,disruptive,4.400843956132392e-06,1.8979287041356905e-06,3,2,1
17344,dissatisfaction,2.3052039770217305e-06,5.348708166200577e-06,5,2,3
17345,dissected,2.3052039770217305e-06,3.6233184351681345e-06,3,1,2
17346,dissection,2.3052039770217305e-06,3.6233184351681345e-06,3,1,2
17347,dissent,2.7452883726349685e-05,2.9504164400654783e-05,33,14,19
17348,dissenting,2.3052039770217305e-06,1.8979287041356905e-06,3,1,2
17349,disservice,4.400843956132392e-06,5.348708166200577e-06,6,3,3
17350,dissident,3.7931083621902995e-05,5.711040009717395e-05,55,19,36
17351,dissolution,2.3052039770217305e-06,3.6233184351681345e-06,4,1,3
17352,dissolve,2.5357243747239038e-05,3.6233184351681345e-06,17,14,3
17353,dissolved,1.0687763893464371e-05,7.074097897233022e-06,9,5,4
17354,dissuade,2.3052039770217305e-06,7.074097897233022e-06,5,1,4
17355,distance,3.3739803663681634e-05,3.640572332478458e-05,39,17,22
17356,distanced,2.3052039770217305e-06,3.6233184351681345e-06,4,1,3
17357,distancing,4.400843956132392e-06,7.074097897233022e-06,7,3,4
17358,distant,1.278340387257504e-05,1.3975656821362803e-05,14,6,8
17359,distinct,6.496483935243052e-06,1.570104655239525e-05,12,3,9
17360,distinction,6.496483935243052e-06,1.052487735929791e-05,9,3,6
17361,distinctly,2.095639979110664e-07,1.8979287041356905e-06,3,0,3
17362,distinguish,8.592123914353715e-06,1.3975656821362803e-05,13,5,8
17363,distinguished,6.496483935243052e-06,1.8979287041356905e-06,4,3,1
17364,distorted,2.095639979110664e-07,7.074097897233022e-06,6,2,4
17365,distorting,4.400843956132392e-06,5.348708166200577e-06,5,2,3
17366,distortion,8.592123914353715e-06,1.7253897310324457e-07,5,5,0
17367,distract,1.278340387257504e-05,1.2250267090330355e-05,14,6,8
17368,distracted,1.0687763893464371e-05,8.79948762826546e-06,11,5,6
17369,distracting,8.592123914353715e-06,1.8979287041356905e-06,6,4,2
17370,distraction,1.48790438516857e-05,3.6233184351681345e-06,10,8,2
17371,distres,1.0687763893464371e-05,1.052487735929791e-05,12,5,7
17372,distressed,4.400843956132392e-06,5.348708166200577e-06,5,2,3
17373,distressing,1.0687763893464371e-05,3.6233184351681345e-06,7,5,2
17374,distribute,1.48790438516857e-05,1.052487735929791e-05,16,8,8
17375,distributed,1.0687763893464371e-05,1.052487735929791e-05,14,6,8
17376,distributing,6.496483935243052e-06,7.074097897233022e-06,8,3,5
17377,distribution,1.9070323809907035e-05,3.468033359375216e-05,32,9,23
17378,district,9.660900303700153e-05,9.334358444885519e-05,107,49,58
17379,distrust,8.592123914353715e-06,1.2250267090330355e-05,13,5,8
17380,disturb,4.400843956132392e-06,1.8979287041356905e-06,3,2,1
17381,disturbance,4.400843956132392e-06,3.6233184351681345e-06,5,3,2
17382,disturbed,1.48790438516857e-05,1.052487735929791e-05,13,7,6
17383,disturbing,2.7452883726349685e-05,2.2602605476525032e-05,31,15,16
17384,disturbingly,6.496483935243052e-06,1.8979287041356905e-06,4,3,1
17385,ditch,2.7452883726349685e-05,1.9151826014460126e-05,26,13,13
17386,ditching,8.592123914353715e-06,1.7253897310324457e-07,4,4,0
17387,dither,4.400843956132392e-06,1.8979287041356905e-06,3,2,1
17388,dive,4.400843956132392e-06,8.79948762826546e-06,8,2,6
17389,diver,8.592123914353715e-06,1.3975656821362803e-05,12,4,8
17390,diverse,2.5357243747239038e-05,2.6053384938589907e-05,29,14,15
17391,diversified,2.3052039770217305e-06,1.8979287041356905e-06,3,2,1
17392,diversify,6.496483935243052e-06,1.7253897310324457e-07,3,3,0
17393,diversion,4.400843956132392e-06,7.074097897233022e-06,6,2,4
17394,diversity,4.4218003559234974e-05,2.087721574549256e-05,40,22,18
17395,divert,1.278340387257504e-05,8.79948762826546e-06,12,7,5
17396,diverted,8.592123914353715e-06,1.052487735929791e-05,12,5,7
17397,diverting,4.400843956132392e-06,5.348708166200577e-06,6,3,3
17398,divest,1.48790438516857e-05,5.348708166200577e-06,11,8,3
17399,divesting,2.3052039770217305e-06,5.348708166200577e-06,4,1,3
17400,divestment,6.496483935243052e-06,1.8979287041356905e-06,4,3,1
17401,divide,4.840928351745632e-05,3.2954943862719716e-05,47,25,22
17402,divided,4.840928351745632e-05,2.6053384938589907e-05,42,25,17
17403,dividend,2.3052039770217305e-06,3.6233184351681345e-06,5,1,4
17404,dividing,1.0687763893464371e-05,1.3975656821362803e-05,14,5,9
17405,divine,2.3052039770217305e-06,1.2250267090330355e-05,8,1,7
17406,diving,2.3052039770217305e-06,1.2250267090330355e-05,9,1,8
17407,division,2.116596378901769e-05,3.122955413168725e-05,35,10,25
17408,divisive,1.9070323809907035e-05,1.2250267090330355e-05,17,10,7
17409,divisivenes,8.592123914353715e-06,3.6233184351681345e-06,6,4,2
17410,divorce,2.954852370546031e-05,1.9151826014460126e-05,28,16,12
17411,divorced,6.496483935243052e-06,5.348708166200577e-06,6,3,3
17412,do,1.278340387257504e-05,1.3975656821362803e-05,15,7,8
17413,doc,2.326160376812834e-05,1.570104655239525e-05,23,12,11
17414,dock,6.496483935243052e-06,1.2250267090330355e-05,10,3,7
17415,docket,4.400843956132392e-06,1.8979287041356905e-06,3,2,1
17416,docking,4.400843956132392e-06,8.79948762826546e-06,7,2,5
17417,doctor,0.00020767792192986646,0.00020549391696596386,247,109,138
17418,doctorate,4.400843956132392e-06,3.6233184351681345e-06,4,2,2
17419,doctored,6.496483935243052e-06,1.7253897310324457e-07,3,3,0
17420,doctrine,1.6974683830796368e-05,1.052487735929791e-05,16,8,8
17421,document,0.0003397032406138383,0.000286587234324489,364,176,188
17422,documentarian,2.095639979110664e-07,1.8979287041356905e-06,3,2,1
17423,documentary,5.050492349656699e-05,6.228656929027126e-05,65,26,39
17424,documentation,6.496483935243052e-06,1.8979287041356905e-06,5,3,2
17425,documented,1.9070323809907035e-05,8.79948762826546e-06,16,10,6
17426,documenting,2.3052039770217305e-06,5.348708166200577e-06,4,1,3
17427,dodge,1.6974683830796368e-05,1.052487735929791e-05,16,10,6
17428,dodged,4.400843956132392e-06,7.074097897233022e-06,7,2,5
17429,dodger,4.400843956132392e-06,1.2250267090330355e-05,9,2,7
17430,dodging,8.592123914353715e-06,1.8979287041356905e-06,5,4,1
17431,dodgy,2.3052039770217305e-06,3.6233184351681345e-06,4,1,3
17432,doesn,6.72700433294523e-05,6.573734875233614e-05,82,37,45
17433,dog,0.00010918284291166549,0.00017788768126944505,178,60,118
17434,dogged,2.3052039770217305e-06,8.79948762826546e-06,6,1,5
17435,doll,4.400843956132392e-06,1.8979287041356905e-06,3,2,1
17436,dollar,0.00023282560167919462,0.0002848618445934566,313,123,190
17437,dolphin,3.583544364279237e-05,3.2954943862719716e-05,40,19,21
17438,domain,1.48790438516857e-05,2.4327995207557487e-05,23,7,16
17439,domestic,8.193952318322689e-05,0.00013130215853156914,128,43,85
17440,domestically,2.3052039770217305e-06,3.6233184351681345e-06,3,1,2
17441,dominance,3.1644163684570994e-05,1.052487735929791e-05,24,17,7
17442,dominant,8.592123914353715e-06,7.074097897233022e-06,10,4,6
17443,dominate,1.6974683830796368e-05,1.2250267090330355e-05,17,8,9
17444,dominated,1.278340387257504e-05,1.2250267090330355e-05,16,6,10
17445,dominating,6.496483935243052e-06,1.8979287041356905e-06,4,3,1
17446,domination,2.3052039770217305e-06,7.074097897233022e-06,5,1,4
17447,domino,2.3052039770217305e-06,5.348708166200577e-06,5,2,3
17448,don,0.00013642616264010403,0.0001364783277246665,170,80,90
17449,donate,5.888748341300963e-05,4.330728224891437e-05,59,29,30
17450,donated,2.954852370546031e-05,2.777877466962238e-05,34,15,19
17451,donating,1.6974683830796368e-05,1.052487735929791e-05,14,8,6
17452,donation,0.00010080028299522283,9.161819471782287e-05,111,54,57
17453,done,0.00020348664197164515,0.00021239547589009395,242,102,140
17454,donkey,1.0687763893464371e-05,8.79948762826546e-06,10,5,5
17455,donor,9.03220830996695e-05,7.436429740749831e-05,102,50,52
17456,donothing,4.400843956132392e-06,3.6233184351681345e-06,4,2,2
17457,doom,2.326160376812834e-05,5.348708166200577e-06,15,11,4
17458,doomed,1.6974683830796368e-05,1.3975656821362803e-05,19,9,10
17459,doomsday,8.592123914353715e-06,7.074097897233022e-06,9,4,5
17460,door,8.613080314144832e-05,0.00010024514337298497,112,46,66
17461,doorstep,4.400843956132392e-06,7.074097897233022e-06,6,2,4
17462,doortodoor,2.095639979110664e-07,1.8979287041356905e-06,3,1,2
17463,dope,4.400843956132392e-06,1.7253897310324457e-07,3,3,0
17464,doping,1.278340387257504e-05,3.6233184351681345e-06,8,6,2
17465,dorm,6.496483935243052e-06,1.8979287041356905e-06,4,3,1
17466,dormant,6.496483935243052e-06,1.8979287041356905e-06,5,4,1
17467,dormitory,2.3052039770217305e-06,7.074097897233022e-06,5,1,4
17468,dose,0.00011966104280721883,9.161819471782287e-05,124,64,60
17469,dossier,8.592123914353715e-06,1.052487735929791e-05,11,4,7
17470,dot,2.3052039770217305e-06,5.348708166200577e-06,5,2,3
17471,double,9.24177230787802e-05,7.091351794543343e-05,93,48,45
17472,doubled,2.326160376812834e-05,4.1581892517881935e-05,37,13,24
17473,doubling,6.496483935243052e-06,7.074097897233022e-06,9,3,6
17474,doubt,0.00010918284291166549,8.126585633162811e-05,107,56,51
17475,doubtful,8.592123914353715e-06,3.6233184351681345e-06,6,4,2
17476,doused,4.400843956132392e-06,1.8979287041356905e-06,4,2,2
17477,dove,2.095639979110664e-07,3.6233184351681345e-06,3,0,3
17478,down,4.400843956132392e-06,1.2250267090330355e-05,9,2,7
17479,downballot,2.095639979110664e-07,5.348708166200577e-06,3,0,3
17480,downed,1.6974683830796368e-05,2.2602605476525032e-05,22,9,13
17481,downfall,6.496483935243052e-06,7.074097897233022e-06,7,3,4
17482,downgrade,1.278340387257504e-05,1.570104655239525e-05,17,6,11
17483,downgraded,1.0687763893464371e-05,1.2250267090330355e-05,14,5,9
17484,downgrading,2.3052039770217305e-06,1.8979287041356905e-06,3,1,2
17485,downing,1.6974683830796368e-05,8.79948762826546e-06,15,8,7
17486,download,1.48790438516857e-05,2.2602605476525032e-05,22,9,13
17487,downloaded,4.400843956132392e-06,1.8979287041356905e-06,4,2,2
17488,downloader,2.3052039770217305e-06,1.8979287041356905e-06,3,2,1
17489,downloading,4.400843956132392e-06,1.2250267090330355e-05,10,2,8
17490,downplay,2.3052039770217305e-06,7.074097897233022e-06,7,1,6
17491,downplayed,2.3052039770217305e-06,7.074097897233022e-06,6,1,5
17492,downplaying,2.3052039770217305e-06,3.6233184351681345e-06,4,1,3
17493,downright,2.3052039770217305e-06,5.348708166200577e-06,4,1,3
17494,downtown,2.116596378901769e-05,2.087721574549256e-05,24,11,13
17495,downturn,4.400843956132392e-06,1.052487735929791e-05,10,4,6
17496,downward,4.400843956132392e-06,5.348708166200577e-06,6,2,4
17497,dowry,2.095639979110664e-07,7.074097897233022e-06,5,1,4
17498,dozen,0.00017205204228498542,0.0001485560558418934,194,89,105
17499,drachma,6.496483935243052e-06,1.8979287041356905e-06,4,3,1
17500,draconian,1.9070323809907035e-05,1.3975656821362803e-05,17,9,8
17501,draft,6.517440335034157e-05,8.126585633162811e-05,84,33,51
17502,drafted,1.48790438516857e-05,8.79948762826546e-06,13,7,6
17503,drafting,8.592123914353715e-06,8.79948762826546e-06,10,4,6
17504,drag,1.48790438516857e-05,1.052487735929791e-05,15,9,6
17505,dragged,2.7452883726349685e-05,1.9151826014460126e-05,26,14,12
17506,dragging,1.0687763893464371e-05,7.074097897233022e-06,13,6,7
17507,dragnet,2.3052039770217305e-06,3.6233184351681345e-06,3,1,2
17508,dragon,8.592123914353715e-06,7.074097897233022e-06,8,4,4
17509,drain,1.6974683830796368e-05,1.742643628342769e-05,20,8,12
17510,drained,2.095639979110664e-07,3.6233184351681345e-06,3,1,2
17511,draining,4.400843956132392e-06,7.074097897233022e-06,6,2,4
17512,drama,2.954852370546031e-05,1.570104655239525e-05,25,14,11
17513,dramatic,5.260056347567764e-05,5.1934230904076595e-05,59,27,32
17514,dramatically,1.9070323809907035e-05,3.122955413168725e-05,29,9,20
17515,drank,4.400843956132392e-06,5.348708166200577e-06,7,3,4
17516,drastic,1.278340387257504e-05,1.052487735929791e-05,13,7,6
17517,drastically,1.278340387257504e-05,1.3975656821362803e-05,14,6,8
17518,draw,6.098312339212028e-05,5.5385010366141504e-05,71,32,39
17519,drawing,3.7931083621902995e-05,2.777877466962238e-05,39,20,19
17520,drawn,3.1644163684570994e-05,4.8483451442011706e-05,45,16,29
17521,dread,4.400843956132392e-06,5.348708166200577e-06,6,2,4
17522,dreaded,2.095639979110664e-07,3.6233184351681345e-06,3,0,3
17523,dreadful,6.496483935243052e-06,1.8979287041356905e-06,4,3,1
17524,dream,7.355696326678427e-05,0.0001019705331040174,102,39,63
17525,dreamed,6.496483935243052e-06,3.6233184351681345e-06,5,3,2
17526,dreaming,4.400843956132392e-06,5.348708166200577e-06,6,2,4
17527,dreary,4.400843956132392e-06,3.6233184351681345e-06,4,2,2
17528,dredge,6.496483935243052e-06,7.074097897233022e-06,7,3,4
17529,dredging,4.400843956132392e-06,5.348708166200577e-06,5,2,3
17530,drenched,4.400843956132392e-06,1.8979287041356905e-06,3,2,1
17531,dres,3.583544364279237e-05,2.4327995207557487e-05,35,18,17
17532,dressed,2.7452883726349685e-05,1.742643628342769e-05,25,14,11
17533,dressing,4.400843956132392e-06,7.074097897233022e-06,7,3,4
17534,drew,2.326160376812834e-05,2.4327995207557487e-05,28,12,16
17535,dried,2.3052039770217305e-06,3.6233184351681345e-06,3,1,2
17536,drifting,4.400843956132392e-06,8.79948762826546e-06,8,2,6
17537,drill,4.840928351745632e-05,4.1581892517881935e-05,54,26,28
17538,drilling,4.840928351745632e-05,4.50326719799468e-05,55,26,29
17539,drink,5.888748341300963e-05,6.573734875233614e-05,71,30,41
17540,drinkdriving,2.3052039770217305e-06,1.8979287041356905e-06,3,1,2
17541,drinker,2.3052039770217305e-06,5.348708166200577e-06,5,2,3
17542,drinking,7.984388320411623e-05,7.091351794543343e-05,88,42,46
17543,drip,4.400843956132392e-06,7.074097897233022e-06,6,2,4
17544,dripped,4.400843956132392e-06,1.8979287041356905e-06,3,2,1
17545,drive,0.00013223488268188294,0.00011922443041434203,149,72,77
17546,driveby,2.095639979110664e-07,7.074097897233022e-06,4,0,4
17547,driven,5.260056347567764e-05,3.640572332478458e-05,49,26,23
17548,driver,0.00012175668278632962,0.0001036959228350498,133,63,70
17549,driverles,2.095639979110664e-07,7.074097897233022e-06,4,0,4
17550,driving,8.193952318322689e-05,8.644202552472544e-05,101,42,59
17551,drone,0.00023282560167919462,0.00021239547589009395,256,117,139
17552,drop,0.0001741476822640959,0.00014165449691776373,182,87,95
17553,dropped,0.00011756540282810809,9.161819471782287e-05,117,59,58
17554,dropping,2.954852370546031e-05,2.9504164400654783e-05,34,14,20
17555,drought,5.050492349656699e-05,5.5385010366141504e-05,61,25,36
17556,drove,2.954852370546031e-05,1.9151826014460126e-05,32,18,14
17557,drown,8.592123914353715e-06,8.79948762826546e-06,9,4,5
17558,drowned,8.592123914353715e-06,2.2602605476525032e-05,18,4,14
17559,drowning,8.592123914353715e-06,8.79948762826546e-06,10,4,6
17560,drug,0.0007609268764150817,0.000752442461703249,894,401,493
17561,drugcartel,2.3052039770217305e-06,3.6233184351681345e-06,3,1,2
17562,drugged,4.400843956132392e-06,5.348708166200577e-06,6,2,4
17563,drugmaker,6.496483935243052e-06,5.348708166200577e-06,6,3,3
17564,drugrelated,1.6974683830796368e-05,5.348708166200577e-06,14,8,6
17565,drugresistant,6.496483935243052e-06,1.7253897310324457e-07,4,3,1
17566,drum,6.496483935243052e-06,1.742643628342769e-05,13,3,10
17567,drummer,2.095639979110664e-07,3.6233184351681345e-06,3,0,3
17568,drunk,3.3739803663681634e-05,3.122955413168725e-05,35,17,18
17569,drunken,8.592123914353715e-06,1.052487735929791e-05,11,4,7
17570,dry,1.48790438516857e-05,2.6053384938589907e-05,24,7,17
17571,drying,4.400843956132392e-06,1.8979287041356905e-06,4,3,1
17572,du,4.400843956132392e-06,1.7253897310324457e-07,3,3,0
17573,dual,1.6974683830796368e-05,1.8979287041356905e-06,9,8,1
17574,dubbed,2.954852370546031e-05,1.2250267090330355e-05,22,15,7
17575,dubiou,1.278340387257504e-05,1.570104655239525e-05,17,6,11
17576,duck,8.592123914353715e-06,1.570104655239525e-05,16,5,11
17577,duckling,2.3052039770217305e-06,1.8979287041356905e-06,3,1,2
17578,dude,6.496483935243052e-06,3.6233184351681345e-06,8,3,5
17579,due,0.00024749508153296894,0.00025725560889693777,295,129,166
17580,dug,6.496483935243052e-06,7.074097897233022e-06,8,3,5
17581,dull,2.095639979110664e-07,7.074097897233022e-06,4,0,4
17582,dumb,1.48790438516857e-05,1.052487735929791e-05,14,7,7
17583,dummy,2.3052039770217305e-06,5.348708166200577e-06,4,1,3
17584,dump,4.212236358012434e-05,4.1581892517881935e-05,49,20,29
17585,dumped,4.002672360101368e-05,3.468033359375216e-05,40,19,21
17586,dumping,2.116596378901769e-05,3.468033359375216e-05,31,10,21
17587,duo,6.496483935243052e-06,3.6233184351681345e-06,5,3,2
17588,duped,4.400843956132392e-06,8.79948762826546e-06,7,2,5
17589,duration,2.3052039770217305e-06,1.8979287041356905e-06,3,1,2
17590,dures,2.095639979110664e-07,5.348708166200577e-06,3,0,3
17591,dust,1.6974683830796368e-05,1.2250267090330355e-05,17,9,8
17592,duty,5.050492349656699e-05,4.6758061710979285e-05,58,28,30
17593,dwarf,2.326160376812834e-05,1.2250267090330355e-05,18,11,7
17594,dwarfed,2.095639979110664e-07,7.074097897233022e-06,4,0,4
17595,dwell,2.3052039770217305e-06,3.6233184351681345e-06,3,1,2
17596,dweller,2.3052039770217305e-06,5.348708166200577e-06,4,1,3
17597,dwelling,2.095639979110664e-07,5.348708166200577e-06,3,0,3
17598,dwindle,4.400843956132392e-06,3.6233184351681345e-06,4,2,2
17599,dwindling,4.400843956132392e-06,5.348708166200577e-06,8,3,5
17600,dy,0.00014061744259832545,0.00013130215853156914,165,76,89
17601,dying,5.050492349656699e-05,6.918812821440096e-05,73,29,44
17602,dynamic,8.592123914353715e-06,5.348708166200577e-06,8,4,4
17603,dynamite,6.496483935243052e-06,1.8979287041356905e-06,4,3,1
17604,dynasty,1.278340387257504e-05,5.348708166200577e-06,10,6,4
17605,dysfunction,2.3052039770217305e-06,7.074097897233022e-06,5,1,4
17606,dysfunctional,4.400843956132392e-06,1.052487735929791e-05,8,2,6
17607,dystopia,4.400843956132392e-06,1.8979287041356905e-06,3,2,1
17608,décor,2.095639979110664e-07,5.348708166200577e-06,3,0,3
17609,eBay,1.9070323809907035e-05,1.9151826014460126e-05,22,10,12
17610,ea,4.400843956132392e-06,1.052487735929791e-05,9,3,6
17611,eager,2.116596378901769e-05,1.570104655239525e-05,21,11,10
17612,eagle,1.0687763893464371e-05,5.348708166200577e-06,8,5,3
17613,ear,1.6974683830796368e-05,2.2602605476525032e-05,22,8,14
17614,earful,4.400843956132392e-06,1.8979287041356905e-06,3,2,1
17615,earlier,0.00011127848289077625,0.0001364783277246665,145,60,85
17616,earliest,1.48790438516857e-05,1.3975656821362803e-05,16,7,9
17617,early,0.00019091280209698145,0.0002244732040073209,254,108,146
17618,earmark,2.095639979110664e-07,3.6233184351681345e-06,3,1,2
17619,earmarked,4.400843956132392e-06,1.7253897310324457e-07,3,2,1
17620,earn,5.888748341300963e-05,5.1934230904076595e-05,67,31,36
17621,earned,2.116596378901769e-05,1.742643628342769e-05,27,13,14
17622,earner,2.3052039770217305e-06,1.052487735929791e-05,9,2,7
17623,earnest,4.400843956132392e-06,1.8979287041356905e-06,3,2,1
17624,earning,4.002672360101368e-05,2.777877466962238e-05,40,21,19
17625,earth,6.307876337123095e-05,4.6758061710979285e-05,61,31,30
17626,earthquake,0.00022863432172097337,0.00015373222503499084,208,112,96
17627,ease,2.7452883726349685e-05,3.468033359375216e-05,35,14,21
17628,easier,5.050492349656699e-05,6.746273848336857e-05,73,29,44
17629,easiest,2.3052039770217305e-06,3.6233184351681345e-06,3,1,2
17630,easily,4.002672360101368e-05,3.985650278684949e-05,48,23,25
17631,easing,6.496483935243052e-06,7.074097897233022e-06,8,3,5
17632,east,6.936568330856297e-05,9.506897417988779e-05,97,37,60
17633,eastern,0.00010289592297433347,0.00010887209202814718,124,58,66
17634,eastward,4.400843956132392e-06,1.8979287041356905e-06,3,2,1
17635,easy,0.0001154697628489974,0.00011922443041434203,142,62,80
17636,eat,7.355696326678427e-05,7.091351794543343e-05,91,42,49
17637,eaten,1.278340387257504e-05,1.3975656821362803e-05,15,6,9
17638,eater,2.3052039770217305e-06,3.6233184351681345e-06,3,1,2
17639,eatery,2.3052039770217305e-06,3.6233184351681345e-06,4,1,3
17640,eating,4.212236358012434e-05,4.330728224891437e-05,53,24,29
17641,eavesdrop,2.3052039770217305e-06,3.6233184351681345e-06,3,1,2
17642,eavesdropping,8.592123914353715e-06,1.052487735929791e-05,10,4,6
17643,ebb,2.3052039770217305e-06,1.8979287041356905e-06,3,2,1
17644,ebola,1.6974683830796368e-05,8.79948762826546e-06,13,8,5
17645,echo,8.592123914353715e-06,1.2250267090330355e-05,11,4,7
17646,echoed,6.496483935243052e-06,5.348708166200577e-06,6,3,3
17647,echoing,2.095639979110664e-07,5.348708166200577e-06,4,1,3
17648,ecigarette,4.400843956132392e-06,7.074097897233022e-06,7,2,5
17649,eclipse,1.48790438516857e-05,1.9151826014460126e-05,20,9,11
17650,ecofriendly,2.3052039770217305e-06,1.8979287041356905e-06,3,2,1
17651,ecological,2.3052039770217305e-06,2.087721574549256e-05,15,2,13
17652,ecologically,4.400843956132392e-06,1.8979287041356905e-06,3,2,1
17653,ecology,4.400843956132392e-06,1.8979287041356905e-06,3,2,1
17654,ecommerce,2.095639979110664e-07,3.6233184351681345e-06,3,1,2
17655,economic,0.0003229381207809529,0.00036250438248991657,409,178,231
17656,economically,1.6974683830796368e-05,1.2250267090330355e-05,17,10,7
17657,economist,5.260056347567764e-05,4.1581892517881935e-05,52,27,25
17658,economy,0.0003837116801751621,0.0004125406846898576,477,211,266
17659,ecosystem,3.1644163684570994e-05,2.087721574549256e-05,31,17,14
17660,ecstasy,1.278340387257504e-05,5.348708166200577e-06,10,7,3
17661,ed,4.400843956132392e-06,1.8979287041356905e-06,4,2,2
17662,edge,2.954852370546031e-05,2.777877466962238e-05,37,15,22
17663,edging,4.400843956132392e-06,1.8979287041356905e-06,3,2,1
17664,edible,2.095639979110664e-07,5.348708166200577e-06,4,1,3
17665,edict,6.496483935243052e-06,1.8979287041356905e-06,4,3,1
17666,edit,4.400843956132392e-06,5.348708166200577e-06,5,2,3
17667,edited,1.0687763893464371e-05,8.79948762826546e-06,10,5,5
17668,editing,2.3052039770217305e-06,8.79948762826546e-06,6,1,5
17669,edition,8.592123914353715e-06,1.9151826014460126e-05,15,4,11
17670,editor,5.4696203454788295e-05,6.573734875233614e-05,70,27,43
17671,editorial,2.5357243747239038e-05,1.570104655239525e-05,22,12,10
17672,educate,6.496483935243052e-06,1.570104655239525e-05,15,5,10
17673,educated,2.116596378901769e-05,2.2602605476525032e-05,25,10,15
17674,educating,1.0687763893464371e-05,1.052487735929791e-05,11,5,6
17675,education,0.00019091280209698145,0.0002192970348142235,253,107,146
17676,educational,2.7452883726349685e-05,1.570104655239525e-05,23,13,10
17677,educator,1.0687763893464371e-05,2.087721574549256e-05,17,5,12
17678,eel,4.400843956132392e-06,1.8979287041356905e-06,3,2,1
17679,effect,0.00017205204228498542,0.00017788768126944505,207,93,114
17680,effective,6.936568330856297e-05,7.954046660059569e-05,85,36,49
17681,effectively,5.260056347567764e-05,7.608968713853079e-05,78,30,48
17682,effectivenes,8.592123914353715e-06,7.074097897233022e-06,11,6,5
17683,efficiency,1.6974683830796368e-05,1.3975656821362803e-05,17,8,9
17684,efficient,1.6974683830796368e-05,1.2250267090330355e-05,16,8,8
17685,effigy,8.592123914353715e-06,1.8979287041356905e-06,5,4,1
17686,effort,0.00035856400042583424,0.00036250438248991657,436,195,241
17687,effortlessly,2.3052039770217305e-06,3.6233184351681345e-06,4,2,2
17688,eg,2.3052039770217305e-06,3.6233184351681345e-06,4,1,3
17689,egalitarian,2.3052039770217305e-06,5.348708166200577e-06,4,1,3
17690,egg,4.840928351745632e-05,2.9504164400654783e-05,45,25,20
17691,ego,6.496483935243052e-06,3.6233184351681345e-06,6,3,3
17692,egregiou,1.0687763893464371e-05,8.79948762826546e-06,11,6,5
17693,eh,6.496483935243052e-06,1.8979287041356905e-06,4,3,1
17694,eight,0.00011127848289077625,0.00013130215853156914,141,57,84
17695,eighth,6.496483935243052e-06,7.074097897233022e-06,9,4,5
17696,eightyear,2.3052039770217305e-06,3.6233184351681345e-06,4,1,3
17697,eightyearold,6.496483935243052e-06,3.6233184351681345e-06,5,3,2
17698,either,9.451336305789087e-05,0.00012094982014537423,131,52,79
17699,ejected,4.400843956132392e-06,7.074097897233022e-06,7,2,5
17700,el,1.48790438516857e-05,1.2250267090330355e-05,14,7,7
17701,elSisi,4.400843956132392e-06,1.8979287041356905e-06,3,2,1
17702,elaborate,1.0687763893464371e-05,7.074097897233022e-06,10,6,4
17703,elder,1.278340387257504e-05,1.9151826014460126e-05,17,6,11
17704,elderly,6.098312339212028e-05,3.8131113055817005e-05,57,30,27
17705,eldest,2.3052039770217305e-06,1.570104655239525e-05,10,1,9
17706,elect,4.6313643538345614e-05,4.6758061710979285e-05,49,22,27
17707,elected,0.00010918284291166549,0.00010024514337298497,125,59,66
17708,electing,4.400843956132392e-06,1.052487735929791e-05,8,2,6
17709,election,0.0007965527560599625,0.0007196600568136328,898,420,478
17710,electionrelated,4.400843956132392e-06,1.8979287041356905e-06,4,2,2
17711,elections,4.400843956132392e-06,1.8979287041356905e-06,3,2,1
17712,elector,4.400843956132392e-06,5.348708166200577e-06,7,3,4
17713,electoral,2.7452883726349685e-05,3.468033359375216e-05,44,18,26
17714,electorate,1.48790438516857e-05,1.3975656821362803e-05,16,7,9
17715,electric,2.5357243747239038e-05,5.020884117304414e-05,47,16,31
17716,electrical,1.48790438516857e-05,1.3975656821362803e-05,15,7,8
17717,electricity,7.565260324589493e-05,9.851975364195259e-05,106,39,67
17718,electrocuted,8.592123914353715e-06,5.348708166200577e-06,7,4,3
17719,electrocution,2.3052039770217305e-06,3.6233184351681345e-06,3,1,2
17720,electronic,6.098312339212028e-05,4.8483451442011706e-05,60,31,29
17721,electronically,2.3052039770217305e-06,3.6233184351681345e-06,4,1,3
17722,elegant,2.3052039770217305e-06,3.6233184351681345e-06,4,1,3
17723,element,3.583544364279237e-05,2.4327995207557487e-05,36,19,17
17724,elementary,1.6974683830796368e-05,5.348708166200577e-06,11,8,3
17725,elephant,0.00010708720293255492,8.299124606266055e-05,115,58,57
17726,elevate,2.3052039770217305e-06,7.074097897233022e-06,5,1,4
17727,elevated,6.496483935243052e-06,8.79948762826546e-06,9,4,5
17728,elevator,8.592123914353715e-06,7.074097897233022e-06,8,4,4
17729,eleven,4.400843956132392e-06,5.348708166200577e-06,5,2,3
17730,eligibility,6.496483935243052e-06,3.6233184351681345e-06,6,4,2
17731,eligible,2.5357243747239038e-05,1.742643628342769e-05,24,13,11
17732,eliminate,5.4696203454788295e-05,5.883578982820635e-05,64,26,38
17733,eliminated,1.48790438516857e-05,1.570104655239525e-05,17,8,9
17734,eliminating,1.9070323809907035e-05,1.9151826014460126e-05,22,10,12
17735,elimination,2.3052039770217305e-06,5.348708166200577e-06,6,2,4
17736,elite,9.03220830996695e-05,7.263890767646595e-05,97,49,48
17737,eloping,2.3052039770217305e-06,1.8979287041356905e-06,3,2,1
17738,eloquent,2.3052039770217305e-06,3.6233184351681345e-06,3,1,2
17739,else,0.0001154697628489974,0.0001295767688005365,153,62,91
17740,elsewhere,2.5357243747239038e-05,5.020884117304414e-05,43,13,30
17741,elude,2.3052039770217305e-06,1.8979287041356905e-06,3,1,2
17742,elusive,1.0687763893464371e-05,5.348708166200577e-06,10,5,5
17743,em,8.592123914353715e-06,2.2602605476525032e-05,19,4,15
17744,emaciated,2.3052039770217305e-06,3.6233184351681345e-06,3,1,2
17745,email,0.00028940788111518276,0.0002141208656211263,278,147,131
17746,emailed,6.496483935243052e-06,1.8979287041356905e-06,4,3,1
17747,emailing,6.496483935243052e-06,1.7253897310324457e-07,3,3,0
17748,emanating,6.496483935243052e-06,5.348708166200577e-06,6,3,3
17749,embargo,2.954852370546031e-05,1.9151826014460126e-05,27,15,12
17750,embark,6.496483935243052e-06,5.348708166200577e-06,6,3,3
17751,embarked,6.496483935243052e-06,3.6233184351681345e-06,6,3,3
17752,embarking,8.592123914353715e-06,3.6233184351681345e-06,6,4,2
17753,embarras,2.095639979110664e-07,5.348708166200577e-06,3,0,3
17754,embarrassed,1.0687763893464371e-05,7.074097897233022e-06,14,6,8
17755,embarrassing,2.5357243747239038e-05,3.468033359375216e-05,35,14,21
17756,embarrassment,1.9070323809907035e-05,1.742643628342769e-05,20,9,11
17757,embassy,0.00012804360272366158,0.00016063378395912072,170,64,106
17758,embattled,2.116596378901769e-05,2.2602605476525032e-05,28,12,16
17759,embedded,4.400843956132392e-06,8.79948762826546e-06,8,2,6
17760,embezzlement,1.0687763893464371e-05,8.79948762826546e-06,10,5,5
17761,embezzling,2.095639979110664e-07,5.348708166200577e-06,3,0,3
17762,emblem,4.400843956132392e-06,1.8979287041356905e-06,3,2,1
17763,emblematic,4.400843956132392e-06,1.8979287041356905e-06,3,2,1
17764,embody,6.496483935243052e-06,1.7253897310324457e-07,3,3,0
17765,embolden,2.3052039770217305e-06,1.8979287041356905e-06,3,2,1
17766,emboldened,4.400843956132392e-06,7.074097897233022e-06,6,2,4
17767,emboldening,4.400843956132392e-06,1.8979287041356905e-06,5,2,3
17768,embrace,5.6791843433898893e-05,5.711040009717395e-05,69,30,39
17769,embraced,1.278340387257504e-05,1.2250267090330355e-05,14,6,8
17770,embracing,1.48790438516857e-05,1.9151826014460126e-05,19,8,11
17771,embroiled,1.0687763893464371e-05,3.6233184351681345e-06,7,5,2
17772,embryo,8.592123914353715e-06,5.348708166200577e-06,7,4,3
17773,emerge,6.098312339212028e-05,3.2954943862719716e-05,52,31,21
17774,emerged,7.774824322500554e-05,6.401195902130366e-05,80,40,40
17775,emergence,4.400843956132392e-06,1.8979287041356905e-06,3,2,1
17776,emergency,0.00019091280209698145,0.00015373222503499084,204,104,100
17777,emerging,5.888748341300963e-05,4.330728224891437e-05,57,29,28
17778,emigrate,2.095639979110664e-07,7.074097897233022e-06,4,0,4
17779,emigrating,6.496483935243052e-06,1.8979287041356905e-06,4,3,1
17780,emirate,2.3052039770217305e-06,3.6233184351681345e-06,4,1,3
17781,emission,0.0001343305226609934,0.00013302754826260141,152,66,86
17782,emit,2.3052039770217305e-06,3.6233184351681345e-06,4,2,2
17783,emitted,2.3052039770217305e-06,3.6233184351681345e-06,3,1,2
17784,emitter,8.592123914353715e-06,1.052487735929791e-05,10,4,6
17785,emitting,4.400843956132392e-06,5.348708166200577e-06,5,2,3
17786,emoji,6.496483935243052e-06,1.7253897310324457e-07,4,3,1
17787,emotion,8.592123914353715e-06,2.087721574549256e-05,19,5,14
17788,emotional,4.212236358012434e-05,3.8131113055817005e-05,47,24,23
17789,emotionally,6.496483935243052e-06,1.3975656821362803e-05,12,3,9
17790,empathize,4.400843956132392e-06,1.8979287041356905e-06,4,2,2
17791,empathy,1.278340387257504e-05,1.052487735929791e-05,15,7,8
17792,emperor,2.095639979110664e-07,1.9151826014460126e-05,12,1,11
17793,emphasize,8.592123914353715e-06,7.074097897233022e-06,8,4,4
17794,emphasized,2.095639979110664e-07,5.348708166200577e-06,3,0,3
17795,emphasizing,2.3052039770217305e-06,3.6233184351681345e-06,3,1,2
17796,emphatically,2.3052039770217305e-06,3.6233184351681345e-06,3,1,2
17797,empire,4.212236358012434e-05,2.087721574549256e-05,33,21,12
17798,employ,2.326160376812834e-05,1.3975656821362803e-05,20,11,9
17799,employed,2.116596378901769e-05,1.742643628342769e-05,23,11,12
17800,employee,0.0002516863614911905,0.00026415716782106726,303,136,167
17801,employer,7.355696326678427e-05,7.263890767646595e-05,88,38,50
17802,employersponsored,2.3052039770217305e-06,3.6233184351681345e-06,3,1,2
17803,employing,1.48790438516857e-05,5.348708166200577e-06,10,7,3
17804,employment,2.954852370546031e-05,3.8131113055817005e-05,42,15,27
17805,empower,1.9070323809907035e-05,2.9504164400654783e-05,27,10,17
17806,empowered,2.3052039770217305e-06,1.3975656821362803e-05,10,2,8
17807,empowering,1.278340387257504e-05,7.074097897233022e-06,11,6,5
17808,empowerment,4.400843956132392e-06,1.8979287041356905e-06,4,2,2
17809,emptied,6.496483935243052e-06,5.348708166200577e-06,6,3,3
17810,emptines,4.400843956132392e-06,3.6233184351681345e-06,4,2,2
17811,empty,3.583544364279237e-05,4.6758061710979285e-05,51,21,30
17812,emulate,2.3052039770217305e-06,7.074097897233022e-06,5,1,4
17813,en,1.48790438516857e-05,1.742643628342769e-05,18,7,11
17814,enable,3.3739803663681634e-05,2.4327995207557487e-05,33,17,16
17815,enabled,8.592123914353715e-06,7.074097897233022e-06,10,5,5
17816,enabler,4.400843956132392e-06,5.348708166200577e-06,5,2,3
17817,enabling,1.278340387257504e-05,1.052487735929791e-05,14,7,7
17818,enact,1.0687763893464371e-05,8.79948762826546e-06,12,6,6
17819,enacted,1.0687763893464371e-05,1.2250267090330355e-05,14,5,9
17820,enacting,2.3052039770217305e-06,5.348708166200577e-06,4,1,3
17821,enclave,1.48790438516857e-05,8.79948762826546e-06,15,8,7
17822,encounter,2.326160376812834e-05,2.9504164400654783e-05,29,11,18
17823,encountered,4.400843956132392e-06,8.79948762826546e-06,8,2,6
17824,encourage,4.002672360101368e-05,5.883578982820635e-05,61,22,39
17825,encouraged,2.954852370546031e-05,1.570104655239525e-05,26,14,12
17826,encouraging,2.5357243747239038e-05,2.9504164400654783e-05,33,15,18
17827,encroach,4.400843956132392e-06,1.8979287041356905e-06,3,2,1
17828,encrypt,2.3052039770217305e-06,3.6233184351681345e-06,3,1,2
17829,encrypted,1.6974683830796368e-05,8.79948762826546e-06,13,8,5
17830,encryption,2.954852370546031e-05,2.2602605476525032e-05,34,16,18
17831,encyclopaedia,2.095639979110664e-07,5.348708166200577e-06,3,0,3
17832,encyclopedia,4.400843956132392e-06,1.8979287041356905e-06,3,2,1
17833,end,0.0006896751171253188,0.000752442461703249,848,371,477
17834,endanger,1.6974683830796368e-05,1.742643628342769e-05,18,8,10
17835,endangered,3.7931083621902995e-05,5.883578982820635e-05,59,20,39
17836,endangering,1.0687763893464371e-05,3.6233184351681345e-06,8,6,2
17837,endeavor,2.3052039770217305e-06,5.348708166200577e-06,6,2,4
17838,ended,7.355696326678427e-05,6.228656929027126e-05,77,38,39
17839,endemic,1.48790438516857e-05,7.074097897233022e-06,13,9,4
17840,endgame,4.400843956132392e-06,3.6233184351681345e-06,5,2,3
17841,ending,7.774824322500554e-05,5.711040009717395e-05,76,39,37
17842,endles,1.0687763893464371e-05,1.570104655239525e-05,14,5,9
17843,endlessly,4.400843956132392e-06,5.348708166200577e-06,5,2,3
17844,endorse,3.3739803663681634e-05,2.6053384938589907e-05,38,16,22
17845,endorsed,2.954852370546031e-05,2.9504164400654783e-05,38,17,21
17846,endorsement,5.888748341300963e-05,2.6053384938589907e-05,48,30,18
17847,endorsing,1.0687763893464371e-05,8.79948762826546e-06,10,5,5
17848,endure,1.48790438516857e-05,7.074097897233022e-06,13,7,6
17849,endured,4.400843956132392e-06,1.3975656821362803e-05,10,2,8
17850,enduring,1.6974683830796368e-05,1.052487735929791e-05,14,8,6
17851,enemy,6.307876337123095e-05,0.0001036959228350498,100,36,64
17852,energize,4.400843956132392e-06,1.7253897310324457e-07,3,2,1
17853,energy,0.00034179888059294886,0.0002986649624417165,375,173,202
17854,enforce,2.326160376812834e-05,2.9504164400654783e-05,30,13,17
17855,enforced,1.278340387257504e-05,7.074097897233022e-06,14,8,6
17856,enforcement,9.24177230787802e-05,9.506897417988779e-05,111,49,62
17857,enforcer,2.3052039770217305e-06,3.6233184351681345e-06,3,1,2
17858,enforcing,1.278340387257504e-05,1.2250267090330355e-05,15,6,9
17859,engage,5.050492349656699e-05,6.056117955923882e-05,68,27,41
17860,engaged,5.260056347567764e-05,4.1581892517881935e-05,59,27,32
17861,engagement,3.3739803663681634e-05,2.9504164400654783e-05,37,19,18
17862,engaging,1.48790438516857e-05,2.087721574549256e-05,22,8,14
17863,engine,5.260056347567764e-05,4.330728224891437e-05,59,30,29
17864,engineer,5.4696203454788295e-05,3.985650278684949e-05,56,32,24
17865,engineered,8.592123914353715e-06,1.3975656821362803e-05,14,4,10
17866,engineering,2.326160376812834e-05,1.570104655239525e-05,21,12,9
17867,english,2.3052039770217305e-06,5.348708166200577e-06,4,1,3
17868,engulf,6.496483935243052e-06,1.7253897310324457e-07,4,4,0
17869,engulfed,8.592123914353715e-06,7.074097897233022e-06,9,4,5
17870,enhance,8.592123914353715e-06,5.348708166200577e-06,8,5,3
17871,enhanced,1.0687763893464371e-05,5.348708166200577e-06,9,5,4
17872,enjoy,4.4218003559234974e-05,4.6758061710979285e-05,53,24,29
17873,enjoyable,4.400843956132392e-06,7.074097897233022e-06,6,2,4
17874,enjoyed,2.095639979110664e-07,2.087721574549256e-05,12,0,12
17875,enjoying,8.592123914353715e-06,1.2250267090330355e-05,13,4,9
17876,enlightened,2.3052039770217305e-06,3.6233184351681345e-06,3,1,2
17877,enlist,1.278340387257504e-05,5.348708166200577e-06,10,6,4
17878,enlisted,6.496483935243052e-06,1.7253897310324457e-07,4,3,1
17879,enlisting,2.3052039770217305e-06,5.348708166200577e-06,4,1,3
17880,enormou,2.954852370546031e-05,3.2954943862719716e-05,38,18,20
17881,enormously,2.3052039770217305e-06,5.348708166200577e-06,5,2,3
17882,enough,0.0003166512008436211,0.00029521418297965093,363,171,192
17883,enraged,1.0687763893464371e-05,5.348708166200577e-06,9,5,4
17884,enrich,8.592123914353715e-06,8.79948762826546e-06,9,4,5
17885,enriched,1.48790438516857e-05,8.79948762826546e-06,12,7,5
17886,enrichment,8.592123914353715e-06,7.074097897233022e-06,9,4,5
17887,enroll,2.095639979110664e-07,1.8979287041356905e-06,3,1,2
17888,enrolled,4.400843956132392e-06,8.79948762826546e-06,7,2,5
17889,enrollee,2.3052039770217305e-06,1.8979287041356905e-06,4,2,2
17890,enrollment,1.0687763893464371e-05,7.074097897233022e-06,12,7,5
17891,enshrine,4.400843956132392e-06,5.348708166200577e-06,5,2,3
17892,enshrined,4.400843956132392e-06,1.7253897310324457e-07,3,3,0
17893,enslave,6.496483935243052e-06,1.8979287041356905e-06,4,3,1
17894,enslaved,4.400843956132392e-06,1.052487735929791e-05,8,2,6
17895,enslavement,1.0687763893464371e-05,1.8979287041356905e-06,6,5,1
17896,ensnared,4.400843956132392e-06,3.6233184351681345e-06,4,2,2
17897,ensue,1.0687763893464371e-05,3.6233184351681345e-06,7,5,2
17898,ensure,6.517440335034157e-05,0.00010714670229711469,102,34,68
17899,ensured,2.3052039770217305e-06,7.074097897233022e-06,5,1,4
17900,ensuring,1.278340387257504e-05,1.052487735929791e-05,12,6,6
17901,entail,6.496483935243052e-06,8.79948762826546e-06,8,3,5
17902,entangled,6.496483935243052e-06,1.7253897310324457e-07,3,3,0
17903,entanglement,2.095639979110664e-07,7.074097897233022e-06,4,0,4
17904,enter,0.00012385232276544028,0.00012440059960743937,144,64,80
17905,entered,7.146132328767358e-05,5.020884117304414e-05,70,38,32
17906,entering,6.72700433294523e-05,6.401195902130366e-05,76,37,39
17907,enterprise,1.9070323809907035e-05,1.570104655239525e-05,23,10,13
17908,entertaining,1.278340387257504e-05,5.348708166200577e-06,10,6,4
17909,entertainment,8.592123914353715e-06,1.570104655239525e-05,15,5,10
17910,enthusiasm,1.6974683830796368e-05,8.79948762826546e-06,14,8,6
17911,enthusiast,1.48790438516857e-05,3.6233184351681345e-06,10,7,3
17912,enthusiastic,2.095639979110664e-07,1.2250267090330355e-05,8,0,8
17913,entire,0.00016995640230587486,0.00014510527637982858,177,86,91
17914,entirely,5.888748341300963e-05,4.330728224891437e-05,57,30,27
17915,entirety,4.400843956132392e-06,3.6233184351681345e-06,4,2,2
17916,entitled,2.116596378901769e-05,2.9504164400654783e-05,28,10,18
17917,entitlement,6.496483935243052e-06,5.348708166200577e-06,6,3,3
17918,entity,2.5357243747239038e-05,1.9151826014460126e-05,24,12,12
17919,entourage,2.3052039770217305e-06,3.6233184351681345e-06,3,1,2
17920,entrance,3.1644163684570994e-05,1.3975656821362803e-05,23,15,8
17921,entrenched,4.400843956132392e-06,7.074097897233022e-06,6,2,4
17922,entrepreneur,7.565260324589493e-05,6.401195902130366e-05,76,38,38
17923,entrepreneurial,2.095639979110664e-07,1.742643628342769e-05,11,0,11
17924,entrepreneurship,1.0687763893464371e-05,1.052487735929791e-05,12,6,6
17925,entry,7.146132328767358e-05,5.711040009717395e-05,72,35,37
17926,envelope,4.400843956132392e-06,3.6233184351681345e-06,4,2,2
17927,environment,0.0001385218026192147,0.00014337988664879628,161,72,89
17928,environmental,0.00016786076232676425,0.00011922443041434203,162,84,78
17929,environmentalist,1.6974683830796368e-05,2.2602605476525032e-05,22,8,14
17930,environmentally,6.496483935243052e-06,7.074097897233022e-06,7,3,4
17931,envision,8.592123914353715e-06,3.6233184351681345e-06,7,4,3
17932,envisioned,4.400843956132392e-06,3.6233184351681345e-06,5,3,2
17933,envoy,7.146132328767358e-05,4.6758061710979285e-05,69,38,31
17934,envy,1.0687763893464371e-05,7.074097897233022e-06,10,5,5
17935,enzyme,2.3052039770217305e-06,3.6233184351681345e-06,3,1,2
17936,epic,1.9070323809907035e-05,1.570104655239525e-05,18,9,9
17937,epicenter,8.592123914353715e-06,5.348708166200577e-06,7,4,3
17938,epidemic,6.307876337123095e-05,7.263890767646595e-05,76,32,44
17939,episode,2.954852370546031e-05,2.2602605476525032e-05,28,14,14
17940,equal,5.4696203454788295e-05,7.608968713853079e-05,79,30,49
17941,equality,4.002672360101368e-05,5.3659620635109e-05,56,20,36
17942,equally,1.6974683830796368e-05,1.3975656821362803e-05,18,9,9
17943,equate,4.400843956132392e-06,5.348708166200577e-06,5,2,3
17944,equating,2.3052039770217305e-06,3.6233184351681345e-06,3,1,2
17945,equation,4.400843956132392e-06,7.074097897233022e-06,6,2,4
17946,equip,2.095639979110664e-07,5.348708166200577e-06,3,0,3
17947,equipment,5.4696203454788295e-05,5.883578982820635e-05,67,31,36
17948,equipped,8.592123914353715e-06,2.087721574549256e-05,16,4,12
17949,equitable,6.496483935243052e-06,7.074097897233022e-06,8,4,4
17950,equity,1.48790438516857e-05,8.79948762826546e-06,14,8,6
17951,equivalent,3.1644163684570994e-05,2.4327995207557487e-05,35,16,19
17952,era,8.193952318322689e-05,8.816741525575797e-05,98,42,56
17953,eradicate,1.6974683830796368e-05,8.79948762826546e-06,14,8,6
17954,eradicating,2.3052039770217305e-06,1.8979287041356905e-06,5,1,4
17955,eradication,6.496483935243052e-06,5.348708166200577e-06,6,3,3
17956,erase,1.48790438516857e-05,1.3975656821362803e-05,16,7,9
17957,erased,2.095639979110664e-07,5.348708166200577e-06,4,1,3
17958,erasing,6.496483935243052e-06,1.8979287041356905e-06,4,3,1
17959,erect,2.3052039770217305e-06,5.348708166200577e-06,4,1,3
17960,erected,8.592123914353715e-06,5.348708166200577e-06,7,4,3
17961,erode,8.592123914353715e-06,3.6233184351681345e-06,6,4,2
17962,eroding,6.496483935243052e-06,3.6233184351681345e-06,5,3,2
17963,erosion,2.3052039770217305e-06,3.6233184351681345e-06,3,1,2
17964,erratic,8.592123914353715e-06,1.8979287041356905e-06,5,4,1
17965,error,3.3739803663681634e-05,7.263890767646595e-05,60,17,43
17966,erupt,4.6313643538345614e-05,6.228656929027126e-05,60,23,37
17967,erupted,1.0687763893464371e-05,1.9151826014460126e-05,19,7,12
17968,erupting,2.3052039770217305e-06,5.348708166200577e-06,6,1,5
17969,eruption,8.592123914353715e-06,1.3975656821362803e-05,12,4,8
17970,escalate,4.212236358012434e-05,3.468033359375216e-05,41,21,20
17971,escalated,6.496483935243052e-06,1.570104655239525e-05,12,3,9
17972,escalating,2.954852370546031e-05,2.2602605476525032e-05,31,15,16
17973,escalation,1.9070323809907035e-05,1.742643628342769e-05,22,9,13
17974,escape,9.03220830996695e-05,0.0001036959228350498,113,49,64
17975,escaped,3.3739803663681634e-05,2.777877466962238e-05,38,18,20
17976,escaping,1.278340387257504e-05,1.570104655239525e-05,17,8,9
17977,escort,1.0687763893464371e-05,7.074097897233022e-06,9,5,4
17978,escorted,6.496483935243052e-06,3.6233184351681345e-06,6,3,3
17979,especially,9.451336305789087e-05,0.0001278513790695043,131,50,81
17980,espionage,3.1644163684570994e-05,2.777877466962238e-05,33,17,16
17981,espoused,4.400843956132392e-06,1.8979287041356905e-06,3,2,1
17982,essay,1.6974683830796368e-05,1.742643628342769e-05,20,9,11
17983,essence,8.592123914353715e-06,1.052487735929791e-05,10,4,6
17984,essential,4.6313643538345614e-05,6.228656929027126e-05,63,23,40
17985,essentially,2.7452883726349685e-05,1.570104655239525e-05,24,13,11
17986,establish,3.3739803663681634e-05,1.9151826014460126e-05,32,17,15
17987,established,3.7931083621902995e-05,2.9504164400654783e-05,37,18,19
17988,establishing,1.278340387257504e-05,1.052487735929791e-05,14,6,8
17989,establishment,3.583544364279237e-05,6.918812821440096e-05,64,21,43
17990,estate,5.888748341300963e-05,6.228656929027126e-05,74,29,45
17991,estimate,4.840928351745632e-05,5.711040009717395e-05,63,24,39
17992,estimated,9.451336305789087e-05,9.506897417988779e-05,110,48,62
17993,et,4.400843956132392e-06,3.6233184351681345e-06,4,2,2
17994,etc,1.48790438516857e-05,2.4327995207557487e-05,22,8,14
17995,eternal,2.3052039770217305e-06,3.6233184351681345e-06,4,1,3
17996,eternally,8.592123914353715e-06,1.7253897310324457e-07,5,4,1
17997,ethanol,2.3052039770217305e-06,5.348708166200577e-06,5,2,3
17998,ethic,4.212236358012434e-05,3.640572332478458e-05,41,20,21
17999,ethical,3.1644163684570994e-05,1.570104655239525e-05,29,17,12
18000,ethically,2.3052039770217305e-06,3.6233184351681345e-06,3,1,2
18001,ethnic,8.403516316233764e-05,6.056117955923882e-05,82,44,38
18002,ethnically,4.400843956132392e-06,1.7253897310324457e-07,4,3,1
18003,ethnicity,1.0687763893464371e-05,8.79948762826546e-06,12,7,5
18004,etho,2.3052039770217305e-06,5.348708166200577e-06,4,1,3
18005,euphemism,2.3052039770217305e-06,3.6233184351681345e-06,3,1,2
18006,euro,0.00014900000251476814,0.00013992910718673112,165,75,90
18007,eurozone,2.954852370546031e-05,2.4327995207557487e-05,34,17,17
18008,euthanasia,1.0687763893464371e-05,1.2250267090330355e-05,13,5,8
18009,euthanized,8.592123914353715e-06,5.348708166200577e-06,7,4,3
18010,evacuate,2.326160376812834e-05,2.6053384938589907e-05,27,11,16
18011,evacuated,2.5357243747239038e-05,3.122955413168725e-05,31,12,19
18012,evacuating,6.496483935243052e-06,1.052487735929791e-05,10,4,6
18013,evacuation,2.7452883726349685e-05,2.087721574549256e-05,28,14,14
18014,evacuee,2.3052039770217305e-06,1.052487735929791e-05,7,1,6
18015,evade,2.5357243747239038e-05,1.2250267090330355e-05,21,12,9
18016,evader,8.592123914353715e-06,3.6233184351681345e-06,6,4,2
18017,evading,2.3052039770217305e-06,5.348708166200577e-06,4,1,3
18018,evaluate,2.095639979110664e-07,3.6233184351681345e-06,3,1,2
18019,evaluated,2.3052039770217305e-06,8.79948762826546e-06,7,1,6
18020,evaluation,6.496483935243052e-06,3.6233184351681345e-06,7,3,4
18021,evangelical,1.0687763893464371e-05,2.777877466962238e-05,28,7,21
18022,evangelist,2.095639979110664e-07,5.348708166200577e-06,3,0,3
18023,evaporated,2.3052039770217305e-06,3.6233184351681345e-06,4,1,3
18024,evasion,2.954852370546031e-05,1.2250267090330355e-05,24,14,10
18025,eve,1.48790438516857e-05,8.79948762826546e-06,15,8,7
18026,even,0.0007839789161852989,0.0007955772049790604,937,416,521
18027,evening,0.00011756540282810809,0.00011577365095227703,142,63,79
18028,event,0.0002621645613867441,0.00026760794728313193,305,136,169
18029,eventual,8.592123914353715e-06,8.79948762826546e-06,10,4,6
18030,eventually,2.5357243747239038e-05,4.8483451442011706e-05,42,13,29
18031,ever,0.00042143319979915414,0.00039183600791746807,469,216,253
18032,evergrowing,4.400843956132392e-06,1.8979287041356905e-06,4,2,2
18033,everincreasing,2.3052039770217305e-06,5.348708166200577e-06,4,1,3
18034,every,0.0005639367183786793,0.0005488464734414206,655,300,355
18035,everybody,3.7931083621902995e-05,2.4327995207557487e-05,33,18,15
18036,everyday,2.7452883726349685e-05,2.9504164400654783e-05,36,17,19
18037,everyone,0.0001741476822640959,0.0001916907991177046,220,94,126
18038,everything,0.00016157384238943198,0.00016235917369015308,195,88,107
18039,everywhere,3.583544364279237e-05,4.330728224891437e-05,48,20,28
18040,evict,1.0687763893464371e-05,1.052487735929791e-05,12,5,7
18041,evicted,1.278340387257504e-05,2.087721574549256e-05,20,6,14
18042,eviction,1.9070323809907035e-05,1.052487735929791e-05,20,11,9
18043,evidence,0.0003438945205720597,0.00034870126464165704,395,177,218
18044,evidencebased,4.400843956132392e-06,8.79948762826546e-06,8,3,5
18045,evident,6.496483935243052e-06,1.742643628342769e-05,14,3,11
18046,evidently,4.400843956132392e-06,5.348708166200577e-06,5,2,3
18047,evil,4.4218003559234974e-05,3.640572332478458e-05,44,23,21
18048,evoke,2.3052039770217305e-06,7.074097897233022e-06,5,1,4
18049,evolution,2.116596378901769e-05,3.468033359375216e-05,33,11,22
18050,evolutionary,2.3052039770217305e-06,5.348708166200577e-06,4,1,3
18051,evolve,2.3052039770217305e-06,1.2250267090330355e-05,8,1,7
18052,evolved,4.400843956132392e-06,5.348708166200577e-06,6,3,3
18053,evolving,6.496483935243052e-06,1.052487735929791e-05,10,3,7
18054,ex,8.592123914353715e-06,1.2250267090330355e-05,11,4,7
18055,exPM,8.592123914353715e-06,1.7253897310324457e-07,4,4,0
18056,exPresident,2.095639979110664e-07,7.074097897233022e-06,4,0,4
18057,exSoviet,8.592123914353715e-06,3.6233184351681345e-06,7,4,3
18058,exacerbate,2.095639979110664e-07,8.79948762826546e-06,5,0,5
18059,exacerbated,2.095639979110664e-07,7.074097897233022e-06,4,0,4
18060,exacerbating,6.496483935243052e-06,1.7253897310324457e-07,3,3,0
18061,exact,1.6974683830796368e-05,2.4327995207557487e-05,23,9,14
18062,exactly,8.822644312055891e-05,8.4716635793693e-05,97,46,51
18063,exaggerate,8.592123914353715e-06,1.7253897310324457e-07,4,4,0
18064,exaggerated,1.9070323809907035e-05,7.074097897233022e-06,14,9,5
18065,exaggerating,4.400843956132392e-06,3.6233184351681345e-06,6,2,4
18066,exaggeration,4.400843956132392e-06,1.8979287041356905e-06,3,2,1
18067,exam,1.9070323809907035e-05,1.052487735929791e-05,20,11,9
18068,examination,6.496483935243052e-06,3.6233184351681345e-06,7,3,4
18069,examine,1.9070323809907035e-05,1.9151826014460126e-05,22,11,11
18070,examined,8.592123914353715e-06,5.348708166200577e-06,7,4,3
18071,examiner,4.400843956132392e-06,1.8979287041356905e-06,3,2,1
18072,examining,1.0687763893464371e-05,7.074097897233022e-06,10,5,5
18073,example,9.24177230787802e-05,0.00010714670229711469,114,47,67
18074,excavated,4.400843956132392e-06,5.348708166200577e-06,5,2,3
18075,excavation,4.400843956132392e-06,1.7253897310324457e-07,4,2,2
18076,exceed,3.3739803663681634e-05,1.3975656821362803e-05,27,17,10
18077,exceeded,1.0687763893464371e-05,1.2250267090330355e-05,12,5,7
18078,exceeding,6.496483935243052e-06,8.79948762826546e-06,9,3,6
18079,exceedingly,8.592123914353715e-06,1.8979287041356905e-06,5,4,1
18080,excellent,2.326160376812834e-05,2.4327995207557487e-05,26,11,15
18081,except,1.9070323809907035e-05,3.985650278684949e-05,38,11,27
18082,exception,1.0687763893464371e-05,2.6053384938589907e-05,22,6,16
18083,exceptional,8.592123914353715e-06,1.3975656821362803e-05,12,4,8
18084,exceptionally,6.496483935243052e-06,3.6233184351681345e-06,5,3,2
18085,excerpt,6.496483935243052e-06,7.074097897233022e-06,9,4,5
18086,exces,1.278340387257504e-05,8.79948762826546e-06,13,8,5
18087,excessive,3.1644163684570994e-05,3.122955413168725e-05,36,16,20
18088,excessively,4.400843956132392e-06,3.6233184351681345e-06,6,2,4
18089,exchange,0.00012385232276544028,9.679436391092026e-05,123,61,62
18090,exchanged,6.496483935243052e-06,3.6233184351681345e-06,6,4,2
18091,exchanging,4.400843956132392e-06,3.6233184351681345e-06,5,3,2
18092,excited,3.1644163684570994e-05,2.4327995207557487e-05,31,16,15
18093,excitement,1.278340387257504e-05,8.79948762826546e-06,11,6,5
18094,exciting,2.7452883726349685e-05,1.742643628342769e-05,26,14,12
18095,exclude,1.0687763893464371e-05,1.2250267090330355e-05,14,6,8
18096,excluded,6.496483935243052e-06,3.6233184351681345e-06,5,3,2
18097,excluding,2.3052039770217305e-06,7.074097897233022e-06,6,1,5
18098,exclusion,1.278340387257504e-05,1.2250267090330355e-05,15,8,7
18099,exclusive,3.3739803663681634e-05,3.122955413168725e-05,41,21,20
18100,exclusively,1.0687763893464371e-05,5.348708166200577e-06,9,5,4
18101,excommunication,8.592123914353715e-06,1.8979287041356905e-06,5,4,1
18102,excop,2.3052039770217305e-06,1.8979287041356905e-06,3,1,2
18103,excrement,2.3052039770217305e-06,7.074097897233022e-06,5,1,4
18104,excursion,2.3052039770217305e-06,5.348708166200577e-06,4,1,3
18105,excuse,3.1644163684570994e-05,4.6758061710979285e-05,46,16,30
18106,excusing,4.400843956132392e-06,1.8979287041356905e-06,3,2,1
18107,exdiplomat,6.496483935243052e-06,1.8979287041356905e-06,4,3,1
18108,exec,1.48790438516857e-05,5.348708166200577e-06,11,8,3
18109,execute,6.936568330856297e-05,6.056117955923882e-05,76,34,42
18110,executed,7.984388320411623e-05,7.781507686956326e-05,96,44,52
18111,executing,1.6974683830796368e-05,1.570104655239525e-05,19,9,10
18112,execution,9.870464301611217e-05,9.161819471782287e-05,120,55,65
18113,executioner,2.3052039770217305e-06,1.8979287041356905e-06,3,1,2
18114,executionstyle,4.400843956132392e-06,1.8979287041356905e-06,3,2,1
18115,executive,0.00022863432172097337,0.00025898099862796983,292,126,166
18116,exemplify,2.3052039770217305e-06,5.348708166200577e-06,4,1,3
18117,exempt,8.592123914353715e-06,1.2250267090330355e-05,11,4,7
18118,exempted,4.400843956132392e-06,5.348708166200577e-06,6,3,3
18119,exemption,1.6974683830796368e-05,1.3975656821362803e-05,17,8,9
18120,exercise,6.517440335034157e-05,7.781507686956326e-05,85,34,51
18121,exercised,4.400843956132392e-06,3.6233184351681345e-06,4,2,2
18122,exercising,2.3052039770217305e-06,5.348708166200577e-06,5,2,3
18123,exert,2.095639979110664e-07,3.6233184351681345e-06,3,0,3
18124,exgirlfriend,2.095639979110664e-07,1.8979287041356905e-06,3,1,2
18125,exhausted,4.400843956132392e-06,1.2250267090330355e-05,9,2,7
18126,exhaustion,2.095639979110664e-07,7.074097897233022e-06,4,0,4
18127,exhibit,1.278340387257504e-05,1.3975656821362803e-05,14,6,8
18128,exhibition,6.496483935243052e-06,1.570104655239525e-05,12,3,9
18129,exhusband,2.095639979110664e-07,5.348708166200577e-06,4,0,4
18130,exile,3.3739803663681634e-05,1.052487735929791e-05,24,17,7
18131,exiled,8.592123914353715e-06,5.348708166200577e-06,8,4,4
18132,exist,0.00011127848289077625,8.644202552472544e-05,116,57,59
18133,existed,1.278340387257504e-05,1.9151826014460126e-05,20,9,11
18134,existence,3.7931083621902995e-05,3.8131113055817005e-05,49,22,27
18135,existential,4.400843956132392e-06,8.79948762826546e-06,8,2,6
18136,existing,2.7452883726349685e-05,2.777877466962238e-05,33,15,18
18137,exit,4.212236358012434e-05,4.6758061710979285e-05,52,21,31
18138,exited,2.095639979110664e-07,5.348708166200577e-06,4,0,4
18139,exiting,2.3052039770217305e-06,3.6233184351681345e-06,3,1,2
18140,exleader,2.3052039770217305e-06,5.348708166200577e-06,5,1,4
18141,exmilitary,2.095639979110664e-07,1.8979287041356905e-06,3,1,2
18142,exminister,2.3052039770217305e-06,8.79948762826546e-06,6,1,5
18143,exodu,8.592123914353715e-06,5.348708166200577e-06,7,4,3
18144,exonerated,2.095639979110664e-07,7.074097897233022e-06,4,0,4
18145,exotic,6.496483935243052e-06,1.052487735929791e-05,10,4,6
18146,expand,4.4218003559234974e-05,8.126585633162811e-05,75,27,48
18147,expanded,2.116596378901769e-05,2.9504164400654783e-05,36,18,18
18148,expanding,4.4218003559234974e-05,2.9504164400654783e-05,45,24,21
18149,expansion,7.355696326678427e-05,5.1934230904076595e-05,69,38,31
18150,expat,1.278340387257504e-05,8.79948762826546e-06,12,6,6
18151,expect,0.0001385218026192147,0.00011404826122124471,142,71,71
18152,expectancy,1.0687763893464371e-05,1.052487735929791e-05,11,5,6
18153,expectation,3.583544364279237e-05,2.9504164400654783e-05,39,19,20
18154,expected,0.00019929536201342395,0.00027623489593829424,274,105,169
18155,expecting,1.9070323809907035e-05,1.742643628342769e-05,19,9,10
18156,expedited,2.3052039770217305e-06,5.348708166200577e-06,4,1,3
18157,expedition,8.592123914353715e-06,7.074097897233022e-06,8,4,4
18158,expel,4.002672360101368e-05,5.3659620635109e-05,54,21,33
18159,expelled,2.7452883726349685e-05,4.330728224891437e-05,41,15,26
18160,expelling,4.400843956132392e-06,3.6233184351681345e-06,4,2,2
18161,expenditure,2.3052039770217305e-06,7.074097897233022e-06,8,1,7
18162,expense,5.260056347567764e-05,7.091351794543343e-05,73,29,44
18163,expensive,5.6791843433898893e-05,6.056117955923882e-05,68,31,37
18164,experience,0.00014690436253565753,0.00017443690180738014,187,75,112
18165,experienced,3.583544364279237e-05,3.640572332478458e-05,48,22,26
18166,experiencing,1.9070323809907035e-05,2.087721574549256e-05,21,9,12
18167,experiment,6.098312339212028e-05,5.3659620635109e-05,65,33,32
18168,experimental,1.278340387257504e-05,5.348708166200577e-06,9,6,3
18169,experimenting,8.592123914353715e-06,1.7253897310324457e-07,4,4,0
18170,expert,0.00023911252161652657,0.00026243177809003493,289,123,166
18171,expertise,1.9070323809907035e-05,7.074097897233022e-06,15,9,6
18172,expiration,4.400843956132392e-06,3.6233184351681345e-06,4,2,2
18173,expire,1.6974683830796368e-05,1.3975656821362803e-05,17,8,9
18174,expired,8.592123914353715e-06,7.074097897233022e-06,9,5,4
18175,expiring,2.095639979110664e-07,7.074097897233022e-06,4,0,4
18176,explain,9.870464301611217e-05,0.0001019705331040174,122,54,68
18177,explained,3.3739803663681634e-05,2.4327995207557487e-05,30,16,14
18178,explaining,1.6974683830796368e-05,1.2250267090330355e-05,16,9,7
18179,explanation,4.002672360101368e-05,3.985650278684949e-05,48,23,25
18180,explicit,2.3052039770217305e-06,2.4327995207557487e-05,15,1,14
18181,explicitly,8.592123914353715e-06,8.79948762826546e-06,10,4,6
18182,explode,3.583544364279237e-05,3.468033359375216e-05,43,21,22
18183,exploded,4.212236358012434e-05,1.9151826014460126e-05,35,22,13
18184,exploding,1.278340387257504e-05,7.074097897233022e-06,14,9,5
18185,exploit,1.48790438516857e-05,2.2602605476525032e-05,24,8,16
18186,exploitation,2.326160376812834e-05,1.742643628342769e-05,26,11,15
18187,exploited,1.278340387257504e-05,1.570104655239525e-05,15,6,9
18188,exploiting,1.48790438516857e-05,1.570104655239525e-05,17,7,10
18189,exploration,3.3739803663681634e-05,2.2602605476525032e-05,31,16,15
18190,exploratory,4.400843956132392e-06,3.6233184351681345e-06,4,2,2
18191,explore,2.7452883726349685e-05,1.2250267090330355e-05,23,14,9
18192,explored,4.400843956132392e-06,3.6233184351681345e-06,4,2,2
18193,explorer,6.496483935243052e-06,5.348708166200577e-06,6,3,3
18194,exploring,1.0687763893464371e-05,1.2250267090330355e-05,13,6,7
18195,explosion,0.00010080028299522283,0.00010024514337298497,125,55,70
18196,explosive,6.936568330856297e-05,5.5385010366141504e-05,74,35,39
18197,expo,2.3052039770217305e-06,3.6233184351681345e-06,3,1,2
18198,export,8.193952318322689e-05,7.781507686956326e-05,91,42,49
18199,exported,6.496483935243052e-06,7.074097897233022e-06,7,3,4
18200,exporter,1.0687763893464371e-05,1.742643628342769e-05,17,6,11
18201,exporting,6.496483935243052e-06,1.3975656821362803e-05,12,3,9
18202,expose,6.517440335034157e-05,7.263890767646595e-05,80,37,43
18203,exposed,9.03220830996695e-05,6.918812821440096e-05,90,46,44
18204,exposing,3.3739803663681634e-05,2.777877466962238e-05,35,17,18
18205,exposure,1.6974683830796368e-05,2.6053384938589907e-05,27,10,17
18206,expres,5.050492349656699e-05,4.330728224891437e-05,55,26,29
18207,expresident,8.592123914353715e-06,8.79948762826546e-06,13,5,8
18208,expressed,4.4218003559234974e-05,4.330728224891437e-05,52,24,28
18209,expressing,2.116596378901769e-05,2.087721574549256e-05,23,11,12
18210,expression,6.098312339212028e-05,5.020884117304414e-05,63,30,33
18211,expressway,4.400843956132392e-06,3.6233184351681345e-06,4,2,2
18212,expulsion,1.0687763893464371e-05,1.052487735929791e-05,13,5,8
18213,exsoldier,2.3052039770217305e-06,1.8979287041356905e-06,3,2,1
18214,exspy,2.095639979110664e-07,8.79948762826546e-06,6,0,6
18215,extend,6.72700433294523e-05,4.6758061710979285e-05,65,33,32
18216,extended,4.002672360101368e-05,2.4327995207557487e-05,37,21,16
18217,extending,1.278340387257504e-05,1.9151826014460126e-05,21,9,12
18218,extension,3.583544364279237e-05,2.2602605476525032e-05,34,18,16
18219,extensive,2.116596378901769e-05,1.052487735929791e-05,17,10,7
18220,extensively,2.095639979110664e-07,5.348708166200577e-06,3,0,3
18221,extent,3.7931083621902995e-05,3.2954943862719716e-05,46,23,23
18222,exterminated,6.496483935243052e-06,1.7253897310324457e-07,3,3,0
18223,external,1.48790438516857e-05,8.79948762826546e-06,13,7,6
18224,extinct,2.954852370546031e-05,2.6053384938589907e-05,33,15,18
18225,extinction,4.840928351745632e-05,4.8483451442011706e-05,53,23,30
18226,extinguish,2.3052039770217305e-06,3.6233184351681345e-06,3,1,2
18227,extort,4.400843956132392e-06,7.074097897233022e-06,6,2,4
18228,extortion,1.0687763893464371e-05,5.348708166200577e-06,11,5,6
18229,extra,5.888748341300963e-05,5.5385010366141504e-05,67,31,36
18230,extract,4.400843956132392e-06,1.570104655239525e-05,12,3,9
18231,extracted,2.3052039770217305e-06,1.8979287041356905e-06,4,1,3
18232,extracting,6.496483935243052e-06,1.8979287041356905e-06,4,3,1
18233,extraction,4.400843956132392e-06,1.8979287041356905e-06,4,3,1
18234,extradite,1.6974683830796368e-05,1.3975656821362803e-05,18,10,8
18235,extradited,1.278340387257504e-05,2.087721574549256e-05,18,6,12
18236,extradition,5.260056347567764e-05,5.711040009717395e-05,62,28,34
18237,extrajudicial,4.400843956132392e-06,5.348708166200577e-06,5,2,3
18238,extramarital,2.3052039770217305e-06,5.348708166200577e-06,4,1,3
18239,extraordinarily,4.400843956132392e-06,7.074097897233022e-06,6,2,4
18240,extraordinary,4.6313643538345614e-05,5.020884117304414e-05,57,25,32
18241,extraterrestrial,8.592123914353715e-06,1.7253897310324457e-07,5,5,0
18242,extravagant,6.496483935243052e-06,1.7253897310324457e-07,3,3,0
18243,extreme,5.6791843433898893e-05,6.401195902130366e-05,78,34,44
18244,extremely,5.888748341300963e-05,5.3659620635109e-05,65,29,36
18245,extremism,5.888748341300963e-05,2.6053384938589907e-05,48,31,17
18246,extremist,0.00010918284291166549,0.00012094982014537423,134,56,78
18247,exwife,6.496483935243052e-06,1.7253897310324457e-07,5,4,1
18248,eye,0.00014690436253565753,0.0001278513790695043,155,72,83
18249,eyebrow,8.592123914353715e-06,5.348708166200577e-06,9,6,3
18250,eyed,2.3052039770217305e-06,3.6233184351681345e-06,3,1,2
18251,eyeing,1.48790438516857e-05,1.8979287041356905e-06,8,7,1
18252,eyeopening,6.496483935243052e-06,5.348708166200577e-06,6,3,3
18253,eyewitnes,1.0687763893464371e-05,7.074097897233022e-06,10,5,5
18254,fabric,6.496483935243052e-06,1.2250267090330355e-05,12,4,8
18255,fabricated,8.592123914353715e-06,1.3975656821362803e-05,12,4,8
18256,fabricating,2.095639979110664e-07,3.6233184351681345e-06,3,1,2
18257,fabrication,4.400843956132392e-06,5.348708166200577e-06,5,2,3
18258,facade,2.095639979110664e-07,1.052487735929791e-05,6,0,6
18259,face,0.0007609268764150817,0.0007386393438549896,882,405,477
18260,facebook,2.095639979110664e-07,1.8979287041356905e-06,4,1,3
18261,faced,6.72700433294523e-05,6.228656929027126e-05,75,35,40
18262,faceles,2.3052039770217305e-06,1.8979287041356905e-06,3,1,2
18263,faceoff,4.400843956132392e-06,1.8979287041356905e-06,4,3,1
18264,facet,2.3052039770217305e-06,3.6233184351681345e-06,3,1,2
18265,facetoface,2.095639979110664e-07,1.2250267090330355e-05,7,0,7
18266,facial,6.496483935243052e-06,7.074097897233022e-06,8,3,5
18267,facilitate,2.3052039770217305e-06,1.3975656821362803e-05,12,4,8
18268,facilitating,4.400843956132392e-06,1.8979287041356905e-06,3,2,1
18269,facility,0.00010080028299522283,9.334358444885519e-05,114,52,62
18270,facing,0.0001783389622223174,0.00018133846073150993,212,97,115
18271,fact,0.00023701688163741595,0.0002192970348142235,269,124,145
18272,factcheck,2.3052039770217305e-06,3.6233184351681345e-06,3,1,2
18273,factfree,2.3052039770217305e-06,5.348708166200577e-06,4,1,3
18274,faction,1.278340387257504e-05,1.570104655239525e-05,16,7,9
18275,facto,1.0687763893464371e-05,8.79948762826546e-06,10,5,5
18276,factor,5.4696203454788295e-05,5.883578982820635e-05,66,31,35
18277,factored,4.400843956132392e-06,1.7253897310324457e-07,3,3,0
18278,factory,0.00011966104280721883,0.00011749904068330962,141,63,78
18279,factual,6.496483935243052e-06,1.8979287041356905e-06,5,4,1
18280,fad,2.095639979110664e-07,5.348708166200577e-06,3,0,3
18281,fade,6.496483935243052e-06,7.074097897233022e-06,8,3,5
18282,fading,2.095639979110664e-07,5.348708166200577e-06,3,0,3
18283,fail,0.00015947820241032126,0.0001364783277246665,175,88,87
18284,failed,0.0002181561218254202,0.00018996540938667205,239,115,124
18285,failing,0.00010708720293255492,7.608968713853079e-05,106,57,49
18286,failure,0.00015738256243121094,0.00012094982014537423,155,79,76
18287,fainting,4.400843956132392e-06,3.6233184351681345e-06,4,2,2
18288,fair,7.774824322500554e-05,6.056117955923882e-05,86,39,47
18289,fairer,2.3052039770217305e-06,5.348708166200577e-06,4,1,3
18290,fairly,6.496483935243052e-06,2.087721574549256e-05,18,4,14
18291,fairnes,2.3052039770217305e-06,1.2250267090330355e-05,11,3,8
18292,fairy,8.592123914353715e-06,3.6233184351681345e-06,6,4,2
18293,faith,9.03220830996695e-05,7.091351794543343e-05,98,50,48
18294,faithbased,6.496483935243052e-06,1.7253897310324457e-07,3,3,0
18295,faithful,6.496483935243052e-06,5.348708166200577e-06,7,3,4
18296,fake,0.00013223488268188294,0.00012612598933847184,153,67,86
18297,faked,6.496483935243052e-06,8.79948762826546e-06,8,3,5
18298,faker,2.095639979110664e-07,3.6233184351681345e-06,3,1,2
18299,faking,2.095639979110664e-07,8.79948762826546e-06,6,0,6
18300,fall,0.0001971997220343134,0.0002313747629314509,259,107,152
18301,fallen,3.7931083621902995e-05,6.746273848336857e-05,60,20,40
18302,falling,5.6791843433898893e-05,5.5385010366141504e-05,66,32,34
18303,fallout,8.592123914353715e-06,2.2602605476525032e-05,19,4,15
18304,false,0.00010708720293255492,9.334358444885519e-05,113,55,58
18305,falsehood,1.0687763893464371e-05,1.570104655239525e-05,15,6,9
18306,falsely,2.326160376812834e-05,2.4327995207557487e-05,27,12,15
18307,falsified,4.400843956132392e-06,7.074097897233022e-06,6,2,4
18308,falsifying,2.3052039770217305e-06,3.6233184351681345e-06,3,1,2
18309,falter,4.400843956132392e-06,3.6233184351681345e-06,4,2,2
18310,faltering,6.496483935243052e-06,1.7253897310324457e-07,4,3,1
18311,fame,4.400843956132392e-06,8.79948762826546e-06,9,2,7
18312,famed,1.278340387257504e-05,1.742643628342769e-05,17,6,11
18313,familiar,4.002672360101368e-05,2.2602605476525032e-05,39,21,18
18314,family,0.0006666230773551017,0.0007696963590135735,865,355,510
18315,famine,2.116596378901769e-05,1.570104655239525e-05,22,13,9
18316,famou,6.72700433294523e-05,4.6758061710979285e-05,67,37,30
18317,famously,8.592123914353715e-06,1.052487735929791e-05,13,6,7
18318,fan,8.613080314144832e-05,7.954046660059569e-05,96,45,51
18319,fanatic,6.496483935243052e-06,1.8979287041356905e-06,5,3,2
18320,fancy,2.095639979110664e-07,5.348708166200577e-06,3,0,3
18321,fanfare,2.095639979110664e-07,5.348708166200577e-06,3,0,3
18322,fang,2.3052039770217305e-06,3.6233184351681345e-06,3,1,2
18323,fanned,4.400843956132392e-06,1.8979287041356905e-06,3,2,1
18324,fantasized,4.400843956132392e-06,1.8979287041356905e-06,3,2,1
18325,fantastic,8.592123914353715e-06,8.79948762826546e-06,9,4,5
18326,fantasy,1.278340387257504e-05,1.742643628342769e-05,18,8,10
18327,far,0.00031455556086451027,0.0003780328900692085,419,174,245
18328,farce,4.400843956132392e-06,3.6233184351681345e-06,8,4,4
18329,fare,6.496483935243052e-06,5.348708166200577e-06,7,3,4
18330,fared,4.400843956132392e-06,3.6233184351681345e-06,4,2,2
18331,farewell,4.400843956132392e-06,3.6233184351681345e-06,5,3,2
18332,farfetched,4.400843956132392e-06,3.6233184351681345e-06,5,3,2
18333,faring,4.400843956132392e-06,1.8979287041356905e-06,3,2,1
18334,farleft,2.3052039770217305e-06,8.79948762826546e-06,6,1,5
18335,farm,0.00010289592297433347,8.989280498679035e-05,114,54,60
18336,farmer,0.00012385232276544028,0.00011922443041434203,145,61,84
18337,farming,2.116596378901769e-05,3.985650278684949e-05,34,10,24
18338,farmland,8.592123914353715e-06,8.79948762826546e-06,11,6,5
18339,farreaching,1.9070323809907035e-05,1.2250267090330355e-05,17,10,7
18340,farright,6.098312339212028e-05,4.6758061710979285e-05,60,31,29
18341,fascinated,8.592123914353715e-06,1.8979287041356905e-06,5,4,1
18342,fascinating,6.496483935243052e-06,1.052487735929791e-05,11,3,8
18343,fascism,1.0687763893464371e-05,1.9151826014460126e-05,18,6,12
18344,fascist,2.5357243747239038e-05,8.79948762826546e-06,18,13,5
18345,fashion,1.48790438516857e-05,2.087721574549256e-05,22,9,13
18346,fast,8.613080314144832e-05,8.989280498679035e-05,105,47,58
18347,faster,4.4218003559234974e-05,6.573734875233614e-05,64,22,42
18348,fastest,2.116596378901769e-05,2.4327995207557487e-05,25,11,14
18349,fastestgrowing,2.3052039770217305e-06,1.2250267090330355e-05,9,1,8
18350,fastfood,1.9070323809907035e-05,8.79948762826546e-06,15,9,6
18351,fasting,2.3052039770217305e-06,1.052487735929791e-05,7,1,6
18352,fasttrack,6.496483935243052e-06,3.6233184351681345e-06,6,4,2
18353,fasttracked,4.400843956132392e-06,5.348708166200577e-06,5,2,3
18354,fat,4.002672360101368e-05,2.9504164400654783e-05,38,19,19
18355,fatal,4.840928351745632e-05,3.2954943862719716e-05,46,25,21
18356,fatality,1.6974683830796368e-05,1.570104655239525e-05,18,8,10
18357,fatally,1.48790438516857e-05,2.4327995207557487e-05,22,8,14
18358,fate,5.050492349656699e-05,5.020884117304414e-05,59,26,33
18359,father,0.00015738256243121094,0.00016926073261428268,194,84,110
18360,fathered,4.400843956132392e-06,5.348708166200577e-06,6,2,4
18361,fatigue,8.592123914353715e-06,1.052487735929791e-05,11,5,6
18362,fatty,4.400843956132392e-06,1.8979287041356905e-06,3,2,1
18363,fatwa,2.5357243747239038e-05,2.6053384938589907e-05,31,12,19
18364,fault,3.1644163684570994e-05,2.2602605476525032e-05,33,16,17
18365,faulty,4.400843956132392e-06,7.074097897233022e-06,7,3,4
18366,favor,9.870464301611217e-05,9.334358444885519e-05,115,50,65
18367,favorability,4.400843956132392e-06,3.6233184351681345e-06,4,2,2
18368,favorable,6.496483935243052e-06,7.074097897233022e-06,8,3,5
18369,favored,1.0687763893464371e-05,3.6233184351681345e-06,7,5,2
18370,favoring,4.400843956132392e-06,5.348708166200577e-06,7,3,4
18371,favorite,5.260056347567764e-05,6.228656929027126e-05,67,30,37
18372,favour,3.583544364279237e-05,3.2954943862719716e-05,40,19,21
18373,favoured,2.095639979110664e-07,3.6233184351681345e-06,3,1,2
18374,favouring,2.095639979110664e-07,3.6233184351681345e-06,3,1,2
18375,favourite,4.400843956132392e-06,3.6233184351681345e-06,4,2,2
18376,fax,2.095639979110664e-07,5.348708166200577e-06,3,0,3
18377,fazed,2.3052039770217305e-06,1.8979287041356905e-06,3,1,2
18378,fear,0.0003501814405093918,0.0003901106181864356,426,183,243
18379,feared,4.840928351745632e-05,4.8483451442011706e-05,54,24,30
18380,fearful,8.592123914353715e-06,1.3975656821362803e-05,13,4,9
18381,fearing,1.9070323809907035e-05,1.570104655239525e-05,21,10,11
18382,fearles,6.496483935243052e-06,3.6233184351681345e-06,5,3,2
18383,fearmongering,6.496483935243052e-06,1.8979287041356905e-06,4,3,1
18384,fearsome,4.400843956132392e-06,1.8979287041356905e-06,3,2,1
18385,feasible,6.496483935243052e-06,3.6233184351681345e-06,7,4,3
18386,feast,2.3052039770217305e-06,5.348708166200577e-06,4,1,3
18387,feat,8.592123914353715e-06,8.79948762826546e-06,9,4,5
18388,feather,4.400843956132392e-06,5.348708166200577e-06,7,3,4
18389,feature,4.840928351745632e-05,5.5385010366141504e-05,62,27,35
18390,featured,2.116596378901769e-05,1.3975656821362803e-05,20,11,9
18391,featuring,2.5357243747239038e-05,1.9151826014460126e-05,26,13,13
18392,fece,4.400843956132392e-06,8.79948762826546e-06,7,2,5
18393,feckles,4.400843956132392e-06,1.8979287041356905e-06,3,2,1
18394,fed,5.260056347567764e-05,3.8131113055817005e-05,56,28,28
18395,federal,0.0004151462798618222,0.0004867324431242528,516,206,310
18396,federation,6.496483935243052e-06,7.074097897233022e-06,8,3,5
18397,fee,0.00010499156295344414,7.436429740749831e-05,105,56,49
18398,feeble,6.496483935243052e-06,1.7253897310324457e-07,4,3,1
18399,feed,6.517440335034157e-05,5.711040009717395e-05,74,35,39
18400,feeding,1.6974683830796368e-05,1.570104655239525e-05,19,10,9
18401,feel,0.00023911252161652657,0.00024345249104867797,281,125,156
18402,feeling,8.193952318322689e-05,9.161819471782287e-05,102,43,59
18403,fell,5.4696203454788295e-05,5.711040009717395e-05,67,30,37
18404,fellow,7.774824322500554e-05,3.985650278684949e-05,67,40,27
18405,felon,6.496483935243052e-06,8.79948762826546e-06,11,5,6
18406,felony,1.0687763893464371e-05,2.2602605476525032e-05,19,6,13
18407,felt,7.355696326678427e-05,0.00010024514337298497,106,43,63
18408,female,0.0002349212416583052,0.00020549391696596386,262,124,138
18409,feminine,4.400843956132392e-06,5.348708166200577e-06,6,3,3
18410,feminist,1.48790438516857e-05,1.052487735929791e-05,17,7,10
18411,fence,2.5357243747239038e-05,2.6053384938589907e-05,29,13,16
18412,fencing,2.3052039770217305e-06,3.6233184351681345e-06,3,1,2
18413,fend,1.278340387257504e-05,1.2250267090330355e-05,15,7,8
18414,fending,2.3052039770217305e-06,5.348708166200577e-06,4,1,3
18415,feral,8.592123914353715e-06,1.8979287041356905e-06,6,4,2
18416,ferociou,2.3052039770217305e-06,7.074097897233022e-06,8,1,7
18417,ferry,8.592123914353715e-06,1.3975656821362803e-05,12,4,8
18418,fertile,4.400843956132392e-06,1.8979287041356905e-06,3,2,1
18419,fertility,1.48790438516857e-05,1.7253897310324457e-07,9,8,1
18420,fertilizer,4.400843956132392e-06,3.6233184351681345e-06,4,2,2
18421,fervor,2.3052039770217305e-06,3.6233184351681345e-06,3,1,2
18422,fester,2.3052039770217305e-06,3.6233184351681345e-06,3,1,2
18423,festival,3.1644163684570994e-05,2.777877466962238e-05,36,17,19
18424,festive,4.400843956132392e-06,5.348708166200577e-06,5,2,3
18425,festivity,8.592123914353715e-06,1.7253897310324457e-07,4,4,0
18426,fetal,1.0687763893464371e-05,1.2250267090330355e-05,12,5,7
18427,fetu,1.0687763893464371e-05,3.6233184351681345e-06,7,5,2
18428,feud,6.496483935243052e-06,1.3975656821362803e-05,13,3,10
18429,fever,1.278340387257504e-05,1.3975656821362803e-05,15,6,9
18430,fewer,5.4696203454788295e-05,6.228656929027126e-05,68,29,39
18431,fiance,2.3052039770217305e-06,3.6233184351681345e-06,3,1,2
18432,fiasco,6.496483935243052e-06,8.79948762826546e-06,8,3,5
18433,fiber,1.0687763893464371e-05,1.7253897310324457e-07,5,5,0
18434,fiction,1.9070323809907035e-05,1.742643628342769e-05,23,10,13
18435,fictional,6.496483935243052e-06,7.074097897233022e-06,8,4,4
18436,fiddle,4.400843956132392e-06,1.8979287041356905e-06,3,2,1
18437,fiduciary,2.3052039770217305e-06,5.348708166200577e-06,5,2,3
18438,field,0.00010708720293255492,0.0001295767688005365,136,56,80
18439,fierce,2.116596378901769e-05,2.777877466962238e-05,31,13,18
18440,fiercely,6.496483935243052e-06,5.348708166200577e-06,8,3,5
18441,fiery,8.592123914353715e-06,5.348708166200577e-06,10,6,4
18442,fifteen,2.3052039770217305e-06,8.79948762826546e-06,7,2,5
18443,fifth,3.1644163684570994e-05,3.985650278684949e-05,45,15,30
18444,fifthlargest,4.400843956132392e-06,1.8979287041356905e-06,3,2,1
18445,fifty,2.3052039770217305e-06,1.052487735929791e-05,8,1,7
18446,fig,2.3052039770217305e-06,3.6233184351681345e-06,3,1,2
18447,fight,0.0004507721595067034,0.0004608515971587659,549,245,304
18448,fighter,0.00023701688163741595,0.00021239547589009395,256,122,134
18449,fighting,0.00019929536201342395,0.0002089446964280291,254,111,143
18450,figure,0.00017205204228498542,0.0001295767688005365,175,86,89
18451,figured,1.9070323809907035e-05,1.2250267090330355e-05,20,10,10
18452,figurine,2.3052039770217305e-06,1.8979287041356905e-06,3,1,2
18453,figuring,8.592123914353715e-06,5.348708166200577e-06,9,5,4
18454,file,0.00014480872255654665,0.00013302754826260141,165,73,92
18455,filed,8.613080314144832e-05,7.263890767646595e-05,95,47,48
18456,filer,1.0687763893464371e-05,1.8979287041356905e-06,6,5,1
18457,filesharer,6.496483935243052e-06,1.8979287041356905e-06,5,4,1
18458,filesharing,4.400843956132392e-06,1.052487735929791e-05,9,3,6
18459,filibuster,2.326160376812834e-05,1.9151826014460126e-05,23,11,12
18460,filing,4.212236358012434e-05,3.985650278684949e-05,48,20,28
18461,fill,4.212236358012434e-05,5.020884117304414e-05,55,24,31
18462,filled,4.002672360101368e-05,4.50326719799468e-05,54,22,32
18463,filling,1.0687763893464371e-05,1.3975656821362803e-05,13,5,8
18464,film,0.00013013924270277222,0.00014683066611086105,164,68,96
18465,filmed,5.050492349656699e-05,3.2954943862719716e-05,51,29,22
18466,filming,2.954852370546031e-05,2.4327995207557487e-05,33,16,17
18467,filmmaker,1.6974683830796368e-05,1.742643628342769e-05,19,8,11
18468,filter,2.954852370546031e-05,2.777877466962238e-05,35,16,19
18469,filtering,1.278340387257504e-05,1.052487735929791e-05,13,6,7
18470,filthy,2.3052039770217305e-06,7.074097897233022e-06,6,1,5
18471,fin,1.6974683830796368e-05,2.4327995207557487e-05,23,9,14
18472,final,0.00012385232276544028,0.00013302754826260141,153,69,84
18473,finalist,2.3052039770217305e-06,5.348708166200577e-06,5,1,4
18474,finalize,4.400843956132392e-06,3.6233184351681345e-06,4,2,2
18475,finalized,2.3052039770217305e-06,8.79948762826546e-06,7,1,6
18476,finally,0.00014061744259832545,0.0001554576147660233,177,79,98
18477,finance,0.00014690436253565753,0.00011749904068330962,151,74,77
18478,financed,2.3052039770217305e-06,3.6233184351681345e-06,7,3,4
18479,financial,0.000385807320154273,0.00039183600791746807,463,214,249
18480,financially,8.592123914353715e-06,1.3975656821362803e-05,17,5,12
18481,financier,2.3052039770217305e-06,7.074097897233022e-06,6,1,5
18482,financing,1.0687763893464371e-05,2.777877466962238e-05,22,6,16
18483,find,0.0006771012772506551,0.00064029212918614,765,348,417
18484,finder,2.3052039770217305e-06,3.6233184351681345e-06,3,1,2
18485,finding,0.0001259479627445509,0.0001364783277246665,152,66,86
18486,fine,0.00019091280209698145,0.0001485560558418934,198,101,97
18487,fined,7.565260324589493e-05,5.883578982820635e-05,78,38,40
18488,finest,1.278340387257504e-05,7.074097897233022e-06,12,7,5
18489,finger,3.1644163684570994e-05,3.122955413168725e-05,33,15,18
18490,fingerprint,1.0687763893464371e-05,1.742643628342769e-05,16,6,10
18491,fingerprinted,4.400843956132392e-06,1.8979287041356905e-06,3,2,1
18492,finish,3.583544364279237e-05,3.985650278684949e-05,44,19,25
18493,finished,2.7452883726349685e-05,2.2602605476525032e-05,33,15,18
18494,finishing,4.400843956132392e-06,1.8979287041356905e-06,4,2,2
18495,finite,2.095639979110664e-07,1.7253897310324457e-07,3,2,1
18496,fire,0.0005744149182742325,0.0004970847815104472,635,297,338
18497,firearm,3.1644163684570994e-05,2.2602605476525032e-05,30,16,14
18498,fireball,2.3052039770217305e-06,3.6233184351681345e-06,4,1,3
18499,firebombed,2.3052039770217305e-06,8.79948762826546e-06,6,1,5
18500,firebrand,4.400843956132392e-06,1.8979287041356905e-06,3,2,1
18501,fired,0.0001531912824729893,0.0001847892401935746,203,83,120
18502,firefight,6.496483935243052e-06,5.348708166200577e-06,7,3,4
18503,firefighter,1.278340387257504e-05,1.742643628342769e-05,17,7,10
18504,fireman,4.400843956132392e-06,1.8979287041356905e-06,4,3,1
18505,firepower,2.095639979110664e-07,7.074097897233022e-06,4,0,4
18506,firestorm,6.496483935243052e-06,3.6233184351681345e-06,5,3,2
18507,firewall,6.496483935243052e-06,7.074097897233022e-06,8,4,4
18508,firewood,2.3052039770217305e-06,5.348708166200577e-06,4,1,3
18509,firework,2.5357243747239038e-05,1.570104655239525e-05,23,12,11
18510,firing,7.774824322500554e-05,7.608968713853079e-05,82,37,45
18511,firm,0.0002600689214076331,0.00026243177809003493,314,143,171
18512,firmly,6.496483935243052e-06,1.052487735929791e-05,10,3,7
18513,first,0.001511165988936698,0.0015219662817437197,1776,790,986
18514,firstever,2.116596378901769e-05,5.348708166200577e-06,15,10,5
18515,firstgeneration,2.3052039770217305e-06,5.348708166200577e-06,4,1,3
18516,firsthand,2.3052039770217305e-06,8.79948762826546e-06,6,1,5
18517,firsttime,4.400843956132392e-06,5.348708166200577e-06,5,2,3
18518,fiscal,2.7452883726349685e-05,3.2954943862719716e-05,34,13,21
18519,fiscally,4.400843956132392e-06,5.348708166200577e-06,6,3,3
18520,fish,8.613080314144832e-05,7.954046660059569e-05,95,45,50
18521,fisherman,3.7931083621902995e-05,4.6758061710979285e-05,49,21,28
18522,fishery,1.0687763893464371e-05,1.742643628342769e-05,15,5,10
18523,fishing,7.565260324589493e-05,6.918812821440096e-05,87,39,48
18524,fishy,6.496483935243052e-06,5.348708166200577e-06,6,3,3
18525,fissure,2.3052039770217305e-06,7.074097897233022e-06,5,1,4
18526,fist,6.496483935243052e-06,1.052487735929791e-05,9,3,6
18527,fit,5.4696203454788295e-05,4.6758061710979285e-05,59,29,30
18528,fitnes,1.48790438516857e-05,1.3975656821362803e-05,15,7,8
18529,fitted,6.496483935243052e-06,8.79948762826546e-06,9,4,5
18530,fitting,2.3052039770217305e-06,7.074097897233022e-06,5,1,4
18531,five,0.0004025724399871583,0.00034352509544855977,442,214,228
18532,fivestar,6.496483935243052e-06,3.6233184351681345e-06,6,3,3
18533,fiveterm,2.095639979110664e-07,3.6233184351681345e-06,3,0,3
18534,fiveyear,1.0687763893464371e-05,7.074097897233022e-06,9,5,4
18535,fiveyearold,8.592123914353715e-06,1.8979287041356905e-06,5,4,1
18536,fix,5.260056347567764e-05,7.436429740749831e-05,78,31,47
18537,fixated,2.3052039770217305e-06,3.6233184351681345e-06,4,2,2
18538,fixed,2.326160376812834e-05,1.570104655239525e-05,21,11,10
18539,fixer,4.400843956132392e-06,1.8979287041356905e-06,4,3,1
18540,fixing,1.6974683830796368e-05,1.570104655239525e-05,20,8,12
18541,fking,1.0687763893464371e-05,7.074097897233022e-06,10,5,5
18542,flag,0.0001259479627445509,0.00010714670229711469,135,61,74
18543,flagged,4.400843956132392e-06,7.074097897233022e-06,6,2,4
18544,flagging,4.400843956132392e-06,1.8979287041356905e-06,4,2,2
18545,flagship,2.3052039770217305e-06,1.052487735929791e-05,9,3,6
18546,flailing,2.3052039770217305e-06,3.6233184351681345e-06,3,1,2
18547,flame,2.116596378901769e-05,3.122955413168725e-05,33,12,21
18548,flare,1.278340387257504e-05,3.6233184351681345e-06,9,6,3
18549,flash,1.9070323809907035e-05,2.087721574549256e-05,21,9,12
18550,flashpoint,8.592123914353715e-06,7.074097897233022e-06,8,4,4
18551,flat,2.5357243747239038e-05,2.9504164400654783e-05,33,12,21
18552,flatten,6.496483935243052e-06,3.6233184351681345e-06,5,3,2
18553,flattened,8.592123914353715e-06,1.7253897310324457e-07,4,4,0
18554,flavor,4.400843956132392e-06,3.6233184351681345e-06,4,2,2
18555,flaw,1.48790438516857e-05,1.742643628342769e-05,19,7,12
18556,flawed,1.6974683830796368e-05,2.6053384938589907e-05,26,10,16
18557,flea,2.3052039770217305e-06,7.074097897233022e-06,5,1,4
18558,fled,4.212236358012434e-05,3.985650278684949e-05,52,25,27
18559,fledgling,1.0687763893464371e-05,1.7253897310324457e-07,7,5,2
18560,flee,8.822644312055891e-05,7.781507686956326e-05,103,47,56
18561,fleeing,4.002672360101368e-05,3.985650278684949e-05,50,23,27
18562,fleet,3.7931083621902995e-05,3.2954943862719716e-05,38,18,20
18563,fleeting,4.400843956132392e-06,1.8979287041356905e-06,3,2,1
18564,flesh,2.116596378901769e-05,1.8979287041356905e-06,12,11,1
18565,flew,1.9070323809907035e-05,2.4327995207557487e-05,25,11,14
18566,flex,2.095639979110664e-07,1.8979287041356905e-06,4,1,3
18567,flexibility,6.496483935243052e-06,1.2250267090330355e-05,10,3,7
18568,flexible,1.0687763893464371e-05,1.2250267090330355e-05,13,6,7
18569,flick,2.095639979110664e-07,5.348708166200577e-06,4,0,4
18570,flier,4.400843956132392e-06,1.8979287041356905e-06,3,2,1
18571,flight,0.0001741476822640959,0.00018996540938667205,204,87,117
18572,flip,1.48790438516857e-05,1.2250267090330355e-05,14,7,7
18573,flipflop,6.496483935243052e-06,1.8979287041356905e-06,5,3,2
18574,flippant,4.400843956132392e-06,1.7253897310324457e-07,3,2,1
18575,flipped,2.3052039770217305e-06,1.2250267090330355e-05,8,1,7
18576,flipping,6.496483935243052e-06,1.2250267090330355e-05,10,3,7
18577,flirting,4.400843956132392e-06,3.6233184351681345e-06,4,2,2
18578,float,1.0687763893464371e-05,1.052487735929791e-05,14,6,8
18579,floated,4.400843956132392e-06,1.8979287041356905e-06,4,2,2
18580,floating,8.592123914353715e-06,2.9504164400654783e-05,24,4,20
18581,flock,1.0687763893464371e-05,8.79948762826546e-06,10,5,5
18582,flocked,2.095639979110664e-07,5.348708166200577e-06,3,0,3
18583,flocking,6.496483935243052e-06,3.6233184351681345e-06,5,3,2
18584,flogged,4.400843956132392e-06,8.79948762826546e-06,8,3,5
18585,flogging,6.496483935243052e-06,1.052487735929791e-05,9,3,6
18586,flood,5.888748341300963e-05,8.126585633162811e-05,79,29,50
18587,flooded,1.9070323809907035e-05,2.4327995207557487e-05,23,9,14
18588,floodgate,1.0687763893464371e-05,1.8979287041356905e-06,6,5,1
18589,flooding,3.7931083621902995e-05,4.330728224891437e-05,45,19,26
18590,floor,4.6313643538345614e-05,5.5385010366141504e-05,61,24,37
18591,floral,2.3052039770217305e-06,1.8979287041356905e-06,3,1,2
18592,flotilla,5.4696203454788295e-05,4.6758061710979285e-05,65,28,37
18593,flour,2.3052039770217305e-06,3.6233184351681345e-06,3,1,2
18594,flourish,8.592123914353715e-06,3.6233184351681345e-06,6,4,2
18595,flourishing,2.3052039770217305e-06,5.348708166200577e-06,5,2,3
18596,flout,8.592123914353715e-06,1.8979287041356905e-06,5,4,1
18597,flow,2.7452883726349685e-05,3.468033359375216e-05,36,14,22
18598,flowed,2.3052039770217305e-06,5.348708166200577e-06,4,1,3
18599,flower,1.9070323809907035e-05,1.2250267090330355e-05,16,9,7
18600,flowing,1.48790438516857e-05,8.79948762826546e-06,12,7,5
18601,flown,2.326160376812834e-05,1.9151826014460126e-05,22,11,11
18602,flu,6.098312339212028e-05,5.3659620635109e-05,80,44,36
18603,flub,6.496483935243052e-06,1.8979287041356905e-06,4,3,1
18604,fluctuate,2.3052039770217305e-06,3.6233184351681345e-06,3,1,2
18605,fluent,2.095639979110664e-07,5.348708166200577e-06,3,0,3
18606,fluid,4.400843956132392e-06,1.8979287041356905e-06,5,3,2
18607,flurry,2.3052039770217305e-06,7.074097897233022e-06,5,1,4
18608,flush,2.095639979110664e-07,5.348708166200577e-06,3,0,3
18609,flushed,2.3052039770217305e-06,3.6233184351681345e-06,4,1,3
18610,fly,7.984388320411623e-05,6.746273848336857e-05,87,39,48
18611,flyer,2.3052039770217305e-06,3.6233184351681345e-06,3,1,2
18612,flying,4.4218003559234974e-05,4.330728224891437e-05,53,25,28
18613,focu,0.00011756540282810809,0.0001364783277246665,148,61,87
18614,focused,5.888748341300963e-05,5.5385010366141504e-05,69,32,37
18615,focusing,2.116596378901769e-05,3.640572332478458e-05,32,10,22
18616,fodder,6.496483935243052e-06,1.8979287041356905e-06,4,3,1
18617,foe,8.592123914353715e-06,1.2250267090330355e-05,11,4,7
18618,foetal,2.3052039770217305e-06,3.6233184351681345e-06,3,1,2
18619,foetu,4.400843956132392e-06,5.348708166200577e-06,5,2,3
18620,fog,2.3052039770217305e-06,8.79948762826546e-06,6,1,5
18621,foil,2.3052039770217305e-06,1.2250267090330355e-05,10,2,8
18622,foiled,1.278340387257504e-05,1.570104655239525e-05,16,6,10
18623,foiling,2.3052039770217305e-06,1.8979287041356905e-06,3,1,2
18624,fold,2.3052039770217305e-06,1.052487735929791e-05,7,1,6
18625,folk,6.098312339212028e-05,3.985650278684949e-05,56,30,26
18626,follow,0.00014061744259832545,0.00013130215853156914,164,80,84
18627,followed,5.260056347567764e-05,4.8483451442011706e-05,64,28,36
18628,follower,3.7931083621902995e-05,2.4327995207557487e-05,36,20,16
18629,following,0.0002684514813240757,0.00025725560889693777,304,143,161
18630,folly,6.496483935243052e-06,1.8979287041356905e-06,4,3,1
18631,foment,8.592123914353715e-06,5.348708166200577e-06,7,4,3
18632,fond,4.400843956132392e-06,1.8979287041356905e-06,4,2,2
18633,fondnes,4.400843956132392e-06,1.8979287041356905e-06,3,2,1
18634,font,2.095639979110664e-07,3.6233184351681345e-06,3,0,3
18635,food,0.0004759198392560313,0.0004435976998484416,550,259,291
18636,fool,1.0687763893464371e-05,1.2250267090330355e-05,15,5,10
18637,fooled,2.095639979110664e-07,8.79948762826546e-06,5,0,5
18638,fooling,2.095639979110664e-07,1.8979287041356905e-06,3,1,2
18639,foolish,6.496483935243052e-06,8.79948762826546e-06,11,5,6
18640,foot,8.193952318322689e-05,0.00010024514337298497,109,45,64
18641,footage,8.193952318322689e-05,0.00010024514337298497,107,43,64
18642,football,6.936568330856297e-05,4.6758061710979285e-05,69,38,31
18643,footballer,6.496483935243052e-06,5.348708166200577e-06,8,4,4
18644,foothold,4.400843956132392e-06,1.8979287041356905e-06,3,2,1
18645,footing,4.400843956132392e-06,7.074097897233022e-06,7,2,5
18646,footprint,1.0687763893464371e-05,8.79948762826546e-06,11,6,5
18647,footstep,4.400843956132392e-06,3.6233184351681345e-06,4,2,2
18648,for,6.496483935243052e-06,3.6233184351681345e-06,6,3,3
18649,forbid,1.6974683830796368e-05,1.052487735929791e-05,19,11,8
18650,forbidden,1.48790438516857e-05,1.742643628342769e-05,21,10,11
18651,forbidding,4.400843956132392e-06,3.6233184351681345e-06,4,2,2
18652,force,0.0008279873557466225,0.0008456135071790013,988,432,556
18653,forced,0.000304077360968957,0.0003090173008279106,360,158,202
18654,forcefed,4.400843956132392e-06,1.8979287041356905e-06,3,2,1
18655,forceful,6.496483935243052e-06,5.348708166200577e-06,7,4,3
18656,forcefully,2.3052039770217305e-06,1.052487735929791e-05,8,1,7
18657,forcibly,2.954852370546031e-05,1.9151826014460126e-05,28,14,14
18658,forcing,3.7931083621902995e-05,6.228656929027126e-05,57,19,38
18659,fore,4.400843956132392e-06,1.8979287041356905e-06,3,2,1
18660,forecast,3.583544364279237e-05,2.2602605476525032e-05,31,17,14
18661,forecaster,2.3052039770217305e-06,7.074097897233022e-06,5,1,4
18662,foreclosed,6.496483935243052e-06,8.79948762826546e-06,8,3,5
18663,foreclosure,1.48790438516857e-05,8.79948762826546e-06,14,8,6
18664,forefather,4.400843956132392e-06,1.8979287041356905e-06,3,2,1
18665,forefront,6.496483935243052e-06,5.348708166200577e-06,7,4,3
18666,foreign,0.00039838116002893705,0.0003642297722209491,441,211,230
18667,foreignborn,2.3052039770217305e-06,3.6233184351681345e-06,4,2,2
18668,foreigner,6.936568330856297e-05,2.777877466962238e-05,57,38,19
18669,foremost,8.592123914353715e-06,1.052487735929791e-05,13,4,9
18670,forensic,8.592123914353715e-06,1.570104655239525e-05,13,4,9
18671,foresaw,4.400843956132392e-06,1.8979287041356905e-06,3,2,1
18672,foreseeable,4.400843956132392e-06,1.8979287041356905e-06,3,2,1
18673,forest,0.0001154697628489974,0.00011232287149021227,128,59,69
18674,forestall,2.3052039770217305e-06,3.6233184351681345e-06,3,1,2
18675,forestry,6.496483935243052e-06,5.348708166200577e-06,6,3,3
18676,forever,4.002672360101368e-05,3.985650278684949e-05,46,20,26
18677,forex,4.400843956132392e-06,1.8979287041356905e-06,3,2,1
18678,forfeited,2.095639979110664e-07,5.348708166200577e-06,3,0,3
18679,forfeiture,8.592123914353715e-06,5.348708166200577e-06,7,4,3
18680,forge,1.0687763893464371e-05,1.2250267090330355e-05,13,6,7
18681,forged,1.278340387257504e-05,1.742643628342769e-05,16,6,10
18682,forget,5.888748341300963e-05,8.4716635793693e-05,87,31,56
18683,forgetting,4.400843956132392e-06,1.8979287041356905e-06,3,2,1
18684,forging,8.592123914353715e-06,1.8979287041356905e-06,5,4,1
18685,forgive,1.48790438516857e-05,1.742643628342769e-05,18,7,11
18686,forgiven,2.3052039770217305e-06,1.3975656821362803e-05,10,2,8
18687,forgivenes,8.592123914353715e-06,7.074097897233022e-06,10,4,6
18688,forgiving,4.400843956132392e-06,1.7253897310324457e-07,3,3,0
18689,forgo,2.095639979110664e-07,3.6233184351681345e-06,3,0,3
18690,forgot,1.9070323809907035e-05,1.3975656821362803e-05,21,9,12
18691,forgotten,3.3739803663681634e-05,4.6758061710979285e-05,48,18,30
18692,fork,2.095639979110664e-07,5.348708166200577e-06,3,0,3
18693,form,0.00018043460220142793,0.00017961307100047735,214,96,118
18694,formal,2.5357243747239038e-05,2.777877466962238e-05,33,14,19
18695,formally,3.583544364279237e-05,3.640572332478458e-05,40,17,23
18696,format,4.400843956132392e-06,1.2250267090330355e-05,9,2,7
18697,formation,8.592123914353715e-06,1.570104655239525e-05,14,5,9
18698,formed,8.592123914353715e-06,2.9504164400654783e-05,25,6,19
18699,former,0.0009432475545977088,0.0008956498093789422,1070,494,576
18700,formerly,6.496483935243052e-06,7.074097897233022e-06,9,4,5
18701,formidable,4.400843956132392e-06,3.6233184351681345e-06,4,2,2
18702,forming,8.592123914353715e-06,2.087721574549256e-05,16,4,12
18703,formula,8.592123914353715e-06,1.052487735929791e-05,10,4,6
18704,forprofit,1.278340387257504e-05,1.570104655239525e-05,19,6,13
18705,forth,1.0687763893464371e-05,3.6233184351681345e-06,9,5,4
18706,forthcoming,6.496483935243052e-06,5.348708166200577e-06,6,3,3
18707,fortified,8.592123914353715e-06,3.6233184351681345e-06,8,4,4
18708,fortnight,2.3052039770217305e-06,3.6233184351681345e-06,3,1,2
18709,fortunate,1.0687763893464371e-05,1.570104655239525e-05,16,6,10
18710,fortune,3.7931083621902995e-05,3.122955413168725e-05,40,21,19
18711,forty,4.400843956132392e-06,1.8979287041356905e-06,3,2,1
18712,forum,1.9070323809907035e-05,1.742643628342769e-05,20,9,11
18713,forward,0.00011756540282810809,0.0001364783277246665,150,63,87
18714,forwarded,4.400843956132392e-06,3.6233184351681345e-06,5,2,3
18715,fossil,0.00011756540282810809,9.679436391092026e-05,122,59,63
18716,fossilfuel,2.3052039770217305e-06,3.6233184351681345e-06,4,1,3
18717,fossilized,2.3052039770217305e-06,5.348708166200577e-06,4,1,3
18718,foster,1.278340387257504e-05,3.2954943862719716e-05,26,7,19
18719,fostered,2.095639979110664e-07,5.348708166200577e-06,4,1,3
18720,fostering,2.3052039770217305e-06,7.074097897233022e-06,6,1,5
18721,fought,5.260056347567764e-05,5.1934230904076595e-05,66,30,36
18722,foul,1.0687763893464371e-05,1.052487735929791e-05,13,6,7
18723,found,0.0009201955148274918,0.0009146290964202991,1079,484,595
18724,foundation,3.1644163684570994e-05,3.8131113055817005e-05,44,18,26
18725,foundational,4.400843956132392e-06,1.8979287041356905e-06,3,2,1
18726,founded,1.6974683830796368e-05,2.087721574549256e-05,24,10,14
18727,founder,0.00014900000251476814,0.00013992910718673112,174,81,93
18728,founding,1.6974683830796368e-05,1.052487735929791e-05,17,8,9
18729,fountain,4.400843956132392e-06,3.6233184351681345e-06,5,3,2
18730,four,0.0003397032406138383,0.0003245458084072032,390,176,214
18731,fourday,4.400843956132392e-06,1.8979287041356905e-06,4,2,2
18732,fourdecade,2.095639979110664e-07,8.79948762826546e-06,5,0,5
18733,fourteen,2.3052039770217305e-06,3.6233184351681345e-06,3,1,2
18734,fourth,5.260056347567764e-05,3.468033359375216e-05,50,27,23
18735,fourthlargest,4.400843956132392e-06,7.074097897233022e-06,6,2,4
18736,fouryear,6.496483935243052e-06,7.074097897233022e-06,7,3,4
18737,fouryearold,2.3052039770217305e-06,1.8979287041356905e-06,4,2,2
18738,fox,1.278340387257504e-05,8.79948762826546e-06,13,6,7
18739,fracking,4.002672360101368e-05,3.2954943862719716e-05,42,20,22
18740,fraction,1.9070323809907035e-05,1.742643628342769e-05,19,9,10
18741,fracture,2.095639979110664e-07,1.8979287041356905e-06,3,1,2
18742,fractured,6.496483935243052e-06,5.348708166200577e-06,8,3,5
18743,fracturing,2.3052039770217305e-06,1.8979287041356905e-06,3,1,2
18744,fragile,2.5357243747239038e-05,7.074097897233022e-06,18,13,5
18745,fragment,1.0687763893464371e-05,3.6233184351681345e-06,7,5,2
18746,fragmented,6.496483935243052e-06,7.074097897233022e-06,8,3,5
18747,frame,1.278340387257504e-05,1.3975656821362803e-05,15,6,9
18748,framed,6.496483935243052e-06,8.79948762826546e-06,8,3,5
18749,framework,8.592123914353715e-06,1.9151826014460126e-05,15,4,11
18750,franc,2.3052039770217305e-06,3.6233184351681345e-06,5,1,4
18751,franchise,6.496483935243052e-06,7.074097897233022e-06,7,3,4
18752,franchisee,4.400843956132392e-06,1.8979287041356905e-06,3,2,1
18753,frank,6.496483935243052e-06,1.8979287041356905e-06,5,3,2
18754,frankly,6.496483935243052e-06,1.3975656821362803e-05,14,5,9
18755,frantic,2.3052039770217305e-06,3.6233184351681345e-06,4,1,3
18756,fraud,0.00014271308257743603,0.00016753534288325053,188,78,110
18757,fraudster,6.496483935243052e-06,1.8979287041356905e-06,4,3,1
18758,fraudulent,1.9070323809907035e-05,7.074097897233022e-06,18,12,6
18759,fraught,2.095639979110664e-07,7.074097897233022e-06,4,0,4
18760,fray,4.400843956132392e-06,7.074097897233022e-06,6,2,4
18761,freak,2.3052039770217305e-06,1.570104655239525e-05,11,2,9
18762,freaking,1.0687763893464371e-05,1.8979287041356905e-06,8,6,2
18763,free,0.00041095499990360083,0.00044014692038637674,496,213,283
18764,freed,6.517440335034157e-05,6.401195902130366e-05,79,36,43
18765,freedom,0.0002621645613867441,0.00023482554239351563,287,137,150
18766,freefall,6.496483935243052e-06,5.348708166200577e-06,6,3,3
18767,freeing,1.0687763893464371e-05,7.074097897233022e-06,9,5,4
18768,freelance,2.3052039770217305e-06,8.79948762826546e-06,7,1,6
18769,freelancer,8.592123914353715e-06,1.7253897310324457e-07,4,4,0
18770,freely,1.9070323809907035e-05,1.052487735929791e-05,15,9,6
18771,freespeech,4.400843956132392e-06,7.074097897233022e-06,7,2,5
18772,freestyle,2.3052039770217305e-06,1.8979287041356905e-06,3,1,2
18773,freetrade,6.496483935243052e-06,3.6233184351681345e-06,5,3,2
18774,freeway,8.592123914353715e-06,1.7253897310324457e-07,5,5,0
18775,freeze,3.1644163684570994e-05,4.1581892517881935e-05,48,18,30
18776,freezing,1.278340387257504e-05,1.742643628342769e-05,17,7,10
18777,freight,6.496483935243052e-06,5.348708166200577e-06,6,3,3
18778,freighter,8.592123914353715e-06,5.348708166200577e-06,8,4,4
18779,french,2.095639979110664e-07,5.348708166200577e-06,3,0,3
18780,frenzy,4.400843956132392e-06,1.052487735929791e-05,11,3,8
18781,frequency,4.400843956132392e-06,1.8979287041356905e-06,3,2,1
18782,frequent,1.0687763893464371e-05,2.4327995207557487e-05,21,7,14
18783,frequented,4.400843956132392e-06,3.6233184351681345e-06,4,2,2
18784,frequently,1.48790438516857e-05,2.087721574549256e-05,20,8,12
18785,fresh,7.355696326678427e-05,6.746273848336857e-05,77,36,41
18786,freshly,6.496483935243052e-06,1.8979287041356905e-06,4,3,1
18787,freshman,4.400843956132392e-06,8.79948762826546e-06,7,2,5
18788,freshwater,8.592123914353715e-06,3.6233184351681345e-06,7,5,2
18789,friction,4.400843956132392e-06,1.8979287041356905e-06,3,2,1
18790,fridge,4.400843956132392e-06,3.6233184351681345e-06,4,2,2
18791,friend,0.0001971997220343134,0.0002382763218555804,251,104,147
18792,friendlines,4.400843956132392e-06,1.8979287041356905e-06,3,2,1
18793,friendly,2.116596378901769e-05,2.777877466962238e-05,32,14,18
18794,friendship,1.48790438516857e-05,1.052487735929791e-05,15,7,8
18795,frightened,6.496483935243052e-06,1.052487735929791e-05,10,3,7
18796,frightening,8.592123914353715e-06,5.348708166200577e-06,8,5,3
18797,frigid,4.400843956132392e-06,1.7253897310324457e-07,3,2,1
18798,fringe,1.278340387257504e-05,3.6233184351681345e-06,9,7,2
18799,frivolou,6.496483935243052e-06,1.8979287041356905e-06,4,3,1
18800,frog,1.278340387257504e-05,3.6233184351681345e-06,8,6,2
18801,front,0.00012175668278632962,0.00012612598933847184,145,65,80
18802,frontier,6.496483935243052e-06,8.79948762826546e-06,9,4,5
18803,frontline,8.592123914353715e-06,1.570104655239525e-05,13,4,9
18804,frontpage,2.3052039770217305e-06,7.074097897233022e-06,7,2,5
18805,frontrunner,6.936568330856297e-05,4.330728224891437e-05,67,36,31
18806,frowned,2.3052039770217305e-06,3.6233184351681345e-06,3,1,2
18807,frozen,2.954852370546031e-05,4.50326719799468e-05,42,16,26
18808,frugal,2.095639979110664e-07,3.6233184351681345e-06,3,0,3
18809,fruit,3.1644163684570994e-05,1.9151826014460126e-05,27,15,12
18810,frustrated,2.326160376812834e-05,2.777877466962238e-05,30,13,17
18811,frustrating,1.0687763893464371e-05,3.6233184351681345e-06,8,6,2
18812,frustration,3.3739803663681634e-05,1.742643628342769e-05,27,16,11
18813,fry,6.496483935243052e-06,1.8979287041356905e-06,5,3,2
18814,ft,4.400843956132392e-06,1.2250267090330355e-05,12,2,10
18815,fuck,1.0687763893464371e-05,8.79948762826546e-06,13,7,6
18816,fucked,4.400843956132392e-06,8.79948762826546e-06,7,2,5
18817,fucker,4.400843956132392e-06,1.8979287041356905e-06,3,2,1
18818,fucking,1.6974683830796368e-05,1.2250267090330355e-05,15,8,7
18819,fuel,0.00022863432172097337,0.0002089446964280291,247,113,134
18820,fueled,2.116596378901769e-05,1.2250267090330355e-05,18,11,7
18821,fueling,1.9070323809907035e-05,1.3975656821362803e-05,20,10,10
18822,fuelled,6.496483935243052e-06,3.6233184351681345e-06,5,3,2
18823,fuelling,4.400843956132392e-06,1.2250267090330355e-05,10,3,7
18824,fugitive,1.0687763893464371e-05,2.6053384938589907e-05,24,6,18
18825,fulfil,4.400843956132392e-06,1.8979287041356905e-06,3,2,1
18826,fulfill,1.48790438516857e-05,1.3975656821362803e-05,17,7,10
18827,fulfilled,2.3052039770217305e-06,3.6233184351681345e-06,3,1,2
18828,fulfilling,2.095639979110664e-07,1.2250267090330355e-05,7,0,7
18829,fulfillment,6.496483935243052e-06,3.6233184351681345e-06,7,4,3
18830,full,0.0002349212416583052,0.00022792398346938586,271,118,153
18831,fullblown,4.400843956132392e-06,7.074097897233022e-06,6,2,4
18832,fullface,2.3052039770217305e-06,1.8979287041356905e-06,5,2,3
18833,fullscale,4.400843956132392e-06,1.8979287041356905e-06,3,2,1
18834,fulltime,6.496483935243052e-06,1.742643628342769e-05,15,5,10
18835,fully,7.355696326678427e-05,8.4716635793693e-05,91,38,53
18836,fume,6.496483935243052e-06,3.6233184351681345e-06,5,3,2
18837,fun,5.4696203454788295e-05,5.5385010366141504e-05,63,29,34
18838,function,1.278340387257504e-05,2.6053384938589907e-05,23,8,15
18839,functional,4.400843956132392e-06,1.7253897310324457e-07,3,2,1
18840,functionary,2.3052039770217305e-06,3.6233184351681345e-06,3,1,2
18841,functioning,1.278340387257504e-05,5.348708166200577e-06,9,6,3
18842,fund,0.00024330380157474795,0.00023655093212454826,277,125,152
18843,fundamental,5.4696203454788295e-05,6.401195902130366e-05,64,26,38
18844,fundamentalism,4.400843956132392e-06,1.8979287041356905e-06,3,2,1
18845,fundamentalist,2.326160376812834e-05,2.087721574549256e-05,24,12,12
18846,fundamentally,2.116596378901769e-05,1.742643628342769e-05,22,12,10
18847,funded,2.7452883726349685e-05,2.9504164400654783e-05,35,17,18
18848,funder,4.400843956132392e-06,7.074097897233022e-06,6,2,4
18849,funding,0.00015109564249387862,0.0002141208656211263,209,77,132
18850,fundraiser,1.48790438516857e-05,1.3975656821362803e-05,17,7,10
18851,fundraising,1.9070323809907035e-05,2.9504164400654783e-05,27,9,18
18852,funeral,4.6313643538345614e-05,3.8131113055817005e-05,45,22,23
18853,fungu,4.400843956132392e-06,3.6233184351681345e-06,5,2,3
18854,funnel,4.400843956132392e-06,3.6233184351681345e-06,4,2,2
18855,funny,1.6974683830796368e-05,1.2250267090330355e-05,17,9,8
18856,fur,2.095639979110664e-07,8.79948762826546e-06,7,1,6
18857,furiou,1.9070323809907035e-05,2.6053384938589907e-05,25,9,16
18858,furloughed,2.095639979110664e-07,5.348708166200577e-06,3,0,3
18859,furniture,8.592123914353715e-06,1.570104655239525e-05,14,4,10
18860,furor,4.400843956132392e-06,8.79948762826546e-06,9,2,7
18861,fury,1.6974683830796368e-05,2.4327995207557487e-05,25,9,16
18862,fus,6.496483935243052e-06,1.7253897310324457e-07,3,3,0
18863,fuse,4.400843956132392e-06,1.8979287041356905e-06,3,2,1
18864,fusion,1.0687763893464371e-05,8.79948762826546e-06,12,5,7
18865,futile,4.400843956132392e-06,3.6233184351681345e-06,4,2,2
18866,future,0.0003501814405093918,0.00036595516195198134,419,188,231
18867,futuristic,6.496483935243052e-06,1.8979287041356905e-06,4,3,1
18868,fuzzy,4.400843956132392e-06,1.8979287041356905e-06,4,3,1
18869,ga,0.00031455556086451027,0.000302115741903781,360,166,194
18870,gadget,1.0687763893464371e-05,5.348708166200577e-06,9,5,4
18871,gaffe,1.278340387257504e-05,5.348708166200577e-06,11,6,5
18872,gag,2.5357243747239038e-05,7.074097897233022e-06,19,14,5
18873,gagged,2.095639979110664e-07,5.348708166200577e-06,6,2,4
18874,gain,0.00011337412286988677,9.851975364195259e-05,119,57,62
18875,gained,1.48790438516857e-05,1.570104655239525e-05,18,8,10
18876,gaining,2.116596378901769e-05,3.2954943862719716e-05,33,12,21
18877,galaxy,3.7931083621902995e-05,1.3975656821362803e-05,27,19,8
18878,gallery,1.48790438516857e-05,7.074097897233022e-06,13,9,4
18879,gallon,2.116596378901769e-05,1.052487735929791e-05,18,10,8
18880,gallows,4.400843956132392e-06,3.6233184351681345e-06,4,2,2
18881,gamble,2.3052039770217305e-06,7.074097897233022e-06,5,1,4
18882,gambler,2.3052039770217305e-06,1.8979287041356905e-06,3,1,2
18883,gambling,1.278340387257504e-05,1.570104655239525e-05,18,7,11
18884,game,0.00020348664197164515,0.00017788768126944505,217,105,112
18885,gamechanger,2.3052039770217305e-06,5.348708166200577e-06,4,1,3
18886,gamer,8.592123914353715e-06,7.074097897233022e-06,9,5,4
18887,gaming,2.3052039770217305e-06,1.2250267090330355e-05,8,1,7
18888,gang,0.00014900000251476814,0.0001295767688005365,157,74,83
18889,gangland,6.496483935243052e-06,1.7253897310324457e-07,3,3,0
18890,gangrape,1.9070323809907035e-05,2.087721574549256e-05,22,9,13
18891,gangraped,3.3739803663681634e-05,2.4327995207557487e-05,32,17,15
18892,gangster,8.592123914353715e-06,5.348708166200577e-06,7,4,3
18893,gap,5.4696203454788295e-05,8.126585633162811e-05,80,31,49
18894,garage,8.592123914353715e-06,7.074097897233022e-06,10,6,4
18895,garbage,1.9070323809907035e-05,2.6053384938589907e-05,26,10,16
18896,garden,1.9070323809907035e-05,1.9151826014460126e-05,20,9,11
18897,gargantuan,2.3052039770217305e-06,5.348708166200577e-06,4,1,3
18898,garlic,4.400843956132392e-06,1.8979287041356905e-06,4,2,2
18899,garment,1.6974683830796368e-05,1.3975656821362803e-05,17,8,9
18900,garnered,4.400843956132392e-06,7.074097897233022e-06,6,2,4
18901,gasoline,1.0687763893464371e-05,1.570104655239525e-05,14,5,9
18902,gasp,2.095639979110664e-07,3.6233184351681345e-06,3,1,2
18903,gate,1.0687763893464371e-05,2.2602605476525032e-05,19,5,14
18904,gateway,4.400843956132392e-06,5.348708166200577e-06,5,2,3
18905,gather,2.954852370546031e-05,4.50326719799468e-05,44,14,30
18906,gathered,4.840928351745632e-05,7.436429740749831e-05,72,26,46
18907,gathering,6.098312339212028e-05,5.020884117304414e-05,64,32,32
18908,gauge,8.592123914353715e-06,1.7253897310324457e-07,6,5,1
18909,gave,0.00015738256243121094,0.00017098612234531542,191,85,106
18910,gavel,4.400843956132392e-06,1.8979287041356905e-06,3,2,1
18911,gay,0.0002747384012614078,0.00034870126464165704,374,149,225
18912,gayfriendly,2.3052039770217305e-06,3.6233184351681345e-06,3,1,2
18913,gaza,4.400843956132392e-06,1.7253897310324457e-07,3,3,0
18914,gear,2.5357243747239038e-05,1.9151826014460126e-05,26,13,13
18915,geared,2.3052039770217305e-06,1.7253897310324457e-07,3,3,0
18916,gearing,4.400843956132392e-06,1.2250267090330355e-05,9,2,7
18917,geek,4.400843956132392e-06,1.8979287041356905e-06,3,2,1
18918,gem,8.592123914353715e-06,1.2250267090330355e-05,14,6,8
18919,gender,7.146132328767358e-05,9.506897417988779e-05,98,35,63
18920,genderbased,2.3052039770217305e-06,3.6233184351681345e-06,3,1,2
18921,genderneutral,4.400843956132392e-06,5.348708166200577e-06,6,3,3
18922,gene,2.5357243747239038e-05,2.4327995207557487e-05,32,13,19
18923,general,0.0003229381207809529,0.0002900380137865542,368,165,203
18924,generally,2.5357243747239038e-05,2.6053384938589907e-05,31,14,17
18925,generate,2.5357243747239038e-05,3.640572332478458e-05,35,13,22
18926,generated,1.0687763893464371e-05,2.2602605476525032e-05,20,6,14
18927,generating,6.496483935243052e-06,5.348708166200577e-06,8,3,5
18928,generation,0.00014061744259832545,0.0001364783277246665,155,74,81
18929,generator,4.400843956132392e-06,1.8979287041356905e-06,4,2,2
18930,generic,1.0687763893464371e-05,1.052487735929791e-05,15,7,8
18931,generosity,4.400843956132392e-06,7.074097897233022e-06,6,2,4
18932,generou,1.0687763893464371e-05,1.742643628342769e-05,16,5,11
18933,generously,4.400843956132392e-06,1.7253897310324457e-07,4,4,0
18934,genetic,1.48790438516857e-05,3.468033359375216e-05,30,8,22
18935,genetically,2.7452883726349685e-05,2.087721574549256e-05,28,13,15
18936,geneticallymodified,2.095639979110664e-07,5.348708166200577e-06,3,0,3
18937,genital,4.002672360101368e-05,3.985650278684949e-05,49,21,28
18938,geniu,6.496483935243052e-06,1.570104655239525e-05,13,3,10
18939,genocidal,4.400843956132392e-06,5.348708166200577e-06,5,2,3
18940,genocide,0.00010918284291166549,0.00011922443041434203,129,55,74
18941,genome,6.496483935243052e-06,1.570104655239525e-05,12,3,9
18942,genre,2.3052039770217305e-06,1.8979287041356905e-06,4,1,3
18943,gentle,2.3052039770217305e-06,5.348708166200577e-06,5,1,4
18944,gentleman,2.3052039770217305e-06,1.8979287041356905e-06,5,3,2
18945,genu,2.095639979110664e-07,3.6233184351681345e-06,3,0,3
18946,genuine,2.326160376812834e-05,1.3975656821362803e-05,20,11,9
18947,genuinely,6.496483935243052e-06,3.6233184351681345e-06,6,3,3
18948,geoengineering,2.3052039770217305e-06,7.074097897233022e-06,5,1,4
18949,geography,8.592123914353715e-06,3.6233184351681345e-06,8,5,3
18950,geologist,2.3052039770217305e-06,8.79948762826546e-06,6,1,5
18951,geopolitic,2.3052039770217305e-06,3.6233184351681345e-06,4,1,3
18952,geopolitical,8.592123914353715e-06,1.052487735929791e-05,10,4,6
18953,geothermal,2.3052039770217305e-06,3.6233184351681345e-06,3,1,2
18954,germ,2.3052039770217305e-06,3.6233184351681345e-06,4,2,2
18955,german,8.592123914353715e-06,8.79948762826546e-06,9,4,5
18956,gerrymander,2.095639979110664e-07,5.348708166200577e-06,3,0,3
18957,gerrymandered,4.400843956132392e-06,7.074097897233022e-06,6,2,4
18958,gerrymandering,1.278340387257504e-05,7.074097897233022e-06,11,7,4
18959,gesture,1.0687763893464371e-05,2.087721574549256e-05,20,8,12
18960,get,0.0014566793494798218,0.0013459765291784103,1642,760,882
18961,getting,0.0003438945205720597,0.00035387743383475447,408,182,226
18962,ghetto,2.3052039770217305e-06,5.348708166200577e-06,4,1,3
18963,ghost,2.7452883726349685e-05,1.742643628342769e-05,26,14,12
18964,giant,0.00022234740178364096,0.0002141208656211263,264,120,144
18965,gift,9.870464301611217e-05,5.5385010366141504e-05,93,55,38
18966,gifted,6.496483935243052e-06,1.8979287041356905e-06,4,3,1
18967,gig,6.496483935243052e-06,1.052487735929791e-05,9,3,6
18968,gigabyte,4.400843956132392e-06,1.8979287041356905e-06,3,2,1
18969,gigantic,2.095639979110664e-07,8.79948762826546e-06,5,0,5
18970,gigawatt,6.496483935243052e-06,8.79948762826546e-06,8,3,5
18971,gilded,2.3052039770217305e-06,5.348708166200577e-06,4,1,3
18972,gimmick,4.400843956132392e-06,3.6233184351681345e-06,5,3,2
18973,gin,2.095639979110664e-07,3.6233184351681345e-06,3,0,3
18974,ginger,4.400843956132392e-06,7.074097897233022e-06,6,2,4
18975,girl,0.0004947805990680274,0.0005419449145172909,608,258,350
18976,girlfriend,2.5357243747239038e-05,1.742643628342769e-05,24,13,11
18977,give,0.0006016582380026713,0.0005919812167172319,708,314,394
18978,giveaway,8.592123914353715e-06,1.8979287041356905e-06,5,4,1
18979,given,0.00023701688163741595,0.00022619859373835345,278,128,150
18980,giver,2.3052039770217305e-06,3.6233184351681345e-06,4,2,2
18981,giving,0.00019510408205520246,0.0001951415785797695,221,102,119
18982,glacier,2.326160376812834e-05,2.2602605476525032e-05,27,11,16
18983,glad,2.3052039770217305e-06,8.79948762826546e-06,6,1,5
18984,glas,2.954852370546031e-05,2.4327995207557487e-05,31,15,16
18985,glimpse,1.9070323809907035e-05,1.9151826014460126e-05,23,9,14
18986,glitch,1.0687763893464371e-05,7.074097897233022e-06,9,5,4
18987,global,0.0004884936791306954,0.0005160640685518042,593,261,332
18988,globalisation,4.400843956132392e-06,1.8979287041356905e-06,3,2,1
18989,globalization,6.496483935243052e-06,1.7253897310324457e-07,3,3,0
18990,globalized,4.400843956132392e-06,1.8979287041356905e-06,3,2,1
18991,globally,1.0687763893464371e-05,1.742643628342769e-05,18,5,13
18992,globe,4.212236358012434e-05,3.8131113055817005e-05,47,22,25
18993,gloom,6.496483935243052e-06,1.8979287041356905e-06,4,3,1
18994,gloomy,6.496483935243052e-06,1.7253897310324457e-07,4,4,0
18995,gloriou,4.400843956132392e-06,1.8979287041356905e-06,3,2,1
18996,glory,6.496483935243052e-06,3.6233184351681345e-06,5,3,2
18997,glove,4.400843956132392e-06,1.8979287041356905e-06,6,5,1
18998,glow,4.400843956132392e-06,1.8979287041356905e-06,4,2,2
18999,glut,6.496483935243052e-06,3.6233184351681345e-06,6,4,2
19000,glyphosate,4.400843956132392e-06,1.8979287041356905e-06,3,2,1
19001,go,0.0007923614761017417,0.0007558932411653141,909,414,495
19002,goahead,6.496483935243052e-06,8.79948762826546e-06,8,3,5
19003,goal,0.00012804360272366158,0.00012094982014537423,153,77,76
19004,goat,8.592123914353715e-06,1.2250267090330355e-05,11,4,7
19005,god,2.116596378901769e-05,2.087721574549256e-05,22,10,12
19006,godfather,4.400843956132392e-06,3.6233184351681345e-06,4,2,2
19007,goer,4.400843956132392e-06,1.8979287041356905e-06,3,2,1
19008,going,0.0005681279983369005,0.0006333905702620106,704,300,404
19009,gold,0.0001259479627445509,0.00010542131256608228,138,72,66
19010,golden,1.6974683830796368e-05,1.3975656821362803e-05,18,9,9
19011,golf,2.954852370546031e-05,4.330728224891437e-05,40,15,25
19012,gone,0.00012804360272366158,0.00013992910718673112,158,72,86
19013,gonna,2.954852370546031e-05,2.087721574549256e-05,35,21,14
19014,gonorrhoea,2.3052039770217305e-06,7.074097897233022e-06,5,1,4
19015,good,0.0005639367183786793,0.0005522972529034856,667,302,365
19016,goodbye,1.6974683830796368e-05,8.79948762826546e-06,14,9,5
19017,goodnes,4.400843956132392e-06,5.348708166200577e-06,6,2,4
19018,goodwill,6.496483935243052e-06,3.6233184351681345e-06,6,3,3
19019,goody,4.400843956132392e-06,3.6233184351681345e-06,4,2,2
19020,google,1.0687763893464371e-05,1.052487735929791e-05,14,7,7
19021,gore,4.400843956132392e-06,1.8979287041356905e-06,3,2,1
19022,gored,2.3052039770217305e-06,1.8979287041356905e-06,3,1,2
19023,gorgeou,4.400843956132392e-06,3.6233184351681345e-06,4,2,2
19024,gorilla,1.9070323809907035e-05,1.052487735929791e-05,15,9,6
19025,got,0.00029988608101073563,0.0003055665213658457,356,158,198
19026,goto,2.3052039770217305e-06,3.6233184351681345e-06,3,1,2
19027,gotta,6.496483935243052e-06,1.052487735929791e-05,9,3,6
19028,gotten,3.3739803663681634e-05,2.777877466962238e-05,37,18,19
19029,gov,8.592123914353715e-06,5.348708166200577e-06,8,4,4
19030,goverment,6.496483935243052e-06,5.348708166200577e-06,7,4,3
19031,govern,8.592123914353715e-06,1.2250267090330355e-05,14,5,9
19032,governance,2.954852370546031e-05,1.570104655239525e-05,27,16,11
19033,governed,6.496483935243052e-06,5.348708166200577e-06,7,3,4
19034,governing,1.6974683830796368e-05,2.087721574549256e-05,22,9,13
19035,government,0.001982684984236597,0.0019188059198811816,2303,1052,1251
19036,governmental,2.3052039770217305e-06,8.79948762826546e-06,6,1,5
19037,governmentbacked,4.400843956132392e-06,1.8979287041356905e-06,3,2,1
19038,governmentcontrolled,4.400843956132392e-06,3.6233184351681345e-06,4,2,2
19039,governmentrun,2.3052039770217305e-06,3.6233184351681345e-06,4,2,2
19040,governmentsponsored,2.3052039770217305e-06,3.6233184351681345e-06,4,1,3
19041,governor,0.00020767792192986646,0.0002089446964280291,248,114,134
19042,govt,0.00014480872255654665,0.0001295767688005365,168,79,89
19043,gra,4.400843956132392e-06,1.8979287041356905e-06,4,3,1
19044,grab,3.7931083621902995e-05,3.122955413168725e-05,40,19,21
19045,grabbed,1.9070323809907035e-05,1.3975656821362803e-05,18,9,9
19046,grabbing,1.48790438516857e-05,5.348708166200577e-06,10,7,3
19047,grace,6.496483935243052e-06,8.79948762826546e-06,11,3,8
19048,graciously,2.3052039770217305e-06,1.8979287041356905e-06,3,1,2
19049,grad,4.400843956132392e-06,8.79948762826546e-06,7,2,5
19050,grade,1.9070323809907035e-05,2.2602605476525032e-05,27,10,17
19051,gradual,2.3052039770217305e-06,5.348708166200577e-06,4,1,3
19052,gradually,6.496483935243052e-06,5.348708166200577e-06,8,4,4
19053,graduate,2.954852370546031e-05,3.640572332478458e-05,43,15,28
19054,graduated,2.3052039770217305e-06,7.074097897233022e-06,6,2,4
19055,graduating,2.095639979110664e-07,8.79948762826546e-06,5,0,5
19056,graduation,4.400843956132392e-06,7.074097897233022e-06,7,2,5
19057,graf,2.954852370546031e-05,1.9151826014460126e-05,29,15,14
19058,graffiti,2.5357243747239038e-05,1.9151826014460126e-05,28,13,15
19059,graft,1.0687763893464371e-05,1.052487735929791e-05,11,5,6
19060,grain,2.5357243747239038e-05,1.3975656821362803e-05,22,14,8
19061,gram,1.0687763893464371e-05,7.074097897233022e-06,9,5,4
19062,grand,3.3739803663681634e-05,3.468033359375216e-05,41,16,25
19063,grandchild,6.496483935243052e-06,1.052487735929791e-05,10,3,7
19064,granddaughter,4.400843956132392e-06,5.348708166200577e-06,5,2,3
19065,grandfather,1.6974683830796368e-05,1.052487735929791e-05,15,8,7
19066,grandkid,4.400843956132392e-06,3.6233184351681345e-06,4,2,2
19067,grandma,8.592123914353715e-06,3.6233184351681345e-06,6,4,2
19068,grandmother,1.278340387257504e-05,1.570104655239525e-05,20,8,12
19069,grandparent,2.3052039770217305e-06,1.052487735929791e-05,9,3,6
19070,grandson,8.592123914353715e-06,8.79948762826546e-06,10,5,5
19071,grandstanding,4.400843956132392e-06,1.8979287041356905e-06,4,2,2
19072,granite,2.3052039770217305e-06,5.348708166200577e-06,4,1,3
19073,grant,5.6791843433898893e-05,7.781507686956326e-05,80,31,49
19074,granted,6.098312339212028e-05,7.091351794543343e-05,77,29,48
19075,grantee,2.095639979110664e-07,5.348708166200577e-06,3,0,3
19076,granting,1.48790438516857e-05,2.2602605476525032e-05,23,8,15
19077,grape,2.3052039770217305e-06,1.8979287041356905e-06,3,2,1
19078,graph,6.496483935243052e-06,7.074097897233022e-06,9,5,4
19079,graphic,3.3739803663681634e-05,2.777877466962238e-05,36,17,19
19080,grapple,2.3052039770217305e-06,3.6233184351681345e-06,3,1,2
19081,grappled,4.400843956132392e-06,1.8979287041356905e-06,3,2,1
19082,grappling,2.3052039770217305e-06,7.074097897233022e-06,5,1,4
19083,gras,1.278340387257504e-05,7.074097897233022e-06,12,6,6
19084,grasp,1.0687763893464371e-05,1.3975656821362803e-05,13,5,8
19085,grasping,4.400843956132392e-06,1.8979287041356905e-06,3,2,1
19086,grassroot,1.9070323809907035e-05,2.4327995207557487e-05,24,9,15
19087,grateful,1.278340387257504e-05,1.9151826014460126e-05,19,6,13
19088,gratitude,1.0687763893464371e-05,8.79948762826546e-06,10,5,5
19089,grave,4.840928351745632e-05,6.918812821440096e-05,67,24,43
19090,gravely,1.0687763893464371e-05,5.348708166200577e-06,8,5,3
19091,graveyard,1.0687763893464371e-05,3.6233184351681345e-06,7,5,2
19092,gravity,8.592123914353715e-06,5.348708166200577e-06,7,4,3
19093,gray,4.400843956132392e-06,7.074097897233022e-06,6,2,4
19094,great,0.0002684514813240757,0.0002831364548624239,326,142,184
19095,greater,0.00010289592297433347,0.00011404826122124471,128,56,72
19096,greatest,7.565260324589493e-05,6.228656929027126e-05,81,40,41
19097,greatly,1.0687763893464371e-05,2.2602605476525032e-05,23,8,15
19098,greatnes,1.0687763893464371e-05,3.6233184351681345e-06,7,5,2
19099,greed,6.496483935243052e-06,7.074097897233022e-06,11,4,7
19100,greedy,6.496483935243052e-06,1.3975656821362803e-05,11,3,8
19101,green,8.403516316233764e-05,8.126585633162811e-05,94,44,50
19102,greener,2.3052039770217305e-06,7.074097897233022e-06,6,1,5
19103,greenery,4.400843956132392e-06,1.7253897310324457e-07,3,2,1
19104,greenhouse,4.002672360101368e-05,2.2602605476525032e-05,37,20,17
19105,greet,6.496483935243052e-06,7.074097897233022e-06,8,3,5
19106,greeted,1.0687763893464371e-05,8.79948762826546e-06,10,5,5
19107,greeting,2.3052039770217305e-06,7.074097897233022e-06,5,1,4
19108,grenade,2.954852370546031e-05,2.777877466962238e-05,34,17,17
19109,grew,2.7452883726349685e-05,3.2954943862719716e-05,38,16,22
19110,grey,4.400843956132392e-06,3.6233184351681345e-06,4,2,2
19111,grid,2.5357243747239038e-05,1.742643628342769e-05,24,12,12
19112,gridlock,4.400843956132392e-06,1.7253897310324457e-07,3,2,1
19113,gridlocked,2.095639979110664e-07,3.6233184351681345e-06,3,0,3
19114,grief,1.0687763893464371e-05,1.9151826014460126e-05,19,6,13
19115,grievance,4.400843956132392e-06,8.79948762826546e-06,7,2,5
19116,grieve,2.3052039770217305e-06,3.6233184351681345e-06,3,1,2
19117,grieving,4.400843956132392e-06,7.074097897233022e-06,6,2,4
19118,grill,4.400843956132392e-06,1.8979287041356905e-06,3,2,1
19119,grilled,2.095639979110664e-07,5.348708166200577e-06,4,1,3
19120,grilling,4.400843956132392e-06,1.052487735929791e-05,10,4,6
19121,grim,1.6974683830796368e-05,1.570104655239525e-05,21,9,12
19122,grind,8.592123914353715e-06,8.79948762826546e-06,9,4,5
19123,grip,1.6974683830796368e-05,3.122955413168725e-05,30,11,19
19124,gripe,4.400843956132392e-06,1.8979287041356905e-06,3,2,1
19125,gripped,6.496483935243052e-06,1.8979287041356905e-06,7,3,4
19126,grisly,2.3052039770217305e-06,8.79948762826546e-06,6,1,5
19127,grizzly,2.3052039770217305e-06,3.6233184351681345e-06,4,2,2
19128,grocery,1.0687763893464371e-05,2.2602605476525032e-05,21,7,14
19129,groom,2.3052039770217305e-06,1.052487735929791e-05,8,1,7
19130,grooming,4.400843956132392e-06,1.052487735929791e-05,9,2,7
19131,groove,2.095639979110664e-07,7.074097897233022e-06,4,0,4
19132,groped,6.496483935243052e-06,3.6233184351681345e-06,5,3,2
19133,groping,8.592123914353715e-06,8.79948762826546e-06,9,4,5
19134,gros,2.116596378901769e-05,2.087721574549256e-05,24,11,13
19135,grossly,6.496483935243052e-06,8.79948762826546e-06,8,3,5
19136,grotesque,4.400843956132392e-06,3.6233184351681345e-06,5,2,3
19137,ground,0.0002181561218254202,0.00018133846073150993,232,115,117
19138,groundbreaking,6.496483935243052e-06,1.3975656821362803e-05,12,3,9
19139,grounded,1.48790438516857e-05,3.6233184351681345e-06,11,8,3
19140,groundwater,1.6974683830796368e-05,5.348708166200577e-06,12,8,4
19141,groundwork,6.496483935243052e-06,5.348708166200577e-06,6,3,3
19142,group,0.0010103080339292502,0.0010336809878615377,1196,532,664
19143,grove,6.496483935243052e-06,1.8979287041356905e-06,4,3,1
19144,grow,0.00014271308257743603,0.0001520068353039585,169,78,91
19145,grower,8.592123914353715e-06,7.074097897233022e-06,9,5,4
19146,growing,0.0002537820014703013,0.0002503540499728076,300,138,162
19147,grown,4.002672360101368e-05,2.6053384938589907e-05,42,22,20
19148,growth,0.00010918284291166549,0.0001520068353039585,158,63,95
19149,grueling,4.400843956132392e-06,3.6233184351681345e-06,4,2,2
19150,gruesome,1.0687763893464371e-05,1.9151826014460126e-05,17,6,11
19151,gt,8.592123914353715e-06,3.6233184351681345e-06,6,4,2
19152,guarantee,4.002672360101368e-05,2.9504164400654783e-05,42,24,18
19153,guaranteed,1.278340387257504e-05,7.074097897233022e-06,11,7,4
19154,guaranteeing,4.400843956132392e-06,3.6233184351681345e-06,5,2,3
19155,guard,0.00012385232276544028,0.0001019705331040174,126,59,67
19156,guarded,6.496483935243052e-06,3.6233184351681345e-06,6,3,3
19157,guardian,1.278340387257504e-05,1.2250267090330355e-05,14,6,8
19158,guardiancouk,1.48790438516857e-05,1.2250267090330355e-05,15,7,8
19159,guarding,2.3052039770217305e-06,5.348708166200577e-06,4,1,3
19160,gubernatorial,1.0687763893464371e-05,1.052487735929791e-05,16,6,10
19161,guerrilla,2.095639979110664e-07,1.052487735929791e-05,7,1,6
19162,gues,2.954852370546031e-05,3.122955413168725e-05,36,15,21
19163,guessed,2.3052039770217305e-06,3.6233184351681345e-06,4,1,3
19164,guessing,2.3052039770217305e-06,7.074097897233022e-06,5,1,4
19165,guest,2.116596378901769e-05,3.122955413168725e-05,34,13,21
19166,guidance,6.496483935243052e-06,1.570104655239525e-05,17,5,12
19167,guide,4.4218003559234974e-05,4.8483451442011706e-05,53,23,30
19168,guided,8.592123914353715e-06,8.79948762826546e-06,10,4,6
19169,guideline,1.278340387257504e-05,2.777877466962238e-05,26,7,19
19170,guiding,6.496483935243052e-06,3.6233184351681345e-06,5,3,2
19171,guilt,1.0687763893464371e-05,7.074097897233022e-06,12,5,7
19172,guilty,0.00016576512234765329,0.00019341618884873702,210,86,124
19173,guinea,2.095639979110664e-07,7.074097897233022e-06,5,1,4
19174,guise,1.48790438516857e-05,1.052487735929791e-05,14,7,7
19175,guitarist,4.400843956132392e-06,3.6233184351681345e-06,4,2,2
19176,gulag,4.400843956132392e-06,5.348708166200577e-06,5,2,3
19177,gum,2.3052039770217305e-06,3.6233184351681345e-06,4,1,3
19178,gun,0.00036694656034227697,0.00035560282356578675,434,207,227
19179,gunfire,2.116596378901769e-05,2.2602605476525032e-05,23,10,13
19180,gunman,0.00010918284291166549,9.161819471782287e-05,119,57,62
19181,gunned,1.48790438516857e-05,2.6053384938589907e-05,22,7,15
19182,gunpoint,8.592123914353715e-06,8.79948762826546e-06,9,4,5
19183,gunrelated,4.400843956132392e-06,1.7253897310324457e-07,3,3,0
19184,gunship,2.3052039770217305e-06,3.6233184351681345e-06,3,1,2
19185,gunshot,1.0687763893464371e-05,1.052487735929791e-05,12,5,7
19186,guru,8.592123914353715e-06,7.074097897233022e-06,8,4,4
19187,gushed,2.3052039770217305e-06,3.6233184351681345e-06,3,1,2
19188,gushing,4.400843956132392e-06,1.8979287041356905e-06,4,2,2
19189,gut,2.7452883726349685e-05,1.3975656821362803e-05,23,14,9
19190,gutted,6.496483935243052e-06,3.6233184351681345e-06,5,3,2
19191,guy,0.00014061744259832545,0.00012267520987640663,150,76,74
19192,gym,1.278340387257504e-05,5.348708166200577e-06,9,6,3
19193,gymnast,2.3052039770217305e-06,8.79948762826546e-06,6,1,5
19194,gypsy,6.496483935243052e-06,1.7253897310324457e-07,3,3,0
19195,ha,4.400843956132392e-06,3.6233184351681345e-06,5,2,3
19196,habit,3.583544364279237e-05,3.122955413168725e-05,39,19,20
19197,habitable,2.3052039770217305e-06,3.6233184351681345e-06,5,2,3
19198,habitat,1.9070323809907035e-05,1.570104655239525e-05,21,11,10
19199,hack,7.146132328767358e-05,4.6758061710979285e-05,67,36,31
19200,hacked,0.00010080028299522283,5.883578982820635e-05,89,50,39
19201,hacker,9.03220830996695e-05,8.126585633162811e-05,94,44,50
19202,hacking,0.0001552869224521,7.954046660059569e-05,130,80,50
19203,hacktivist,2.3052039770217305e-06,5.348708166200577e-06,7,2,5
19204,hadn,4.400843956132392e-06,3.6233184351681345e-06,6,2,4
19205,hail,2.954852370546031e-05,2.6053384938589907e-05,31,14,17
19206,hailed,1.9070323809907035e-05,2.087721574549256e-05,28,13,15
19207,hailing,2.3052039770217305e-06,3.6233184351681345e-06,3,1,2
19208,hair,3.3739803663681634e-05,2.777877466962238e-05,34,17,17
19209,haircut,2.3052039770217305e-06,3.6233184351681345e-06,4,1,3
19210,hairdresser,6.496483935243052e-06,5.348708166200577e-06,6,3,3
19211,hajj,2.3052039770217305e-06,5.348708166200577e-06,4,1,3
19212,halal,4.400843956132392e-06,3.6233184351681345e-06,4,2,2
19213,half,0.00029779044103162505,0.0002469032705107427,306,151,155
19214,halfcentury,4.400843956132392e-06,7.074097897233022e-06,6,2,4
19215,halfdozen,4.400843956132392e-06,1.8979287041356905e-06,3,2,1
19216,halfway,2.3052039770217305e-06,5.348708166200577e-06,4,1,3
19217,hall,2.5357243747239038e-05,4.8483451442011706e-05,42,13,29
19218,hallmark,8.592123914353715e-06,5.348708166200577e-06,8,5,3
19219,halt,0.0001154697628489974,8.4716635793693e-05,111,60,51
19220,halted,2.116596378901769e-05,3.640572332478458e-05,35,12,23
19221,halting,1.48790438516857e-05,3.6233184351681345e-06,10,8,2
19222,halve,4.400843956132392e-06,3.6233184351681345e-06,5,3,2
19223,halved,1.0687763893464371e-05,8.79948762826546e-06,11,6,5
19224,ham,2.3052039770217305e-06,3.6233184351681345e-06,3,1,2
19225,hamburger,4.400843956132392e-06,5.348708166200577e-06,6,3,3
19226,hammer,6.496483935243052e-06,7.074097897233022e-06,7,3,4
19227,hammered,6.496483935243052e-06,5.348708166200577e-06,7,3,4
19228,hamper,4.400843956132392e-06,5.348708166200577e-06,5,2,3
19229,hampered,6.496483935243052e-06,5.348708166200577e-06,6,3,3
19230,hamstring,2.095639979110664e-07,5.348708166200577e-06,3,0,3
19231,hand,0.00028521660115696105,0.0002900380137865542,339,148,191
19232,handbag,2.095639979110664e-07,5.348708166200577e-06,3,0,3
19233,handbook,2.3052039770217305e-06,1.8979287041356905e-06,3,1,2
19234,handcuff,2.3052039770217305e-06,1.052487735929791e-05,8,1,7
19235,handcuffed,8.592123914353715e-06,8.79948762826546e-06,14,6,8
19236,handed,5.260056347567764e-05,6.056117955923882e-05,63,27,36
19237,handful,2.326160376812834e-05,1.9151826014460126e-05,26,12,14
19238,handgun,6.496483935243052e-06,1.052487735929791e-05,9,3,6
19239,handicapped,8.592123914353715e-06,1.7253897310324457e-07,4,4,0
19240,handily,4.400843956132392e-06,3.6233184351681345e-06,5,2,3
19241,handing,1.6974683830796368e-05,2.4327995207557487e-05,26,9,17
19242,handinhand,2.3052039770217305e-06,5.348708166200577e-06,4,1,3
19243,handle,2.7452883726349685e-05,4.1581892517881935e-05,43,15,28
19244,handled,8.592123914353715e-06,1.570104655239525e-05,14,4,10
19245,handler,2.095639979110664e-07,3.6233184351681345e-06,3,0,3
19246,handling,3.1644163684570994e-05,2.6053384938589907e-05,33,17,16
19247,handout,1.48790438516857e-05,1.052487735929791e-05,14,7,7
19248,handover,4.400843956132392e-06,1.8979287041356905e-06,3,2,1
19249,handshake,6.496483935243052e-06,7.074097897233022e-06,9,4,5
19250,handsome,4.400843956132392e-06,1.8979287041356905e-06,3,2,1
19251,handson,4.400843956132392e-06,1.8979287041356905e-06,4,3,1
19252,handwritten,4.400843956132392e-06,1.8979287041356905e-06,3,2,1
19253,handy,6.496483935243052e-06,3.6233184351681345e-06,5,3,2
19254,hang,2.954852370546031e-05,3.122955413168725e-05,35,17,18
19255,hanged,1.9070323809907035e-05,2.6053384938589907e-05,27,12,15
19256,hanging,3.583544364279237e-05,3.468033359375216e-05,42,20,22
19257,hangover,2.095639979110664e-07,7.074097897233022e-06,4,0,4
19258,happen,0.0002055822819507562,0.00022102242454525643,250,110,140
19259,happened,0.00013642616264010403,0.00012440059960743937,152,70,82
19260,happening,8.193952318322689e-05,7.263890767646595e-05,88,41,47
19261,happier,8.592123914353715e-06,5.348708166200577e-06,8,4,4
19262,happiest,4.400843956132392e-06,1.052487735929791e-05,11,2,9
19263,happily,4.400843956132392e-06,5.348708166200577e-06,5,2,3
19264,happines,1.9070323809907035e-05,3.468033359375216e-05,32,10,22
19265,happy,8.403516316233764e-05,8.816741525575797e-05,102,48,54
19266,haras,6.496483935243052e-06,5.348708166200577e-06,7,3,4
19267,harassed,2.5357243747239038e-05,1.742643628342769e-05,23,12,11
19268,harasser,2.3052039770217305e-06,5.348708166200577e-06,4,1,3
19269,harassing,1.48790438516857e-05,1.2250267090330355e-05,15,7,8
19270,harassment,8.613080314144832e-05,7.436429740749831e-05,94,45,49
19271,harbinger,2.3052039770217305e-06,7.074097897233022e-06,5,1,4
19272,harbor,2.095639979110664e-07,1.8979287041356905e-06,4,0,4
19273,harboring,2.3052039770217305e-06,3.6233184351681345e-06,3,1,2
19274,hard,0.00020767792192986646,0.0002538048294348729,281,117,164
19275,hardcore,2.3052039770217305e-06,3.6233184351681345e-06,5,2,3
19276,hardearned,8.592123914353715e-06,5.348708166200577e-06,7,4,3
19277,harden,4.400843956132392e-06,1.8979287041356905e-06,3,2,1
19278,harder,4.4218003559234974e-05,5.5385010366141504e-05,60,21,39
19279,hardest,1.6974683830796368e-05,1.3975656821362803e-05,18,8,10
19280,hardesthit,4.400843956132392e-06,1.8979287041356905e-06,3,2,1
19281,hardline,2.5357243747239038e-05,1.2250267090330355e-05,21,14,7
19282,hardliner,1.278340387257504e-05,1.570104655239525e-05,16,6,10
19283,hardly,1.6974683830796368e-05,1.742643628342769e-05,19,9,10
19284,hardship,8.592123914353715e-06,7.074097897233022e-06,11,5,6
19285,hardware,6.496483935243052e-06,7.074097897233022e-06,8,4,4
19286,hardwon,2.3052039770217305e-06,3.6233184351681345e-06,4,1,3
19287,hardworking,8.592123914353715e-06,1.8979287041356905e-06,8,5,3
19288,harm,9.24177230787802e-05,6.918812821440096e-05,91,47,44
19289,harmed,8.592123914353715e-06,1.3975656821362803e-05,13,4,9
19290,harmful,1.9070323809907035e-05,2.777877466962238e-05,28,10,18
19291,harming,1.48790438516857e-05,1.2250267090330355e-05,15,7,8
19292,harmles,8.592123914353715e-06,1.8979287041356905e-06,5,4,1
19293,harmoniou,6.496483935243052e-06,1.8979287041356905e-06,4,3,1
19294,harmony,6.496483935243052e-06,5.348708166200577e-06,6,3,3
19295,harmreduction,2.3052039770217305e-06,1.8979287041356905e-06,3,1,2
19296,harnes,4.400843956132392e-06,1.052487735929791e-05,9,2,7
19297,harnessing,6.496483935243052e-06,1.8979287041356905e-06,5,4,1
19298,harp,6.496483935243052e-06,1.7253897310324457e-07,3,3,0
19299,harrowing,1.278340387257504e-05,7.074097897233022e-06,11,6,5
19300,harsh,4.840928351745632e-05,3.640572332478458e-05,51,26,25
19301,harsher,6.496483935243052e-06,1.8979287041356905e-06,4,3,1
19302,harshest,4.400843956132392e-06,5.348708166200577e-06,6,3,3
19303,harshly,2.3052039770217305e-06,8.79948762826546e-06,6,1,5
19304,harvest,1.9070323809907035e-05,2.9504164400654783e-05,28,10,18
19305,harvested,1.278340387257504e-05,1.8979287041356905e-06,7,6,1
19306,harvesting,2.116596378901769e-05,1.2250267090330355e-05,18,10,8
19307,hash,4.400843956132392e-06,5.348708166200577e-06,5,2,3
19308,hashish,2.3052039770217305e-06,3.6233184351681345e-06,3,1,2
19309,hashtag,6.496483935243052e-06,1.742643628342769e-05,15,3,12
19310,hasn,1.6974683830796368e-05,1.9151826014460126e-05,23,10,13
19311,hassle,2.3052039770217305e-06,3.6233184351681345e-06,3,1,2
19312,hastily,4.400843956132392e-06,1.8979287041356905e-06,3,2,1
19313,hasty,1.0687763893464371e-05,1.8979287041356905e-06,6,5,1
19314,hat,6.496483935243052e-06,1.9151826014460126e-05,16,4,12
19315,hatch,4.400843956132392e-06,1.8979287041356905e-06,3,2,1
19316,hatched,6.496483935243052e-06,1.7253897310324457e-07,3,3,0
19317,hatching,2.3052039770217305e-06,1.8979287041356905e-06,3,1,2
19318,hate,0.0001385218026192147,0.0001347529379936339,162,71,91
19319,hated,1.48790438516857e-05,1.052487735929791e-05,14,7,7
19320,hatefilled,2.3052039770217305e-06,3.6233184351681345e-06,4,2,2
19321,hateful,4.400843956132392e-06,5.348708166200577e-06,9,5,4
19322,hater,2.3052039770217305e-06,7.074097897233022e-06,5,1,4
19323,hating,2.095639979110664e-07,5.348708166200577e-06,3,0,3
19324,hatred,3.1644163684570994e-05,3.2954943862719716e-05,40,16,24
19325,haul,2.116596378901769e-05,2.4327995207557487e-05,26,12,14
19326,hauled,2.095639979110664e-07,1.8979287041356905e-06,3,0,3
19327,haunt,8.592123914353715e-06,1.3975656821362803e-05,18,7,11
19328,haunted,8.592123914353715e-06,3.6233184351681345e-06,8,5,3
19329,haunting,4.400843956132392e-06,7.074097897233022e-06,6,2,4
19330,have,6.496483935243052e-06,7.074097897233022e-06,8,3,5
19331,haven,3.7931083621902995e-05,3.2954943862719716e-05,44,20,24
19332,havenot,4.400843956132392e-06,7.074097897233022e-06,7,2,5
19333,havoc,8.592123914353715e-06,1.052487735929791e-05,13,5,8
19334,hawk,4.400843956132392e-06,1.052487735929791e-05,10,3,7
19335,hawkish,6.496483935243052e-06,3.6233184351681345e-06,5,3,2
19336,hazard,2.3052039770217305e-06,1.3975656821362803e-05,12,1,11
19337,hazardou,1.48790438516857e-05,1.3975656821362803e-05,16,8,8
19338,haze,6.496483935243052e-06,5.348708166200577e-06,6,3,3
19339,he,0.0003019817209898466,0.0003055665213658457,357,162,195
19340,head,0.0003837116801751621,0.000379758279800241,446,201,245
19341,headache,2.5357243747239038e-05,5.348708166200577e-06,15,12,3
19342,headed,6.307876337123095e-05,4.330728224891437e-05,60,31,29
19343,heading,4.4218003559234974e-05,4.50326719799468e-05,54,24,30
19344,headles,4.400843956132392e-06,3.6233184351681345e-06,4,2,2
19345,headline,3.7931083621902995e-05,6.228656929027126e-05,59,20,39
19346,headon,8.592123914353715e-06,3.6233184351681345e-06,6,4,2
19347,headphone,6.496483935243052e-06,1.8979287041356905e-06,4,3,1
19348,headquarters,4.840928351745632e-05,4.6758061710979285e-05,61,28,33
19349,headscarf,2.326160376812834e-05,1.2250267090330355e-05,20,12,8
19350,heal,8.592123914353715e-06,1.9151826014460126e-05,16,4,12
19351,healed,6.496483935243052e-06,1.7253897310324457e-07,4,3,1
19352,healer,2.3052039770217305e-06,7.074097897233022e-06,6,1,5
19353,healing,1.48790438516857e-05,7.074097897233022e-06,14,8,6
19354,health,0.0005974669580444496,0.0006661729751516271,750,310,440
19355,healthcare,6.517440335034157e-05,6.056117955923882e-05,74,37,37
19356,healthier,6.496483935243052e-06,1.2250267090330355e-05,10,3,7
19357,healthiest,2.3052039770217305e-06,1.8979287041356905e-06,3,2,1
19358,healthy,6.936568330856297e-05,5.883578982820635e-05,80,38,42
19359,heap,4.400843956132392e-06,1.7253897310324457e-07,3,2,1
19360,heaping,2.3052039770217305e-06,1.8979287041356905e-06,3,2,1
19361,hear,0.00013013924270277222,0.0001036959228350498,136,68,68
19362,heard,0.00015109564249387862,0.0001571830044970555,176,78,98
19363,hearing,0.00014061744259832545,0.00015028144557292604,176,77,99
19364,heart,0.00016366948236854273,0.0001571830044970555,184,84,100
19365,heartbeat,4.400843956132392e-06,1.2250267090330355e-05,9,2,7
19366,heartbreaking,4.400843956132392e-06,8.79948762826546e-06,8,2,6
19367,heartbroken,6.496483935243052e-06,3.6233184351681345e-06,6,3,3
19368,heartfelt,2.095639979110664e-07,5.348708166200577e-06,3,0,3
19369,heartland,2.095639979110664e-07,8.79948762826546e-06,5,0,5
19370,heartwarming,2.3052039770217305e-06,3.6233184351681345e-06,5,3,2
19371,heat,7.146132328767358e-05,6.573734875233614e-05,79,37,42
19372,heated,2.5357243747239038e-05,2.4327995207557487e-05,27,12,15
19373,heating,1.48790438516857e-05,8.79948762826546e-06,12,7,5
19374,heatstroke,6.496483935243052e-06,1.8979287041356905e-06,4,3,1
19375,heatwave,2.954852370546031e-05,1.3975656821362803e-05,22,14,8
19376,heaven,6.496483935243052e-06,1.2250267090330355e-05,10,3,7
19377,heavier,4.400843956132392e-06,1.8979287041356905e-06,4,2,2
19378,heaviest,6.496483935243052e-06,7.074097897233022e-06,7,3,4
19379,heavily,4.6313643538345614e-05,4.1581892517881935e-05,49,22,27
19380,heavy,8.403516316233764e-05,8.299124606266055e-05,96,44,52
19381,heavyhanded,2.3052039770217305e-06,5.348708166200577e-06,4,1,3
19382,heavyweight,8.592123914353715e-06,3.6233184351681345e-06,6,4,2
19383,heckled,6.496483935243052e-06,3.6233184351681345e-06,5,3,2
19384,hectare,1.48790438516857e-05,1.742643628342769e-05,18,7,11
19385,hedge,8.592123914353715e-06,2.2602605476525032e-05,18,4,14
19386,heed,1.0687763893464371e-05,1.8979287041356905e-06,7,6,1
19387,heel,1.0687763893464371e-05,8.79948762826546e-06,10,5,5
19388,hefty,2.3052039770217305e-06,7.074097897233022e-06,7,2,5
19389,height,1.9070323809907035e-05,2.777877466962238e-05,27,9,18
19390,heighten,4.400843956132392e-06,1.8979287041356905e-06,3,2,1
19391,heightened,1.6974683830796368e-05,1.2250267090330355e-05,15,8,7
19392,heinou,6.496483935243052e-06,1.8979287041356905e-06,4,3,1
19393,heir,1.278340387257504e-05,1.742643628342769e-05,17,7,10
19394,heires,2.3052039770217305e-06,3.6233184351681345e-06,3,1,2
19395,heist,1.48790438516857e-05,1.3975656821362803e-05,15,7,8
19396,held,0.000304077360968957,0.0002382763218555804,309,157,152
19397,helicopter,7.146132328767358e-05,6.918812821440096e-05,82,35,47
19398,helium,2.3052039770217305e-06,3.6233184351681345e-06,3,1,2
19399,hell,0.00011337412286988677,9.334358444885519e-05,118,57,61
19400,helmet,1.6974683830796368e-05,8.79948762826546e-06,13,8,5
19401,help,0.00104174263361591,0.0009094529272272013,1154,550,604
19402,helped,0.0001741476822640959,0.00018306385046254245,211,95,116
19403,helper,6.496483935243052e-06,1.8979287041356905e-06,5,3,2
19404,helpful,2.326160376812834e-05,1.742643628342769e-05,23,12,11
19405,helping,0.00014480872255654665,0.00017788768126944505,185,76,109
19406,helples,2.3052039770217305e-06,7.074097897233022e-06,5,1,4
19407,hemisphere,2.3052039770217305e-06,7.074097897233022e-06,5,1,4
19408,hemp,8.592123914353715e-06,3.6233184351681345e-06,6,4,2
19409,henge,2.3052039770217305e-06,3.6233184351681345e-06,3,1,2
19410,her,6.496483935243052e-06,3.6233184351681345e-06,5,3,2
19411,herald,6.496483935243052e-06,7.074097897233022e-06,7,3,4
19412,heralded,2.3052039770217305e-06,3.6233184351681345e-06,3,1,2
19413,heralding,2.095639979110664e-07,5.348708166200577e-06,3,0,3
19414,herb,2.3052039770217305e-06,3.6233184351681345e-06,3,1,2
19415,herbal,8.592123914353715e-06,3.6233184351681345e-06,6,4,2
19416,herbicide,6.496483935243052e-06,5.348708166200577e-06,7,4,3
19417,herd,6.496483935243052e-06,1.570104655239525e-05,12,3,9
19418,here,3.583544364279237e-05,4.1581892517881935e-05,46,19,27
19419,heresy,8.592123914353715e-06,1.7253897310324457e-07,4,4,0
19420,heritage,3.583544364279237e-05,3.2954943862719716e-05,39,19,20
19421,hero,7.146132328767358e-05,6.746273848336857e-05,83,40,43
19422,heroic,8.592123914353715e-06,8.79948762826546e-06,12,5,7
19423,heroin,3.7931083621902995e-05,4.6758061710979285e-05,51,20,31
19424,heroine,4.400843956132392e-06,7.074097897233022e-06,6,2,4
19425,heroism,4.400843956132392e-06,3.6233184351681345e-06,4,2,2
19426,hesitate,2.095639979110664e-07,3.6233184351681345e-06,3,1,2
19427,heterosexual,1.0687763893464371e-05,3.6233184351681345e-06,8,5,3
19428,hey,4.400843956132392e-06,1.052487735929791e-05,8,2,6
19429,hiatus,2.3052039770217305e-06,3.6233184351681345e-06,3,1,2
19430,hibernate,2.3052039770217305e-06,1.8979287041356905e-06,3,1,2
19431,hid,2.5357243747239038e-05,1.742643628342769e-05,23,13,10
19432,hidden,7.565260324589493e-05,6.918812821440096e-05,78,36,42
19433,hide,6.72700433294523e-05,5.883578982820635e-05,75,33,42
19434,hideout,4.400843956132392e-06,1.8979287041356905e-06,5,3,2
19435,hiding,4.6313643538345614e-05,5.020884117304414e-05,63,29,34
19436,hierarchy,6.496483935243052e-06,1.8979287041356905e-06,4,3,1
19437,high,0.00036904220032138744,0.0003901106181864356,445,196,249
19438,highcapacity,2.3052039770217305e-06,1.8979287041356905e-06,3,1,2
19439,highend,4.400843956132392e-06,3.6233184351681345e-06,4,2,2
19440,higher,0.0001259479627445509,0.0001571830044970555,169,68,101
19441,highest,0.00014271308257743603,0.00012440059960743937,155,75,80
19442,highestlevel,4.400843956132392e-06,3.6233184351681345e-06,4,2,2
19443,highestranking,4.400843956132392e-06,8.79948762826546e-06,7,2,5
19444,highimpact,2.3052039770217305e-06,1.8979287041356905e-06,3,2,1
19445,highlevel,1.6974683830796368e-05,2.4327995207557487e-05,23,9,14
19446,highlight,5.4696203454788295e-05,3.8131113055817005e-05,52,26,26
19447,highlighted,1.278340387257504e-05,1.570104655239525e-05,15,6,9
19448,highlighting,1.9070323809907035e-05,1.3975656821362803e-05,17,9,8
19449,highly,8.403516316233764e-05,9.506897417988779e-05,108,46,62
19450,highprofile,1.9070323809907035e-05,2.087721574549256e-05,23,9,14
19451,highquality,2.3052039770217305e-06,7.074097897233022e-06,5,1,4
19452,highranking,2.095639979110664e-07,1.2250267090330355e-05,8,0,8
19453,highrise,2.3052039770217305e-06,5.348708166200577e-06,4,1,3
19454,highspeed,2.326160376812834e-05,1.742643628342769e-05,22,12,10
19455,hightech,1.9070323809907035e-05,5.348708166200577e-06,14,10,4
19456,highway,4.212236358012434e-05,3.122955413168725e-05,42,22,20
19457,hijab,1.48790438516857e-05,1.3975656821362803e-05,16,7,9
19458,hijack,1.48790438516857e-05,1.3975656821362803e-05,16,7,9
19459,hijacked,2.7452883726349685e-05,1.3975656821362803e-05,25,15,10
19460,hijacker,4.400843956132392e-06,5.348708166200577e-06,8,4,4
19461,hijacking,6.496483935243052e-06,1.2250267090330355e-05,11,3,8
19462,hike,3.1644163684570994e-05,2.9504164400654783e-05,37,17,20
19463,hiked,4.400843956132392e-06,1.7253897310324457e-07,3,3,0
19464,hiker,1.278340387257504e-05,8.79948762826546e-06,12,7,5
19465,hilariou,4.400843956132392e-06,8.79948762826546e-06,7,2,5
19466,hill,2.116596378901769e-05,5.348708166200577e-06,13,10,3
19467,hilltop,2.3052039770217305e-06,3.6233184351681345e-06,3,1,2
19468,him,4.400843956132392e-06,1.8979287041356905e-06,5,3,2
19469,hinder,8.592123914353715e-06,3.6233184351681345e-06,6,4,2
19470,hindering,6.496483935243052e-06,3.6233184351681345e-06,5,3,2
19471,hinge,6.496483935243052e-06,7.074097897233022e-06,7,3,4
19472,hint,3.583544364279237e-05,2.087721574549256e-05,31,18,13
19473,hinted,1.48790438516857e-05,7.074097897233022e-06,12,7,5
19474,hip,1.48790438516857e-05,1.052487735929791e-05,14,7,7
19475,hiphop,2.3052039770217305e-06,3.6233184351681345e-06,4,1,3
19476,hipster,2.3052039770217305e-06,3.6233184351681345e-06,3,1,2
19477,hire,4.840928351745632e-05,3.2954943862719716e-05,51,28,23
19478,hired,5.6791843433898893e-05,2.777877466962238e-05,50,30,20
19479,hiring,1.48790438516857e-05,3.640572332478458e-05,32,9,23
19480,historian,1.9070323809907035e-05,1.742643628342769e-05,19,9,10
19481,historic,8.613080314144832e-05,0.00012267520987640663,117,42,75
19482,historical,2.7452883726349685e-05,2.087721574549256e-05,29,15,14
19483,historically,1.6974683830796368e-05,1.570104655239525e-05,18,9,9
19484,history,0.00036694656034227697,0.00042979458200018204,470,194,276
19485,historymaking,2.095639979110664e-07,5.348708166200577e-06,3,0,3
19486,hit,0.0004905893191098062,0.0004970847815104472,589,266,323
19487,hitandrun,6.496483935243052e-06,1.8979287041356905e-06,4,3,1
19488,hitech,2.095639979110664e-07,5.348708166200577e-06,5,1,4
19489,hitman,6.496483935243052e-06,1.9151826014460126e-05,14,3,11
19490,hitting,4.6313643538345614e-05,2.9504164400654783e-05,40,23,17
19491,hoard,1.0687763893464371e-05,3.6233184351681345e-06,7,5,2
19492,hoarded,4.400843956132392e-06,1.8979287041356905e-06,3,2,1
19493,hoax,1.9070323809907035e-05,2.2602605476525032e-05,24,9,15
19494,hobby,2.3052039770217305e-06,5.348708166200577e-06,4,1,3
19495,hockey,8.592123914353715e-06,3.6233184351681345e-06,8,5,3
19496,hog,6.496483935243052e-06,3.6233184351681345e-06,5,3,2
19497,hoisted,2.3052039770217305e-06,3.6233184351681345e-06,3,1,2
19498,hold,0.00028312096117785073,0.00023482554239351563,305,149,156
19499,holder,2.7452883726349685e-05,1.570104655239525e-05,26,13,13
19500,holding,0.00013223488268188294,0.0001019705331040174,134,67,67
19501,holdout,4.400843956132392e-06,3.6233184351681345e-06,4,2,2
19502,hole,5.4696203454788295e-05,5.020884117304414e-05,64,30,34
19503,holed,6.496483935243052e-06,1.8979287041356905e-06,5,3,2
19504,holiday,9.03220830996695e-05,0.0001364783277246665,137,50,87
19505,hollow,2.095639979110664e-07,7.074097897233022e-06,4,0,4
19506,holocaust,1.0687763893464371e-05,7.074097897233022e-06,9,5,4
19507,holy,2.7452883726349685e-05,3.2954943862719716e-05,35,13,22
19508,home,0.0007546399564777497,0.0007127584978895026,865,402,463
19509,homecoming,2.3052039770217305e-06,5.348708166200577e-06,4,1,3
19510,homegrown,1.0687763893464371e-05,3.6233184351681345e-06,7,5,2
19511,homeland,2.326160376812834e-05,2.2602605476525032e-05,26,11,15
19512,homeles,0.00010708720293255492,7.954046660059569e-05,105,56,49
19513,homelessnes,2.326160376812834e-05,2.6053384938589907e-05,27,11,16
19514,homemade,1.6974683830796368e-05,5.348708166200577e-06,12,9,3
19515,homeopathic,6.496483935243052e-06,1.8979287041356905e-06,4,3,1
19516,homeopathy,4.400843956132392e-06,1.8979287041356905e-06,3,2,1
19517,homeowner,3.1644163684570994e-05,8.79948762826546e-06,24,18,6
19518,homepage,4.400843956132392e-06,1.8979287041356905e-06,3,2,1
19519,homestate,2.3052039770217305e-06,3.6233184351681345e-06,3,1,2
19520,hometown,1.9070323809907035e-05,1.3975656821362803e-05,17,9,8
19521,homework,8.592123914353715e-06,1.2250267090330355e-05,15,6,9
19522,homicide,2.7452883726349685e-05,1.2250267090330355e-05,25,15,10
19523,homophobia,1.0687763893464371e-05,5.348708166200577e-06,9,5,4
19524,homophobic,1.0687763893464371e-05,8.79948762826546e-06,10,5,5
19525,homosexual,6.517440335034157e-05,5.020884117304414e-05,68,38,30
19526,homosexuality,4.002672360101368e-05,4.1581892517881935e-05,53,25,28
19527,honed,8.592123914353715e-06,1.7253897310324457e-07,5,4,1
19528,honest,3.1644163684570994e-05,3.985650278684949e-05,41,15,26
19529,honestly,1.9070323809907035e-05,7.074097897233022e-06,14,10,4
19530,honesty,8.592123914353715e-06,3.6233184351681345e-06,6,4,2
19531,honey,1.0687763893464371e-05,1.2250267090330355e-05,12,5,7
19532,honeybee,6.496483935243052e-06,3.6233184351681345e-06,5,3,2
19533,honor,8.613080314144832e-05,6.746273848336857e-05,86,45,41
19534,honorable,4.400843956132392e-06,7.074097897233022e-06,8,3,5
19535,honorary,4.400843956132392e-06,8.79948762826546e-06,7,2,5
19536,honored,2.116596378901769e-05,1.9151826014460126e-05,21,10,11
19537,honoring,1.48790438516857e-05,8.79948762826546e-06,13,7,6
19538,honour,3.3739803663681634e-05,2.777877466962238e-05,34,18,16
19539,honoured,2.095639979110664e-07,1.8979287041356905e-06,3,2,1
19540,hood,6.496483935243052e-06,5.348708166200577e-06,6,3,3
19541,hooded,2.3052039770217305e-06,1.8979287041356905e-06,3,2,1
19542,hook,8.592123914353715e-06,7.074097897233022e-06,10,6,4
19543,hooker,4.400843956132392e-06,1.8979287041356905e-06,4,2,2
19544,hooligan,8.592123914353715e-06,3.6233184351681345e-06,6,4,2
19545,hooliganism,2.3052039770217305e-06,5.348708166200577e-06,4,1,3
19546,hop,8.592123914353715e-06,3.6233184351681345e-06,6,4,2
19547,hope,0.0002935991610734039,0.00029521418297965093,352,158,194
19548,hoped,2.5357243747239038e-05,3.8131113055817005e-05,35,13,22
19549,hopeful,3.7931083621902995e-05,2.777877466962238e-05,45,26,19
19550,hopeles,4.400843956132392e-06,8.79948762826546e-06,8,2,6
19551,hopelessly,2.3052039770217305e-06,1.8979287041356905e-06,3,1,2
19552,hopelessnes,2.095639979110664e-07,8.79948762826546e-06,5,0,5
19553,hoping,6.72700433294523e-05,5.711040009717395e-05,72,35,37
19554,horde,2.095639979110664e-07,5.348708166200577e-06,3,0,3
19555,horizon,1.278340387257504e-05,5.348708166200577e-06,10,6,4
19556,hormone,2.3052039770217305e-06,3.6233184351681345e-06,3,1,2
19557,horn,4.6313643538345614e-05,2.2602605476525032e-05,36,23,13
19558,horrendou,4.400843956132392e-06,7.074097897233022e-06,6,2,4
19559,horrible,2.7452883726349685e-05,2.777877466962238e-05,31,14,17
19560,horribly,2.3052039770217305e-06,5.348708166200577e-06,4,1,3
19561,horrific,3.3739803663681634e-05,2.9504164400654783e-05,44,19,25
19562,horrified,6.496483935243052e-06,7.074097897233022e-06,7,3,4
19563,horrifying,2.5357243747239038e-05,5.348708166200577e-06,15,12,3
19564,horror,4.002672360101368e-05,3.8131113055817005e-05,43,20,23
19565,horse,2.5357243747239038e-05,3.122955413168725e-05,33,14,19
19566,horsemeat,2.3052039770217305e-06,3.6233184351681345e-06,3,1,2
19567,horserace,2.3052039770217305e-06,1.8979287041356905e-06,3,1,2
19568,hospitable,2.3052039770217305e-06,3.6233184351681345e-06,3,1,2
19569,hospital,0.00018672152213876006,0.00024172710131764556,255,101,154
19570,hospitalised,6.496483935243052e-06,1.8979287041356905e-06,6,3,3
19571,hospitality,2.3052039770217305e-06,1.8979287041356905e-06,4,2,2
19572,hospitalized,2.7452883726349685e-05,2.9504164400654783e-05,32,13,19
19573,host,0.00014480872255654665,0.0001554576147660233,171,73,98
19574,hostage,8.403516316233764e-05,7.954046660059569e-05,99,42,57
19575,hosted,2.5357243747239038e-05,1.742643628342769e-05,25,13,12
19576,hostile,2.5357243747239038e-05,3.468033359375216e-05,34,13,21
19577,hostility,2.5357243747239038e-05,1.2250267090330355e-05,19,12,7
19578,hosting,1.6974683830796368e-05,3.122955413168725e-05,27,9,18
19579,hot,7.565260324589493e-05,5.3659620635109e-05,70,36,34
19580,hotel,0.00011966104280721883,9.851975364195259e-05,131,67,64
19581,hotline,2.3052039770217305e-06,7.074097897233022e-06,5,1,4
19582,hotly,4.400843956132392e-06,8.79948762826546e-06,7,2,5
19583,hotspot,6.496483935243052e-06,3.6233184351681345e-06,6,3,3
19584,hotter,4.400843956132392e-06,7.074097897233022e-06,11,6,5
19585,hottest,1.278340387257504e-05,2.087721574549256e-05,21,7,14
19586,hounded,4.400843956132392e-06,1.8979287041356905e-06,3,2,1
19587,hour,0.000465441639360478,0.00035387743383475447,472,246,226
19588,hourlong,4.400843956132392e-06,3.6233184351681345e-06,4,2,2
19589,hourly,4.400843956132392e-06,1.8979287041356905e-06,3,2,1
19590,hourslong,2.3052039770217305e-06,1.8979287041356905e-06,3,2,1
19591,house,0.0002265386817418625,0.00017443690180738014,233,119,114
19592,housed,6.496483935243052e-06,1.052487735929791e-05,11,5,6
19593,household,5.6791843433898893e-05,5.1934230904076595e-05,63,30,33
19594,housemaid,4.400843956132392e-06,1.8979287041356905e-06,3,2,1
19595,housetohouse,4.400843956132392e-06,3.6233184351681345e-06,4,2,2
19596,housewife,4.400843956132392e-06,1.7253897310324457e-07,3,2,1
19597,housing,0.00010708720293255492,0.0001019705331040174,125,55,70
19598,however,5.6791843433898893e-05,8.644202552472544e-05,83,30,53
19599,howling,2.3052039770217305e-06,3.6233184351681345e-06,3,1,2
19600,hr,1.0687763893464371e-05,7.074097897233022e-06,9,5,4
19601,ht,2.3052039770217305e-06,3.6233184351681345e-06,3,1,2
19602,hub,1.0687763893464371e-05,1.742643628342769e-05,16,6,10
19603,hubri,2.3052039770217305e-06,3.6233184351681345e-06,3,1,2
19604,hue,2.3052039770217305e-06,3.6233184351681345e-06,3,1,2
19605,hug,1.6974683830796368e-05,7.074097897233022e-06,13,8,5
19606,huge,0.00020348664197164515,0.0001951415785797695,231,106,125
19607,hugely,6.496483935243052e-06,7.074097897233022e-06,7,3,4
19608,hugging,4.400843956132392e-06,1.7253897310324457e-07,3,3,0
19609,human,0.0006812925572088762,0.0006972299903102106,806,351,455
19610,humane,1.0687763893464371e-05,1.2250267090330355e-05,12,5,7
19611,humanitarian,7.774824322500554e-05,5.883578982820635e-05,79,42,37
19612,humanity,9.660900303700153e-05,7.608968713853079e-05,97,51,46
19613,humankind,2.3052039770217305e-06,3.6233184351681345e-06,3,1,2
19614,humanlike,2.3052039770217305e-06,3.6233184351681345e-06,3,1,2
19615,humanright,1.0687763893464371e-05,1.8979287041356905e-06,6,5,1
19616,humantohuman,2.3052039770217305e-06,1.8979287041356905e-06,4,3,1
19617,humble,6.496483935243052e-06,1.2250267090330355e-05,12,5,7
19618,humiliate,2.3052039770217305e-06,7.074097897233022e-06,5,1,4
19619,humiliated,1.278340387257504e-05,5.348708166200577e-06,10,7,3
19620,humiliating,1.48790438516857e-05,1.7253897310324457e-07,7,7,0
19621,humiliation,1.48790438516857e-05,1.052487735929791e-05,14,7,7
19622,humility,6.496483935243052e-06,8.79948762826546e-06,8,3,5
19623,hummu,4.400843956132392e-06,1.8979287041356905e-06,3,2,1
19624,humor,6.496483935243052e-06,8.79948762826546e-06,8,3,5
19625,hundred,0.00029779044103162505,0.0002848618445934566,336,151,185
19626,hung,1.9070323809907035e-05,1.052487735929791e-05,16,9,7
19627,hunger,6.72700433294523e-05,7.954046660059569e-05,85,36,49
19628,hungry,3.7931083621902995e-05,2.9504164400654783e-05,37,18,19
19629,hunt,6.517440335034157e-05,7.263890767646595e-05,85,35,50
19630,hunted,1.48790438516857e-05,1.2250267090330355e-05,15,7,8
19631,hunter,2.954852370546031e-05,2.777877466962238e-05,37,16,21
19632,hunting,6.517440335034157e-05,5.883578982820635e-05,69,32,37
19633,hurdle,1.0687763893464371e-05,1.3975656821362803e-05,13,5,8
19634,hurl,1.0687763893464371e-05,1.8979287041356905e-06,6,5,1
19635,hurled,8.592123914353715e-06,1.8979287041356905e-06,6,5,1
19636,hurling,2.095639979110664e-07,8.79948762826546e-06,5,0,5
19637,hurricane,1.278340387257504e-05,2.4327995207557487e-05,23,9,14
19638,hurried,2.095639979110664e-07,5.348708166200577e-06,4,1,3
19639,hurry,2.3052039770217305e-06,3.6233184351681345e-06,3,1,2
19640,hurt,8.822644312055891e-05,0.00010024514337298497,111,50,61
19641,hurtful,2.3052039770217305e-06,3.6233184351681345e-06,3,1,2
19642,hurting,8.592123914353715e-06,2.6053384938589907e-05,22,6,16
19643,hurtling,6.496483935243052e-06,3.6233184351681345e-06,5,3,2
19644,husband,0.0001343305226609934,8.299124606266055e-05,129,76,53
19645,hush,4.400843956132392e-06,7.074097897233022e-06,6,2,4
19646,hustle,4.400843956132392e-06,1.7253897310324457e-07,3,2,1
19647,hybrid,6.496483935243052e-06,3.6233184351681345e-06,5,3,2
19648,hydraulic,2.095639979110664e-07,3.6233184351681345e-06,3,0,3
19649,hydrocarbon,2.3052039770217305e-06,3.6233184351681345e-06,3,1,2
19650,hydroelectric,1.278340387257504e-05,1.052487735929791e-05,12,6,6
19651,hydrogen,1.278340387257504e-05,1.2250267090330355e-05,13,6,7
19652,hygiene,4.400843956132392e-06,1.742643628342769e-05,12,2,10
19653,hype,2.3052039770217305e-06,5.348708166200577e-06,4,1,3
19654,hyperbole,2.095639979110664e-07,3.6233184351681345e-06,3,1,2
19655,hyperlink,2.3052039770217305e-06,3.6233184351681345e-06,3,1,2
19656,hypocrisy,3.3739803663681634e-05,3.468033359375216e-05,41,19,22
19657,hypocrite,2.3052039770217305e-06,3.6233184351681345e-06,4,1,3
19658,hypocritical,6.496483935243052e-06,8.79948762826546e-06,9,4,5
19659,hypothetical,2.3052039770217305e-06,3.6233184351681345e-06,4,2,2
19660,hysteria,6.496483935243052e-06,3.6233184351681345e-06,6,3,3
19661,i24new,2.3052039770217305e-06,3.6233184351681345e-06,3,1,2
19662,iO,8.592123914353715e-06,7.074097897233022e-06,8,4,4
19663,iPad,3.583544364279237e-05,1.9151826014460126e-05,28,17,11
19664,iPhone,0.00012385232276544028,0.00012094982014537423,144,65,79
19665,iPod,2.3052039770217305e-06,5.348708166200577e-06,7,1,6
19666,iTune,6.496483935243052e-06,3.6233184351681345e-06,7,4,3
19667,ice,7.565260324589493e-05,9.851975364195259e-05,101,40,61
19668,iceberg,1.0687763893464371e-05,1.052487735929791e-05,12,6,6
19669,icebreaker,2.3052039770217305e-06,5.348708166200577e-06,4,1,3
19670,icon,2.5357243747239038e-05,1.570104655239525e-05,22,12,10
19671,iconic,6.496483935243052e-06,2.4327995207557487e-05,18,3,15
19672,icy,1.0687763893464371e-05,7.074097897233022e-06,9,5,4
19673,idea,0.0002600689214076331,0.0002520794397038401,299,140,159
19674,ideal,1.6974683830796368e-05,1.570104655239525e-05,22,11,11
19675,identical,2.3052039770217305e-06,5.348708166200577e-06,5,2,3
19676,identification,2.095639979110664e-07,1.570104655239525e-05,11,1,10
19677,identified,5.260056347567764e-05,9.334358444885519e-05,86,28,58
19678,identify,5.6791843433898893e-05,5.1934230904076595e-05,65,32,33
19679,identifying,1.48790438516857e-05,1.2250267090330355e-05,16,8,8
19680,identity,0.0001154697628489974,0.00010714670229711469,128,59,69
19681,ideological,1.0687763893464371e-05,1.3975656821362803e-05,17,6,11
19682,ideology,2.326160376812834e-05,2.4327995207557487e-05,30,13,17
19683,idiocy,6.496483935243052e-06,1.8979287041356905e-06,4,3,1
19684,idiot,1.0687763893464371e-05,1.3975656821362803e-05,14,6,8
19685,idle,4.400843956132392e-06,5.348708166200577e-06,5,2,3
19686,idled,2.3052039770217305e-06,1.8979287041356905e-06,3,1,2
19687,idly,4.400843956132392e-06,5.348708166200577e-06,6,2,4
19688,ie,1.48790438516857e-05,8.79948762826546e-06,13,7,6
19689,if,2.095639979110664e-07,5.348708166200577e-06,3,0,3
19690,ignite,2.3052039770217305e-06,1.052487735929791e-05,9,1,8
19691,ignited,2.3052039770217305e-06,1.2250267090330355e-05,9,1,8
19692,igniting,2.095639979110664e-07,5.348708166200577e-06,3,0,3
19693,ignorance,1.278340387257504e-05,2.087721574549256e-05,24,9,15
19694,ignorant,2.116596378901769e-05,1.742643628342769e-05,22,10,12
19695,ignore,5.888748341300963e-05,8.126585633162811e-05,85,33,52
19696,ignored,6.936568330856297e-05,4.6758061710979285e-05,71,40,31
19697,ignoring,1.48790438516857e-05,3.122955413168725e-05,28,10,18
19698,iiNet,4.400843956132392e-06,5.348708166200577e-06,5,2,3
19699,ill,7.146132328767358e-05,5.711040009717395e-05,76,38,38
19700,illadvised,2.095639979110664e-07,3.6233184351681345e-06,3,1,2
19701,illegal,0.00032503376076006407,0.00027623489593829424,364,179,185
19702,illegally,7.146132328767358e-05,8.644202552472544e-05,94,38,56
19703,illegitimate,6.496483935243052e-06,1.742643628342769e-05,13,3,10
19704,illicit,1.6974683830796368e-05,2.4327995207557487e-05,24,10,14
19705,illiteracy,2.3052039770217305e-06,5.348708166200577e-06,5,2,3
19706,illiterate,1.0687763893464371e-05,1.052487735929791e-05,11,5,6
19707,illnes,5.6791843433898893e-05,5.020884117304414e-05,65,29,36
19708,illogical,2.095639979110664e-07,5.348708166200577e-06,3,0,3
19709,illprepared,4.400843956132392e-06,1.8979287041356905e-06,3,2,1
19710,illtreatment,2.3052039770217305e-06,3.6233184351681345e-06,3,1,2
19711,illuminate,2.3052039770217305e-06,3.6233184351681345e-06,4,1,3
19712,illusion,2.095639979110664e-07,1.2250267090330355e-05,7,0,7
19713,illustrate,8.592123914353715e-06,1.3975656821362803e-05,14,4,10
19714,illustrated,4.400843956132392e-06,5.348708166200577e-06,5,2,3
19715,illustration,8.592123914353715e-06,3.6233184351681345e-06,7,4,3
19716,im,2.3052039770217305e-06,5.348708166200577e-06,4,1,3
19717,image,0.00016366948236854273,0.00016063378395912072,194,87,107
19718,imagery,8.592123914353715e-06,1.2250267090330355e-05,12,5,7
19719,imaginable,2.3052039770217305e-06,3.6233184351681345e-06,4,1,3
19720,imaginary,6.496483935243052e-06,1.8979287041356905e-06,4,3,1
19721,imagination,6.496483935243052e-06,7.074097897233022e-06,7,3,4
19722,imagine,3.3739803663681634e-05,5.020884117304414e-05,47,17,30
19723,imagined,8.592123914353715e-06,1.2250267090330355e-05,13,5,8
19724,imaging,2.3052039770217305e-06,1.8979287041356905e-06,3,2,1
19725,imagining,6.496483935243052e-06,3.6233184351681345e-06,6,4,2
19726,imam,2.954852370546031e-05,1.742643628342769e-05,25,14,11
19727,imbalance,8.592123914353715e-06,3.6233184351681345e-06,8,5,3
19728,imitation,6.496483935243052e-06,1.8979287041356905e-06,4,3,1
19729,immediate,4.6313643538345614e-05,5.020884117304414e-05,55,26,29
19730,immediately,7.984388320411623e-05,8.644202552472544e-05,94,40,54
19731,immense,4.400843956132392e-06,8.79948762826546e-06,10,2,8
19732,immensely,1.0687763893464371e-05,1.8979287041356905e-06,7,5,2
19733,immigrant,0.00018881716211787043,0.00019859235804183437,223,100,123
19734,immigration,0.0001741476822640959,0.0001589083942280881,200,92,108
19735,imminent,2.7452883726349685e-05,2.777877466962238e-05,33,17,16
19736,immolation,2.095639979110664e-07,5.348708166200577e-06,3,0,3
19737,immoral,1.278340387257504e-05,1.742643628342769e-05,17,6,11
19738,immortal,1.0687763893464371e-05,1.7253897310324457e-07,5,5,0
19739,immune,2.116596378901769e-05,1.3975656821362803e-05,22,12,10
19740,immunity,2.7452883726349685e-05,2.6053384938589907e-05,34,13,21
19741,immunization,1.0687763893464371e-05,3.6233184351681345e-06,7,5,2
19742,impact,0.00016995640230587486,0.00018996540938667205,212,90,122
19743,impacted,1.278340387257504e-05,8.79948762826546e-06,11,6,5
19744,impacting,2.3052039770217305e-06,5.348708166200577e-06,4,1,3
19745,impaired,6.496483935243052e-06,3.6233184351681345e-06,5,3,2
19746,impartial,2.3052039770217305e-06,1.8979287041356905e-06,3,1,2
19747,impasse,2.095639979110664e-07,3.6233184351681345e-06,3,0,3
19748,impassioned,2.3052039770217305e-06,3.6233184351681345e-06,3,1,2
19749,impeach,4.400843956132392e-06,1.9151826014460126e-05,13,2,11
19750,impeached,4.400843956132392e-06,5.348708166200577e-06,5,2,3
19751,impeachment,4.002672360101368e-05,3.468033359375216e-05,42,21,21
19752,impede,6.496483935243052e-06,5.348708166200577e-06,6,3,3
19753,impediment,2.3052039770217305e-06,1.8979287041356905e-06,4,1,3
19754,impending,8.592123914353715e-06,1.052487735929791e-05,13,7,6
19755,imperative,1.6974683830796368e-05,1.052487735929791e-05,15,9,6
19756,imperfect,2.095639979110664e-07,5.348708166200577e-06,3,0,3
19757,imperial,6.496483935243052e-06,3.6233184351681345e-06,7,3,4
19758,imperialism,6.496483935243052e-06,3.6233184351681345e-06,5,3,2
19759,imperialist,2.3052039770217305e-06,3.6233184351681345e-06,4,2,2
19760,imperil,1.0687763893464371e-05,3.6233184351681345e-06,9,5,4
19761,imperiled,4.400843956132392e-06,1.7253897310324457e-07,4,2,2
19762,impersonating,2.3052039770217305e-06,3.6233184351681345e-06,4,2,2
19763,implant,1.48790438516857e-05,8.79948762826546e-06,14,8,6
19764,implanted,2.3052039770217305e-06,1.8979287041356905e-06,3,2,1
19765,implement,2.5357243747239038e-05,3.122955413168725e-05,32,13,19
19766,implementation,8.592123914353715e-06,1.052487735929791e-05,14,6,8
19767,implemented,8.592123914353715e-06,2.6053384938589907e-05,21,5,16
19768,implementing,1.6974683830796368e-05,1.3975656821362803e-05,18,8,10
19769,implicate,6.496483935243052e-06,3.6233184351681345e-06,6,4,2
19770,implicated,1.0687763893464371e-05,2.087721574549256e-05,21,7,14
19771,implicating,4.400843956132392e-06,1.8979287041356905e-06,3,2,1
19772,implication,3.3739803663681634e-05,2.4327995207557487e-05,34,17,17
19773,implicit,2.095639979110664e-07,8.79948762826546e-06,6,0,6
19774,implied,4.400843956132392e-06,8.79948762826546e-06,9,3,6
19775,implode,4.400843956132392e-06,3.6233184351681345e-06,6,2,4
19776,implored,2.3052039770217305e-06,3.6233184351681345e-06,3,1,2
19777,imply,1.278340387257504e-05,8.79948762826546e-06,12,6,6
19778,implying,6.496483935243052e-06,1.8979287041356905e-06,4,3,1
19779,import,7.984388320411623e-05,5.1934230904076595e-05,73,42,31
19780,importance,4.840928351745632e-05,3.468033359375216e-05,52,28,24
19781,important,0.00028940788111518276,0.0002727841164762295,326,150,176
19782,importantly,8.592123914353715e-06,1.742643628342769e-05,17,4,13
19783,imported,1.6974683830796368e-05,1.3975656821362803e-05,18,10,8
19784,importer,2.095639979110664e-07,1.052487735929791e-05,6,0,6
19785,importing,2.095639979110664e-07,8.79948762826546e-06,5,0,5
19786,impose,6.72700433294523e-05,4.8483451442011706e-05,70,37,33
19787,imposed,4.4218003559234974e-05,3.985650278684949e-05,48,23,25
19788,imposing,2.7452883726349685e-05,2.2602605476525032e-05,29,14,15
19789,impossible,4.212236358012434e-05,7.263890767646595e-05,66,21,45
19790,impoverished,1.278340387257504e-05,7.074097897233022e-06,10,6,4
19791,impressed,6.496483935243052e-06,8.79948762826546e-06,8,3,5
19792,impression,1.9070323809907035e-05,7.074097897233022e-06,15,10,5
19793,impressive,8.592123914353715e-06,2.9504164400654783e-05,23,5,18
19794,imprison,6.496483935243052e-06,1.8979287041356905e-06,4,3,1
19795,imprisoned,4.840928351745632e-05,3.468033359375216e-05,48,24,24
19796,imprisoning,6.496483935243052e-06,3.6233184351681345e-06,6,3,3
19797,imprisonment,2.326160376812834e-05,3.122955413168725e-05,34,13,21
19798,impromptu,2.095639979110664e-07,5.348708166200577e-06,4,1,3
19799,improper,4.400843956132392e-06,7.074097897233022e-06,7,2,5
19800,improperly,4.400843956132392e-06,3.6233184351681345e-06,6,2,4
19801,improve,0.00010080028299522283,8.126585633162811e-05,110,52,58
19802,improved,3.1644163684570994e-05,1.570104655239525e-05,26,16,10
19803,improvement,2.7452883726349685e-05,2.2602605476525032e-05,28,14,14
19804,improving,1.9070323809907035e-05,2.777877466962238e-05,27,11,16
19805,impulse,8.592123914353715e-06,3.6233184351681345e-06,6,4,2
19806,impunity,2.326160376812834e-05,1.3975656821362803e-05,19,11,8
19807,in,4.400843956132392e-06,7.074097897233022e-06,6,2,4
19808,inability,1.0687763893464371e-05,1.570104655239525e-05,19,6,13
19809,inaccessible,6.496483935243052e-06,5.348708166200577e-06,6,3,3
19810,inaccurate,1.278340387257504e-05,1.052487735929791e-05,15,7,8
19811,inaction,1.0687763893464371e-05,1.052487735929791e-05,11,5,6
19812,inadequate,8.592123914353715e-06,7.074097897233022e-06,10,5,5
19813,inadvertently,4.400843956132392e-06,5.348708166200577e-06,5,2,3
19814,inappropriate,2.116596378901769e-05,2.6053384938589907e-05,26,10,16
19815,inappropriately,6.496483935243052e-06,1.052487735929791e-05,10,4,6
19816,inaugural,1.48790438516857e-05,1.7253897310324457e-07,8,8,0
19817,inaugurated,2.3052039770217305e-06,7.074097897233022e-06,5,1,4
19818,inauguration,1.278340387257504e-05,1.742643628342769e-05,22,9,13
19819,inbox,1.9070323809907035e-05,8.79948762826546e-06,14,9,5
19820,incapable,2.3052039770217305e-06,3.6233184351681345e-06,3,1,2
19821,incarcerated,2.3052039770217305e-06,1.2250267090330355e-05,10,3,7
19822,incarceration,1.6974683830796368e-05,7.074097897233022e-06,13,8,5
19823,incendiary,4.400843956132392e-06,3.6233184351681345e-06,4,2,2
19824,incentive,1.6974683830796368e-05,1.742643628342769e-05,22,9,13
19825,incentivize,4.400843956132392e-06,3.6233184351681345e-06,4,2,2
19826,incest,8.592123914353715e-06,1.2250267090330355e-05,12,4,8
19827,inch,6.496483935243052e-06,2.6053384938589907e-05,20,3,17
19828,incidence,2.3052039770217305e-06,7.074097897233022e-06,6,2,4
19829,incident,0.00010708720293255492,0.00011922443041434203,134,54,80
19830,incinerated,6.496483935243052e-06,1.7253897310324457e-07,3,3,0
19831,incite,2.3052039770217305e-06,5.348708166200577e-06,6,2,4
19832,incited,2.095639979110664e-07,8.79948762826546e-06,5,0,5
19833,incitement,2.3052039770217305e-06,5.348708166200577e-06,4,1,3
19834,inciting,1.9070323809907035e-05,2.2602605476525032e-05,26,11,15
19835,incl,4.400843956132392e-06,1.8979287041356905e-06,3,2,1
19836,inclined,6.496483935243052e-06,7.074097897233022e-06,7,3,4
19837,include,0.00018462588215964923,0.0002020431375038992,222,93,129
19838,included,6.517440335034157e-05,7.263890767646595e-05,79,34,45
19839,including,0.00045705907944403545,0.0004539500382346362,546,248,298
19840,inclusion,1.48790438516857e-05,1.9151826014460126e-05,22,9,13
19841,inclusive,1.9070323809907035e-05,8.79948762826546e-06,15,10,5
19842,inclusivity,2.3052039770217305e-06,3.6233184351681345e-06,3,1,2
19843,income,0.00013223488268188294,0.00016063378395912072,174,75,99
19844,incoming,1.48790438516857e-05,2.6053384938589907e-05,31,10,21
19845,incompatible,4.400843956132392e-06,7.074097897233022e-06,6,2,4
19846,incompetence,4.400843956132392e-06,7.074097897233022e-06,7,3,4
19847,incompetent,6.496483935243052e-06,1.052487735929791e-05,10,4,6
19848,incomplete,2.3052039770217305e-06,1.8979287041356905e-06,3,2,1
19849,incomprehensible,4.400843956132392e-06,5.348708166200577e-06,6,3,3
19850,inconceivable,4.400843956132392e-06,1.8979287041356905e-06,4,3,1
19851,inconsequential,2.3052039770217305e-06,3.6233184351681345e-06,3,1,2
19852,inconsistent,1.278340387257504e-05,5.348708166200577e-06,9,6,3
19853,inconvenient,4.400843956132392e-06,1.8979287041356905e-06,3,2,1
19854,incorporate,4.400843956132392e-06,1.8979287041356905e-06,3,2,1
19855,incorrect,1.0687763893464371e-05,1.052487735929791e-05,11,5,6
19856,incorrectly,8.592123914353715e-06,1.8979287041356905e-06,6,4,2
19857,increase,0.00020139100199253443,0.0002192970348142235,253,113,140
19858,increased,8.403516316233764e-05,0.0001019705331040174,102,41,61
19859,increasing,7.984388320411623e-05,8.4716635793693e-05,98,43,55
19860,increasingly,0.00012804360272366158,0.00012612598933847184,148,71,77
19861,incredible,4.002672360101368e-05,2.777877466962238e-05,41,22,19
19862,incredibly,1.48790438516857e-05,1.2250267090330355e-05,16,8,8
19863,incremental,2.095639979110664e-07,3.6233184351681345e-06,3,0,3
19864,incriminating,2.095639979110664e-07,7.074097897233022e-06,5,0,5
19865,incumbent,1.278340387257504e-05,3.985650278684949e-05,37,8,29
19866,incur,4.400843956132392e-06,7.074097897233022e-06,6,2,4
19867,incurable,4.400843956132392e-06,1.7253897310324457e-07,3,3,0
19868,incurred,4.400843956132392e-06,5.348708166200577e-06,6,3,3
19869,incursion,6.496483935243052e-06,8.79948762826546e-06,11,5,6
19870,indebted,6.496483935243052e-06,5.348708166200577e-06,6,3,3
19871,indecency,6.496483935243052e-06,7.074097897233022e-06,8,3,5
19872,indecent,4.400843956132392e-06,3.6233184351681345e-06,4,2,2
19873,indecisive,4.400843956132392e-06,1.8979287041356905e-06,3,2,1
19874,indeed,3.7931083621902995e-05,3.122955413168725e-05,40,20,20
19875,indefensible,1.0687763893464371e-05,3.6233184351681345e-06,7,5,2
19876,indefinite,8.592123914353715e-06,1.742643628342769e-05,15,4,11
19877,indefinitely,1.48790438516857e-05,2.087721574549256e-05,22,9,13
19878,indentured,4.400843956132392e-06,1.7253897310324457e-07,3,2,1
19879,independence,9.870464301611217e-05,8.816741525575797e-05,110,49,61
19880,independent,0.00010080028299522283,0.0001036959228350498,125,59,66
19881,independently,2.3052039770217305e-06,3.6233184351681345e-06,3,1,2
19882,indepth,6.496483935243052e-06,3.6233184351681345e-06,6,4,2
19883,index,3.1644163684570994e-05,3.122955413168725e-05,34,15,19
19884,indicate,4.212236358012434e-05,3.985650278684949e-05,47,21,26
19885,indicated,1.9070323809907035e-05,1.742643628342769e-05,23,10,13
19886,indicating,2.3052039770217305e-06,7.074097897233022e-06,5,1,4
19887,indication,2.116596378901769e-05,2.9504164400654783e-05,27,10,17
19888,indicator,4.400843956132392e-06,7.074097897233022e-06,7,2,5
19889,indict,2.3052039770217305e-06,7.074097897233022e-06,5,1,4
19890,indicted,1.9070323809907035e-05,1.742643628342769e-05,24,11,13
19891,indictment,1.6974683830796368e-05,2.6053384938589907e-05,26,11,15
19892,indifference,1.0687763893464371e-05,3.6233184351681345e-06,8,6,2
19893,indifferent,4.400843956132392e-06,1.8979287041356905e-06,3,2,1
19894,indigenou,4.4218003559234974e-05,5.711040009717395e-05,61,25,36
19895,indignation,2.3052039770217305e-06,5.348708166200577e-06,4,1,3
19896,indirectly,2.095639979110664e-07,3.6233184351681345e-06,3,0,3
19897,indiscriminate,6.496483935243052e-06,3.6233184351681345e-06,5,3,2
19898,indiscriminately,4.400843956132392e-06,8.79948762826546e-06,7,2,5
19899,indispensable,6.496483935243052e-06,1.8979287041356905e-06,4,3,1
19900,individual,0.00013642616264010403,0.00014510527637982858,170,74,96
19901,individually,2.3052039770217305e-06,7.074097897233022e-06,7,2,5
19902,indoor,1.0687763893464371e-05,1.742643628342769e-05,16,5,11
19903,induce,4.400843956132392e-06,3.6233184351681345e-06,5,3,2
19904,industrial,4.4218003559234974e-05,5.5385010366141504e-05,58,23,35
19905,industrialist,2.3052039770217305e-06,3.6233184351681345e-06,3,1,2
19906,industrialized,2.3052039770217305e-06,3.6233184351681345e-06,4,2,2
19907,industry,0.00028102532119873944,0.00033489814679339735,368,148,220
19908,ineffective,8.592123914353715e-06,1.742643628342769e-05,14,4,10
19909,inefficient,4.400843956132392e-06,1.7253897310324457e-07,3,2,1
19910,ineligible,6.496483935243052e-06,5.348708166200577e-06,6,3,3
19911,inequality,5.6791843433898893e-05,8.126585633162811e-05,82,31,51
19912,inequity,2.3052039770217305e-06,7.074097897233022e-06,7,1,6
19913,inescapable,6.496483935243052e-06,1.8979287041356905e-06,5,3,2
19914,inevitable,1.9070323809907035e-05,2.087721574549256e-05,22,9,13
19915,inevitably,6.496483935243052e-06,1.2250267090330355e-05,10,3,7
19916,inexcusable,2.3052039770217305e-06,3.6233184351681345e-06,3,1,2
19917,inexpensive,4.400843956132392e-06,1.8979287041356905e-06,3,2,1
19918,inexperienced,6.496483935243052e-06,7.074097897233022e-06,7,3,4
19919,inexplicable,2.095639979110664e-07,8.79948762826546e-06,5,0,5
19920,inextricably,4.400843956132392e-06,3.6233184351681345e-06,4,2,2
19921,infamou,2.116596378901769e-05,1.742643628342769e-05,21,10,11
19922,infamy,4.400843956132392e-06,1.8979287041356905e-06,3,2,1
19923,infant,3.583544364279237e-05,2.777877466962238e-05,37,20,17
19924,infantry,2.095639979110664e-07,8.79948762826546e-06,5,0,5
19925,infect,8.592123914353715e-06,1.8979287041356905e-06,5,4,1
19926,infected,5.260056347567764e-05,4.1581892517881935e-05,53,25,28
19927,infection,5.050492349656699e-05,3.468033359375216e-05,49,25,24
19928,infectiou,2.7452883726349685e-05,1.570104655239525e-05,25,13,12
19929,inferior,2.3052039770217305e-06,1.052487735929791e-05,7,1,6
19930,infertility,2.3052039770217305e-06,7.074097897233022e-06,5,1,4
19931,infidel,2.3052039770217305e-06,5.348708166200577e-06,5,1,4
19932,infidelity,2.095639979110664e-07,5.348708166200577e-06,5,1,4
19933,infighting,2.095639979110664e-07,5.348708166200577e-06,3,0,3
19934,infiltrate,1.278340387257504e-05,7.074097897233022e-06,10,6,4
19935,infiltrated,1.278340387257504e-05,1.3975656821362803e-05,14,6,8
19936,infiltration,6.496483935243052e-06,7.074097897233022e-06,7,3,4
19937,infiltrator,4.400843956132392e-06,1.8979287041356905e-06,3,2,1
19938,infinite,2.095639979110664e-07,5.348708166200577e-06,3,0,3
19939,inflame,2.095639979110664e-07,7.074097897233022e-06,5,0,5
19940,inflamed,4.400843956132392e-06,1.8979287041356905e-06,4,2,2
19941,inflaming,2.3052039770217305e-06,3.6233184351681345e-06,3,1,2
19942,inflammatory,1.278340387257504e-05,3.6233184351681345e-06,9,7,2
19943,inflatable,4.400843956132392e-06,1.8979287041356905e-06,3,2,1
19944,inflated,6.496483935243052e-06,1.7253897310324457e-07,3,3,0
19945,inflation,2.116596378901769e-05,3.985650278684949e-05,35,11,24
19946,inflict,8.592123914353715e-06,5.348708166200577e-06,8,4,4
19947,inflicted,6.496483935243052e-06,3.6233184351681345e-06,8,3,5
19948,inflight,6.496483935243052e-06,1.8979287041356905e-06,5,4,1
19949,influence,8.613080314144832e-05,0.00010714670229711469,113,45,68
19950,influenced,1.6974683830796368e-05,8.79948762826546e-06,13,8,5
19951,influencer,2.095639979110664e-07,8.79948762826546e-06,5,0,5
19952,influencing,6.496483935243052e-06,3.6233184351681345e-06,5,3,2
19953,influential,2.7452883726349685e-05,3.8131113055817005e-05,39,14,25
19954,influenza,8.592123914353715e-06,1.8979287041356905e-06,8,5,3
19955,influx,1.0687763893464371e-05,1.052487735929791e-05,13,7,6
19956,info,3.1644163684570994e-05,1.9151826014460126e-05,30,15,15
19957,infographic,1.278340387257504e-05,8.79948762826546e-06,11,6,5
19958,inform,1.0687763893464371e-05,1.3975656821362803e-05,15,7,8
19959,informal,4.400843956132392e-06,1.570104655239525e-05,11,2,9
19960,informant,1.9070323809907035e-05,2.6053384938589907e-05,28,11,17
19961,information,0.00028521660115696105,0.00033489814679339735,366,154,212
19962,informative,6.496483935243052e-06,1.7253897310324457e-07,3,3,0
19963,informed,1.48790438516857e-05,1.570104655239525e-05,19,8,11
19964,informing,4.400843956132392e-06,3.6233184351681345e-06,4,2,2
19965,infraction,2.095639979110664e-07,5.348708166200577e-06,3,0,3
19966,infrared,2.095639979110664e-07,7.074097897233022e-06,4,0,4
19967,infrastructure,6.72700433294523e-05,6.918812821440096e-05,79,36,43
19968,infrequent,2.3052039770217305e-06,3.6233184351681345e-06,3,1,2
19969,infringe,8.592123914353715e-06,5.348708166200577e-06,7,4,3
19970,infringement,2.326160376812834e-05,1.3975656821362803e-05,19,11,8
19971,infringing,4.400843956132392e-06,5.348708166200577e-06,6,3,3
19972,ingested,4.400843956132392e-06,3.6233184351681345e-06,4,2,2
19973,ingrained,6.496483935243052e-06,3.6233184351681345e-06,5,3,2
19974,ingredient,2.5357243747239038e-05,1.3975656821362803e-05,21,13,8
19975,inhabit,4.400843956132392e-06,3.6233184351681345e-06,4,2,2
19976,inhabitant,1.0687763893464371e-05,1.3975656821362803e-05,16,8,8
19977,inhabited,4.400843956132392e-06,5.348708166200577e-06,6,3,3
19978,inhaling,4.400843956132392e-06,1.8979287041356905e-06,3,2,1
19979,inherent,4.400843956132392e-06,3.6233184351681345e-06,4,2,2
19980,inherently,4.400843956132392e-06,7.074097897233022e-06,7,3,4
19981,inherit,4.400843956132392e-06,1.052487735929791e-05,10,4,6
19982,inheritance,6.496483935243052e-06,8.79948762826546e-06,10,5,5
19983,inherited,6.496483935243052e-06,1.052487735929791e-05,9,3,6
19984,inhouse,6.496483935243052e-06,1.8979287041356905e-06,4,3,1
19985,inhuman,6.496483935243052e-06,7.074097897233022e-06,9,4,5
19986,inhumane,6.496483935243052e-06,1.052487735929791e-05,10,3,7
19987,initial,3.1644163684570994e-05,3.640572332478458e-05,45,18,27
19988,initially,2.326160376812834e-05,1.2250267090330355e-05,21,13,8
19989,initiate,6.496483935243052e-06,3.6233184351681345e-06,5,3,2
19990,initiated,8.592123914353715e-06,7.074097897233022e-06,8,4,4
19991,initiation,6.496483935243052e-06,1.8979287041356905e-06,5,3,2
19992,initiative,6.72700433294523e-05,8.644202552472544e-05,92,36,56
19993,inject,1.0687763893464371e-05,1.7253897310324457e-07,6,6,0
19994,injected,4.400843956132392e-06,8.79948762826546e-06,7,2,5
19995,injection,1.0687763893464371e-05,1.9151826014460126e-05,16,5,11
19996,injunction,2.116596378901769e-05,1.052487735929791e-05,16,10,6
19997,injure,1.278340387257504e-05,1.2250267090330355e-05,15,7,8
19998,injured,0.0001552869224521,0.0001589083942280881,186,80,106
19999,injuring,2.116596378901769e-05,1.742643628342769e-05,20,10,10
20000,injuriou,6.496483935243052e-06,1.7253897310324457e-07,3,3,0
20001,injury,7.565260324589493e-05,3.8131113055817005e-05,68,41,27
20002,injustice,2.326160376812834e-05,3.2954943862719716e-05,36,14,22
20003,ink,6.496483935243052e-06,1.052487735929791e-05,9,3,6
20004,inland,2.095639979110664e-07,3.6233184351681345e-06,3,1,2
20005,inlaw,8.592123914353715e-06,3.6233184351681345e-06,7,5,2
20006,inmate,6.098312339212028e-05,6.746273848336857e-05,75,29,46
20007,inner,2.5357243747239038e-05,1.052487735929791e-05,18,12,6
20008,inning,2.3052039770217305e-06,1.8979287041356905e-06,3,2,1
20009,innocence,2.3052039770217305e-06,7.074097897233022e-06,6,1,5
20010,innocent,6.72700433294523e-05,8.299124606266055e-05,93,37,56
20011,innocuou,2.3052039770217305e-06,5.348708166200577e-06,4,1,3
20012,innovation,4.002672360101368e-05,3.985650278684949e-05,46,23,23
20013,innovative,1.278340387257504e-05,2.9504164400654783e-05,24,7,17
20014,innovator,6.496483935243052e-06,1.8979287041356905e-06,4,3,1
20015,inperson,4.400843956132392e-06,5.348708166200577e-06,5,2,3
20016,input,8.592123914353715e-06,8.79948762826546e-06,10,5,5
20017,inquest,1.48790438516857e-05,1.570104655239525e-05,17,7,10
20018,inquiry,0.00013013924270277222,9.506897417988779e-05,125,67,58
20019,inroad,2.095639979110664e-07,5.348708166200577e-06,3,0,3
20020,insane,1.9070323809907035e-05,1.742643628342769e-05,24,11,13
20021,insanely,2.095639979110664e-07,3.6233184351681345e-06,3,1,2
20022,insanity,6.496483935243052e-06,8.79948762826546e-06,10,3,7
20023,insatiable,2.3052039770217305e-06,1.8979287041356905e-06,3,1,2
20024,inscribed,2.3052039770217305e-06,1.8979287041356905e-06,3,1,2
20025,inscription,4.400843956132392e-06,5.348708166200577e-06,6,2,4
20026,insect,8.592123914353715e-06,1.3975656821362803e-05,15,6,9
20027,insecticide,4.400843956132392e-06,3.6233184351681345e-06,6,3,3
20028,insecure,6.496483935243052e-06,3.6233184351681345e-06,7,4,3
20029,insecurity,1.48790438516857e-05,8.79948762826546e-06,14,7,7
20030,insensitive,8.592123914353715e-06,5.348708166200577e-06,7,4,3
20031,insert,2.3052039770217305e-06,7.074097897233022e-06,5,1,4
20032,inserted,4.400843956132392e-06,1.7253897310324457e-07,3,2,1
20033,inside,0.0001783389622223174,0.0001589083942280881,201,95,106
20034,insider,2.116596378901769e-05,3.2954943862719716e-05,34,11,23
20035,insidiou,4.400843956132392e-06,1.8979287041356905e-06,3,2,1
20036,insight,2.7452883726349685e-05,2.777877466962238e-05,34,17,17
20037,insignia,4.400843956132392e-06,3.6233184351681345e-06,5,3,2
20038,insignificant,2.3052039770217305e-06,3.6233184351681345e-06,3,1,2
20039,insist,6.307876337123095e-05,7.608968713853079e-05,77,30,47
20040,insisted,2.116596378901769e-05,2.777877466962238e-05,29,13,16
20041,insistence,4.400843956132392e-06,1.8979287041356905e-06,4,3,1
20042,insisting,1.48790438516857e-05,1.2250267090330355e-05,14,7,7
20043,inspect,6.496483935243052e-06,1.8979287041356905e-06,4,3,1
20044,inspected,2.3052039770217305e-06,1.8979287041356905e-06,3,1,2
20045,inspection,8.592123914353715e-06,1.742643628342769e-05,16,6,10
20046,inspector,4.002672360101368e-05,3.2954943862719716e-05,42,20,22
20047,inspiration,1.278340387257504e-05,1.2250267090330355e-05,14,6,8
20048,inspire,1.6974683830796368e-05,2.6053384938589907e-05,27,10,17
20049,inspired,5.260056347567764e-05,2.777877466962238e-05,46,28,18
20050,inspiring,1.9070323809907035e-05,1.2250267090330355e-05,17,9,8
20051,instability,1.278340387257504e-05,1.3975656821362803e-05,15,6,9
20052,install,2.116596378901769e-05,1.3975656821362803e-05,21,11,10
20053,installation,6.496483935243052e-06,3.6233184351681345e-06,6,3,3
20054,installed,2.5357243747239038e-05,1.9151826014460126e-05,26,13,13
20055,installing,4.400843956132392e-06,5.348708166200577e-06,5,2,3
20056,installment,2.3052039770217305e-06,7.074097897233022e-06,5,1,4
20057,instance,1.278340387257504e-05,2.2602605476525032e-05,20,6,14
20058,instant,1.278340387257504e-05,1.052487735929791e-05,12,6,6
20059,instantaneously,2.3052039770217305e-06,5.348708166200577e-06,4,1,3
20060,instantly,6.496483935243052e-06,5.348708166200577e-06,8,3,5
20061,instead,0.00016995640230587486,0.00018651462992460717,210,91,119
20062,instigated,2.3052039770217305e-06,3.6233184351681345e-06,3,1,2
20063,instill,4.400843956132392e-06,1.8979287041356905e-06,5,4,1
20064,instinct,8.592123914353715e-06,5.348708166200577e-06,8,5,3
20065,institute,6.496483935243052e-06,5.348708166200577e-06,7,4,3
20066,institution,7.565260324589493e-05,7.091351794543343e-05,84,39,45
20067,institutional,4.400843956132392e-06,1.052487735929791e-05,10,2,8
20068,instructed,8.592123914353715e-06,3.6233184351681345e-06,8,5,3
20069,instructing,2.3052039770217305e-06,3.6233184351681345e-06,3,1,2
20070,instruction,1.6974683830796368e-05,1.570104655239525e-05,20,10,10
20071,instructive,2.095639979110664e-07,3.6233184351681345e-06,3,1,2
20072,instructor,4.400843956132392e-06,3.6233184351681345e-06,4,2,2
20073,instrument,1.48790438516857e-05,1.052487735929791e-05,15,8,7
20074,instrumental,2.3052039770217305e-06,5.348708166200577e-06,5,2,3
20075,insufficient,8.592123914353715e-06,5.348708166200577e-06,9,5,4
20076,insulin,2.095639979110664e-07,5.348708166200577e-06,3,0,3
20077,insult,4.6313643538345614e-05,3.640572332478458e-05,46,22,24
20078,insulted,1.48790438516857e-05,1.3975656821362803e-05,17,8,9
20079,insulting,8.193952318322689e-05,5.1934230904076595e-05,72,41,31
20080,insurance,0.00011756540282810809,0.0001554576147660233,161,57,104
20081,insured,1.0687763893464371e-05,5.348708166200577e-06,8,5,3
20082,insurer,1.6974683830796368e-05,1.742643628342769e-05,20,8,12
20083,insurgency,1.278340387257504e-05,2.087721574549256e-05,18,6,12
20084,insurgent,3.7931083621902995e-05,3.8131113055817005e-05,43,20,23
20085,insurrection,2.116596378901769e-05,1.052487735929791e-05,18,10,8
20086,intact,8.592123914353715e-06,1.742643628342769e-05,16,5,11
20087,integral,6.496483935243052e-06,7.074097897233022e-06,8,4,4
20088,integrate,1.0687763893464371e-05,1.052487735929791e-05,12,5,7
20089,integrated,6.496483935243052e-06,1.2250267090330355e-05,10,3,7
20090,integrating,6.496483935243052e-06,7.074097897233022e-06,7,3,4
20091,integration,8.592123914353715e-06,1.2250267090330355e-05,13,5,8
20092,integrity,2.954852370546031e-05,2.9504164400654783e-05,32,14,18
20093,intel,1.9070323809907035e-05,1.9151826014460126e-05,21,9,12
20094,intellectual,2.326160376812834e-05,1.9151826014460126e-05,25,12,13
20095,intellectually,6.496483935243052e-06,8.79948762826546e-06,9,4,5
20096,intelligence,0.00031455556086451027,0.00027796028566932717,337,162,175
20097,intelligent,8.592123914353715e-06,1.570104655239525e-05,14,4,10
20098,intend,2.326160376812834e-05,3.640572332478458e-05,36,12,24
20099,intended,4.840928351745632e-05,4.1581892517881935e-05,58,28,30
20100,intense,2.954852370546031e-05,2.9504164400654783e-05,33,14,19
20101,intensified,6.496483935243052e-06,7.074097897233022e-06,8,4,4
20102,intensify,2.5357243747239038e-05,1.3975656821362803e-05,23,13,10
20103,intensifying,8.592123914353715e-06,5.348708166200577e-06,8,5,3
20104,intensity,6.496483935243052e-06,8.79948762826546e-06,9,3,6
20105,intensive,4.400843956132392e-06,1.3975656821362803e-05,10,2,8
20106,intent,2.5357243747239038e-05,3.122955413168725e-05,32,13,19
20107,intention,2.7452883726349685e-05,4.50326719799468e-05,40,14,26
20108,intentional,6.496483935243052e-06,7.074097897233022e-06,7,3,4
20109,intentionally,1.48790438516857e-05,2.2602605476525032e-05,22,9,13
20110,interact,8.592123914353715e-06,1.2250267090330355e-05,12,4,8
20111,interaction,2.116596378901769e-05,1.2250267090330355e-05,17,10,7
20112,interactive,8.592123914353715e-06,1.2250267090330355e-05,11,4,7
20113,interbank,2.3052039770217305e-06,1.7253897310324457e-07,3,2,1
20114,intercept,1.9070323809907035e-05,3.2954943862719716e-05,31,11,20
20115,intercepted,1.9070323809907035e-05,1.3975656821362803e-05,19,9,10
20116,intercepting,2.3052039770217305e-06,3.6233184351681345e-06,6,2,4
20117,interception,2.3052039770217305e-06,5.348708166200577e-06,4,1,3
20118,interceptor,6.496483935243052e-06,3.6233184351681345e-06,5,3,2
20119,interconnected,6.496483935243052e-06,1.8979287041356905e-06,4,3,1
20120,intercontinental,4.400843956132392e-06,5.348708166200577e-06,5,2,3
20121,intercourse,2.095639979110664e-07,3.6233184351681345e-06,3,1,2
20122,interest,0.0002600689214076331,0.00024172710131764556,295,135,160
20123,interested,4.6313643538345614e-05,3.640572332478458e-05,48,24,24
20124,interestfree,2.3052039770217305e-06,1.8979287041356905e-06,3,2,1
20125,interesting,6.307876337123095e-05,5.1934230904076595e-05,65,33,32
20126,interfere,2.5357243747239038e-05,1.570104655239525e-05,24,13,11
20127,interference,1.9070323809907035e-05,2.087721574549256e-05,21,9,12
20128,interfering,1.9070323809907035e-05,1.8979287041356905e-06,11,9,2
20129,interim,1.0687763893464371e-05,2.777877466962238e-05,23,6,17
20130,interior,2.954852370546031e-05,3.122955413168725e-05,37,15,22
20131,intermediary,4.400843956132392e-06,1.8979287041356905e-06,4,2,2
20132,intern,1.0687763893464371e-05,1.2250267090330355e-05,12,5,7
20133,internal,5.888748341300963e-05,5.020884117304414e-05,62,28,34
20134,international,0.00036904220032138744,0.00036250438248991657,427,189,238
20135,internationally,4.400843956132392e-06,1.2250267090330355e-05,9,2,7
20136,internet,0.0003124599208853996,0.00027105872674519724,339,161,178
20137,internment,4.400843956132392e-06,1.8979287041356905e-06,4,3,1
20138,internship,2.095639979110664e-07,7.074097897233022e-06,4,0,4
20139,interpersonal,2.095639979110664e-07,3.6233184351681345e-06,3,0,3
20140,interpret,2.3052039770217305e-06,3.6233184351681345e-06,3,1,2
20141,interpretation,6.496483935243052e-06,1.2250267090330355e-05,10,3,7
20142,interpreter,1.278340387257504e-05,1.052487735929791e-05,13,7,6
20143,interracial,2.3052039770217305e-06,3.6233184351681345e-06,3,1,2
20144,interrogate,2.3052039770217305e-06,1.8979287041356905e-06,4,3,1
20145,interrogating,4.400843956132392e-06,1.7253897310324457e-07,3,3,0
20146,interrogation,2.954852370546031e-05,3.8131113055817005e-05,39,15,24
20147,interrogator,4.400843956132392e-06,5.348708166200577e-06,5,2,3
20148,interrupt,2.3052039770217305e-06,5.348708166200577e-06,4,1,3
20149,interrupted,8.592123914353715e-06,1.8979287041356905e-06,6,5,1
20150,intersect,8.592123914353715e-06,1.7253897310324457e-07,4,4,0
20151,intersection,6.496483935243052e-06,5.348708166200577e-06,6,3,3
20152,interstate,8.592123914353715e-06,3.6233184351681345e-06,6,4,2
20153,interstellar,6.496483935243052e-06,1.8979287041356905e-06,5,4,1
20154,intervene,2.5357243747239038e-05,2.6053384938589907e-05,28,13,15
20155,intervened,8.592123914353715e-06,1.8979287041356905e-06,7,4,3
20156,intervening,2.3052039770217305e-06,5.348708166200577e-06,4,1,3
20157,intervention,6.098312339212028e-05,7.091351794543343e-05,75,31,44
20158,interview,0.0002181561218254202,0.00017443690180738014,222,112,110
20159,interviewed,1.48790438516857e-05,2.087721574549256e-05,20,7,13
20160,interviewing,4.400843956132392e-06,8.79948762826546e-06,9,3,6
20161,intifada,2.3052039770217305e-06,7.074097897233022e-06,5,1,4
20162,intimate,4.400843956132392e-06,1.2250267090330355e-05,11,3,8
20163,intimately,2.3052039770217305e-06,5.348708166200577e-06,4,1,3
20164,intimidate,2.116596378901769e-05,1.3975656821362803e-05,19,11,8
20165,intimidated,6.496483935243052e-06,1.2250267090330355e-05,10,3,7
20166,intimidating,1.0687763893464371e-05,3.6233184351681345e-06,8,5,3
20167,intimidation,6.496483935243052e-06,1.742643628342769e-05,15,3,12
20168,intl,8.592123914353715e-06,5.348708166200577e-06,7,4,3
20169,intolerable,4.400843956132392e-06,3.6233184351681345e-06,4,2,2
20170,intolerance,1.6974683830796368e-05,1.2250267090330355e-05,16,9,7
20171,intolerant,4.400843956132392e-06,1.8979287041356905e-06,3,2,1
20172,intoxicated,2.3052039770217305e-06,3.6233184351681345e-06,3,1,2
20173,intractable,2.095639979110664e-07,5.348708166200577e-06,3,0,3
20174,intraparty,2.3052039770217305e-06,1.8979287041356905e-06,3,1,2
20175,intrepid,4.400843956132392e-06,1.7253897310324457e-07,5,2,3
20176,intrigue,2.3052039770217305e-06,3.6233184351681345e-06,4,1,3
20177,intriguing,6.496483935243052e-06,3.6233184351681345e-06,6,3,3
20178,introduce,7.774824322500554e-05,5.5385010366141504e-05,74,41,33
20179,introduced,4.4218003559234974e-05,5.020884117304414e-05,60,24,36
20180,introducing,4.400843956132392e-06,7.074097897233022e-06,8,2,6
20181,introduction,1.0687763893464371e-05,7.074097897233022e-06,12,6,6
20182,intrude,4.400843956132392e-06,3.6233184351681345e-06,4,2,2
20183,intruder,1.278340387257504e-05,1.3975656821362803e-05,16,7,9
20184,intruding,6.496483935243052e-06,1.8979287041356905e-06,4,3,1
20185,intrusion,1.48790438516857e-05,1.742643628342769e-05,17,7,10
20186,intrusive,8.592123914353715e-06,3.6233184351681345e-06,7,5,2
20187,inundated,2.3052039770217305e-06,1.8979287041356905e-06,3,1,2
20188,invade,2.954852370546031e-05,2.2602605476525032e-05,32,18,14
20189,invaded,6.496483935243052e-06,2.2602605476525032e-05,18,5,13
20190,invader,2.095639979110664e-07,3.6233184351681345e-06,3,1,2
20191,invading,2.326160376812834e-05,1.2250267090330355e-05,19,12,7
20192,invalid,6.496483935243052e-06,1.3975656821362803e-05,12,3,9
20193,invalidate,4.400843956132392e-06,5.348708166200577e-06,5,2,3
20194,invalidated,2.3052039770217305e-06,3.6233184351681345e-06,3,1,2
20195,invaluable,6.496483935243052e-06,1.8979287041356905e-06,4,3,1
20196,invasion,9.03220830996695e-05,8.4716635793693e-05,102,48,54
20197,invasive,1.0687763893464371e-05,7.074097897233022e-06,10,6,4
20198,invent,1.278340387257504e-05,3.6233184351681345e-06,8,6,2
20199,invented,4.400843956132392e-06,1.9151826014460126e-05,13,2,11
20200,inventing,4.400843956132392e-06,1.8979287041356905e-06,3,2,1
20201,invention,2.3052039770217305e-06,1.2250267090330355e-05,8,1,7
20202,inventor,2.116596378901769e-05,1.3975656821362803e-05,18,10,8
20203,inventory,2.095639979110664e-07,5.348708166200577e-06,5,2,3
20204,invest,4.840928351745632e-05,3.8131113055817005e-05,49,24,25
20205,invested,2.954852370546031e-05,2.087721574549256e-05,28,16,12
20206,investigate,0.00010499156295344414,9.334358444885519e-05,118,56,62
20207,investigated,4.840928351745632e-05,4.1581892517881935e-05,50,24,26
20208,investigating,9.03220830996695e-05,0.00010714670229711469,117,48,69
20209,investigation,0.0004423895995902609,0.00034870126464165704,449,225,224
20210,investigative,1.278340387257504e-05,2.777877466962238e-05,23,7,16
20211,investigator,5.6791843433898893e-05,5.883578982820635e-05,67,27,40
20212,investing,4.840928351745632e-05,3.8131113055817005e-05,50,25,25
20213,investment,0.00015947820241032126,0.00011577365095227703,160,83,77
20214,investor,9.870464301611217e-05,0.00010887209202814718,122,51,71
20215,invisibility,2.095639979110664e-07,5.348708166200577e-06,4,1,3
20216,invisible,1.278340387257504e-05,1.3975656821362803e-05,15,6,9
20217,invitation,1.0687763893464371e-05,1.3975656821362803e-05,15,6,9
20218,invite,2.954852370546031e-05,2.087721574549256e-05,30,15,15
20219,invited,2.5357243747239038e-05,3.468033359375216e-05,35,12,23
20220,inviting,6.496483935243052e-06,5.348708166200577e-06,6,3,3
20221,invoke,4.400843956132392e-06,1.7253897310324457e-07,3,3,0
20222,invoked,2.3052039770217305e-06,1.052487735929791e-05,8,2,6
20223,invoking,4.400843956132392e-06,5.348708166200577e-06,5,2,3
20224,involf,1.9070323809907035e-05,1.742643628342769e-05,20,10,10
20225,involuntary,2.3052039770217305e-06,5.348708166200577e-06,4,1,3
20226,involve,1.278340387257504e-05,1.3975656821362803e-05,14,6,8
20227,involved,0.0001741476822640959,0.00014683066611086105,187,90,97
20228,involvement,4.840928351745632e-05,6.573734875233614e-05,68,26,42
20229,involving,6.72700433294523e-05,4.6758061710979285e-05,64,35,29
20230,iodine,4.400843956132392e-06,3.6233184351681345e-06,4,2,2
20231,iranian,2.3052039770217305e-06,3.6233184351681345e-06,3,1,2
20232,ire,2.3052039770217305e-06,7.074097897233022e-06,7,2,5
20233,iron,1.9070323809907035e-05,1.9151826014460126e-05,21,10,11
20234,ironic,1.0687763893464371e-05,1.2250267090330355e-05,14,6,8
20235,ironically,4.400843956132392e-06,8.79948762826546e-06,7,2,5
20236,irony,1.9070323809907035e-05,1.9151826014460126e-05,20,9,11
20237,irrational,2.095639979110664e-07,7.074097897233022e-06,4,0,4
20238,irrefutable,4.400843956132392e-06,1.8979287041356905e-06,3,2,1
20239,irregular,4.400843956132392e-06,7.074097897233022e-06,8,3,5
20240,irregularity,4.400843956132392e-06,3.6233184351681345e-06,4,2,2
20241,irrelevant,6.496483935243052e-06,3.6233184351681345e-06,8,5,3
20242,irreparable,8.592123914353715e-06,3.6233184351681345e-06,6,4,2
20243,irrespective,2.3052039770217305e-06,1.8979287041356905e-06,3,1,2
20244,irresponsibility,2.095639979110664e-07,7.074097897233022e-06,4,0,4
20245,irresponsible,1.48790438516857e-05,1.3975656821362803e-05,19,7,12
20246,irreversible,1.6974683830796368e-05,8.79948762826546e-06,15,9,6
20247,irrigation,8.592123914353715e-06,1.8979287041356905e-06,5,4,1
20248,irritated,2.095639979110664e-07,5.348708166200577e-06,3,0,3
20249,islamic,4.400843956132392e-06,1.8979287041356905e-06,3,2,1
20250,island,0.0001825302421805385,0.00020549391696596386,225,100,125
20251,islander,8.592123914353715e-06,5.348708166200577e-06,7,4,3
20252,isn,4.6313643538345614e-05,5.1934230904076595e-05,62,27,35
20253,isolate,1.0687763893464371e-05,3.6233184351681345e-06,8,6,2
20254,isolated,2.954852370546031e-05,2.2602605476525032e-05,30,14,16
20255,isolation,4.400843956132392e-06,2.087721574549256e-05,20,4,16
20256,isolationist,4.400843956132392e-06,1.8979287041356905e-06,3,2,1
20257,issue,0.00045496343946492464,0.0005333179658621288,585,244,341
20258,issued,0.00013013924270277222,0.0001278513790695043,152,68,84
20259,issuing,1.278340387257504e-05,1.570104655239525e-05,18,6,12
20260,it,0.00015109564249387862,0.00016753534288325053,190,82,108
20261,italian,4.400843956132392e-06,3.6233184351681345e-06,4,2,2
20262,item,4.6313643538345614e-05,5.3659620635109e-05,55,23,32
20263,iteration,4.400843956132392e-06,1.8979287041356905e-06,3,2,1
20264,itll,1.48790438516857e-05,1.9151826014460126e-05,20,8,12
20265,ivory,6.307876337123095e-05,5.3659620635109e-05,64,32,32
20266,jab,6.496483935243052e-06,8.79948762826546e-06,12,4,8
20267,jacket,8.592123914353715e-06,5.348708166200577e-06,7,4,3
20268,jacking,4.400843956132392e-06,1.8979287041356905e-06,3,2,1
20269,jackpot,1.278340387257504e-05,1.052487735929791e-05,13,6,7
20270,jail,0.00035646836044672355,0.00031074269055894344,395,190,205
20271,jailed,0.00016366948236854273,0.00017616229153841266,202,86,116
20272,jailer,2.095639979110664e-07,7.074097897233022e-06,4,0,4
20273,jailhouse,6.496483935243052e-06,3.6233184351681345e-06,6,3,3
20274,jailing,2.116596378901769e-05,8.79948762826546e-06,16,10,6
20275,jam,1.6974683830796368e-05,7.074097897233022e-06,16,10,6
20276,jamming,6.496483935243052e-06,5.348708166200577e-06,7,3,4
20277,janitor,2.3052039770217305e-06,1.8979287041356905e-06,3,1,2
20278,japanese,2.3052039770217305e-06,3.6233184351681345e-06,3,1,2
20279,jar,8.592123914353715e-06,1.8979287041356905e-06,6,4,2
20280,jaw,6.496483935243052e-06,8.79948762826546e-06,10,5,5
20281,jawbone,6.496483935243052e-06,1.8979287041356905e-06,4,3,1
20282,jealou,6.496483935243052e-06,1.8979287041356905e-06,4,3,1
20283,jean,4.400843956132392e-06,5.348708166200577e-06,7,2,5
20284,jeep,2.3052039770217305e-06,3.6233184351681345e-06,3,1,2
20285,jellyfish,2.3052039770217305e-06,3.6233184351681345e-06,5,2,3
20286,jeopardize,8.592123914353715e-06,1.052487735929791e-05,10,4,6
20287,jeopardy,8.592123914353715e-06,7.074097897233022e-06,10,4,6
20288,jerk,4.400843956132392e-06,8.79948762826546e-06,8,3,5
20289,jersey,2.095639979110664e-07,5.348708166200577e-06,3,0,3
20290,jet,0.00018462588215964923,0.0001520068353039585,195,94,101
20291,jewel,1.0687763893464371e-05,1.570104655239525e-05,15,5,10
20292,jewellery,2.3052039770217305e-06,3.6233184351681345e-06,4,2,2
20293,jewelry,1.278340387257504e-05,5.348708166200577e-06,10,6,4
20294,jibe,2.3052039770217305e-06,3.6233184351681345e-06,3,1,2
20295,jihad,2.7452883726349685e-05,2.2602605476525032e-05,26,13,13
20296,jihadi,1.9070323809907035e-05,1.2250267090330355e-05,19,12,7
20297,jihadist,4.840928351745632e-05,6.056117955923882e-05,65,27,38
20298,jitter,4.400843956132392e-06,1.8979287041356905e-06,3,2,1
20299,jo,1.0687763893464371e-05,8.79948762826546e-06,12,6,6
20300,job,0.0005241195587755767,0.0005988827756413617,663,281,382
20301,jobles,1.9070323809907035e-05,2.087721574549256e-05,21,9,12
20302,joblessnes,2.095639979110664e-07,7.074097897233022e-06,4,0,4
20303,jobseeker,6.496483935243052e-06,1.8979287041356905e-06,5,4,1
20304,join,0.00028731224113607147,0.00021584625535215864,293,149,144
20305,joined,6.517440335034157e-05,7.436429740749831e-05,82,35,47
20306,joining,5.4696203454788295e-05,5.711040009717395e-05,63,26,37
20307,joint,6.098312339212028e-05,6.573734875233614e-05,77,31,46
20308,jointly,4.400843956132392e-06,5.348708166200577e-06,6,2,4
20309,joke,6.72700433294523e-05,5.1934230904076595e-05,69,33,36
20310,joked,6.496483935243052e-06,1.052487735929791e-05,9,3,6
20311,joking,1.48790438516857e-05,5.348708166200577e-06,10,7,3
20312,jolly,4.400843956132392e-06,1.7253897310324457e-07,3,3,0
20313,jolt,2.3052039770217305e-06,5.348708166200577e-06,6,2,4
20314,journal,1.6974683830796368e-05,2.4327995207557487e-05,22,8,14
20315,journalism,3.1644163684570994e-05,2.2602605476525032e-05,31,18,13
20316,journalist,0.00036694656034227697,0.00032799658786926807,406,194,212
20317,journalistic,8.592123914353715e-06,5.348708166200577e-06,7,4,3
20318,journey,4.212236358012434e-05,2.9504164400654783e-05,42,22,20
20319,joy,1.278340387257504e-05,2.9504164400654783e-05,23,6,17
20320,joyful,2.3052039770217305e-06,5.348708166200577e-06,4,1,3
20321,judge,0.0003124599208853996,0.0003003903521727485,358,165,193
20322,judged,4.400843956132392e-06,5.348708166200577e-06,7,3,4
20323,judgement,8.592123914353715e-06,1.8979287041356905e-06,6,4,2
20324,judgeship,2.095639979110664e-07,7.074097897233022e-06,5,1,4
20325,judging,6.496483935243052e-06,1.8979287041356905e-06,4,3,1
20326,judgment,1.9070323809907035e-05,3.2954943862719716e-05,30,10,20
20327,judicial,4.4218003559234974e-05,3.640572332478458e-05,47,24,23
20328,judiciary,1.278340387257504e-05,1.742643628342769e-05,17,6,11
20329,juggernaut,8.592123914353715e-06,1.7253897310324457e-07,7,5,2
20330,juice,4.400843956132392e-06,1.2250267090330355e-05,10,2,8
20331,jump,5.260056347567764e-05,5.020884117304414e-05,60,26,34
20332,jumped,2.5357243747239038e-05,1.742643628342769e-05,22,12,10
20333,jumper,4.400843956132392e-06,1.8979287041356905e-06,3,2,1
20334,jumping,1.6974683830796368e-05,7.074097897233022e-06,13,9,4
20335,juncture,4.400843956132392e-06,1.8979287041356905e-06,4,2,2
20336,jungle,2.7452883726349685e-05,1.742643628342769e-05,25,14,11
20337,junior,1.48790438516857e-05,8.79948762826546e-06,14,7,7
20338,junk,1.6974683830796368e-05,1.9151826014460126e-05,23,9,14
20339,junkie,2.3052039770217305e-06,3.6233184351681345e-06,3,1,2
20340,junky,2.095639979110664e-07,5.348708166200577e-06,3,0,3
20341,junta,8.592123914353715e-06,8.79948762826546e-06,12,4,8
20342,jurisdiction,1.0687763893464371e-05,2.4327995207557487e-05,21,6,15
20343,juror,8.592123914353715e-06,7.074097897233022e-06,8,4,4
20344,jury,6.936568330856297e-05,5.3659620635109e-05,70,33,37
20345,justice,0.00028521660115696105,0.00026243177809003493,324,150,174
20346,justifiable,4.400843956132392e-06,1.8979287041356905e-06,3,2,1
20347,justification,1.48790438516857e-05,1.9151826014460126e-05,18,7,11
20348,justified,3.7931083621902995e-05,1.570104655239525e-05,34,20,14
20349,justify,3.1644163684570994e-05,2.9504164400654783e-05,36,17,19
20350,justifying,4.400843956132392e-06,1.8979287041356905e-06,3,2,1
20351,juvenile,4.400843956132392e-06,1.3975656821362803e-05,13,5,8
20352,kamikaze,4.400843956132392e-06,1.8979287041356905e-06,3,2,1
20353,kangaroo,4.400843956132392e-06,1.7253897310324457e-07,3,3,0
20354,keen,4.400843956132392e-06,1.7253897310324457e-07,3,2,1
20355,keep,0.00041933755982004344,0.0003780328900692085,474,224,250
20356,keeper,2.095639979110664e-07,3.6233184351681345e-06,3,1,2
20357,keeping,0.00010080028299522283,6.401195902130366e-05,92,51,41
20358,kept,0.00011127848289077625,9.679436391092026e-05,120,55,65
20359,kerosene,2.3052039770217305e-06,3.6233184351681345e-06,3,1,2
20360,kettle,6.496483935243052e-06,1.8979287041356905e-06,4,3,1
20361,kettling,6.496483935243052e-06,3.6233184351681345e-06,5,3,2
20362,key,0.0002265386817418625,0.0002520794397038401,281,122,159
20363,keyboard,6.496483935243052e-06,1.7253897310324457e-07,3,3,0
20364,keynote,8.592123914353715e-06,7.074097897233022e-06,8,4,4
20365,kg,1.278340387257504e-05,1.3975656821362803e-05,14,6,8
20366,khat,2.3052039770217305e-06,5.348708166200577e-06,4,1,3
20367,kibbutz,2.095639979110664e-07,5.348708166200577e-06,3,0,3
20368,kick,2.7452883726349685e-05,5.3659620635109e-05,49,15,34
20369,kicked,2.954852370546031e-05,4.330728224891437e-05,42,14,28
20370,kicker,4.400843956132392e-06,5.348708166200577e-06,6,2,4
20371,kicking,1.6974683830796368e-05,8.79948762826546e-06,13,8,5
20372,kid,0.0001971997220343134,0.00020376852723493182,251,107,144
20373,kidding,1.0687763893464371e-05,3.6233184351681345e-06,10,7,3
20374,kidnap,3.1644163684570994e-05,3.122955413168725e-05,36,16,20
20375,kidnapped,6.72700433294523e-05,7.608968713853079e-05,84,35,49
20376,kidnapper,2.3052039770217305e-06,7.074097897233022e-06,7,3,4
20377,kidnapping,4.840928351745632e-05,3.985650278684949e-05,53,27,26
20378,kidney,2.116596378901769e-05,1.9151826014460126e-05,22,11,11
20379,kids,4.400843956132392e-06,1.8979287041356905e-06,3,2,1
20380,kill,0.0006016582380026713,0.0006057843345654911,707,314,393
20381,killed,0.0011800548722372137,0.0010888934592545763,1341,621,720
20382,killer,9.660900303700153e-05,8.644202552472544e-05,107,48,59
20383,killing,0.0004926849590889169,0.000469478545813928,560,258,302
20384,kilo,2.3052039770217305e-06,3.6233184351681345e-06,3,1,2
20385,kilogram,4.400843956132392e-06,8.79948762826546e-06,7,2,5
20386,kilometer,2.326160376812834e-05,1.570104655239525e-05,23,12,11
20387,kilometre,6.496483935243052e-06,1.052487735929791e-05,9,3,6
20388,kind,0.0001783389622223174,0.0002020431375038992,229,95,134
20389,kinda,2.3052039770217305e-06,7.074097897233022e-06,5,1,4
20390,kindergarten,1.278340387257504e-05,1.2250267090330355e-05,14,6,8
20391,kindly,6.496483935243052e-06,3.6233184351681345e-06,5,3,2
20392,kindnes,6.496483935243052e-06,1.2250267090330355e-05,15,6,9
20393,king,5.4696203454788295e-05,3.640572332478458e-05,56,32,24
20394,kingdom,3.3739803663681634e-05,3.122955413168725e-05,37,18,19
20395,kingpin,1.0687763893464371e-05,1.052487735929791e-05,13,6,7
20396,kiosk,2.095639979110664e-07,7.074097897233022e-06,4,0,4
20397,kippa,4.400843956132392e-06,1.8979287041356905e-06,3,2,1
20398,kis,1.0687763893464371e-05,1.742643628342769e-05,17,6,11
20399,kissed,8.592123914353715e-06,5.348708166200577e-06,7,4,3
20400,kissing,1.48790438516857e-05,1.8979287041356905e-06,9,7,2
20401,kit,1.6974683830796368e-05,1.052487735929791e-05,16,8,8
20402,kitchen,2.116596378901769e-05,1.3975656821362803e-05,20,12,8
20403,kite,2.095639979110664e-07,3.6233184351681345e-06,4,2,2
20404,kitten,8.592123914353715e-06,5.348708166200577e-06,8,4,4
20405,km,2.5357243747239038e-05,2.777877466962238e-05,28,12,16
20406,knack,2.3052039770217305e-06,3.6233184351681345e-06,3,1,2
20407,knee,1.48790438516857e-05,8.79948762826546e-06,13,8,5
20408,kneel,4.400843956132392e-06,3.6233184351681345e-06,5,3,2
20409,kneeling,2.3052039770217305e-06,5.348708166200577e-06,6,2,4
20410,knew,0.00010708720293255492,0.0001019705331040174,117,54,63
20411,knife,2.7452883726349685e-05,4.50326719799468e-05,40,14,26
20412,knight,4.400843956132392e-06,1.8979287041356905e-06,3,2,1
20413,knighthood,4.400843956132392e-06,3.6233184351681345e-06,4,2,2
20414,knock,4.400843956132392e-06,1.742643628342769e-05,14,4,10
20415,knocked,8.592123914353715e-06,1.052487735929791e-05,10,4,6
20416,knocking,2.3052039770217305e-06,7.074097897233022e-06,7,1,6
20417,knot,8.592123914353715e-06,1.7253897310324457e-07,4,4,0
20418,know,0.0007378748366448642,0.000783499476861833,883,374,509
20419,knowing,3.1644163684570994e-05,3.640572332478458e-05,39,16,23
20420,knowingly,1.0687763893464371e-05,3.6233184351681345e-06,8,6,2
20421,knowledge,6.098312339212028e-05,5.711040009717395e-05,70,32,38
20422,known,0.00020348664197164515,0.00025553021916590484,269,108,161
20423,kosher,4.400843956132392e-06,7.074097897233022e-06,7,2,5
20424,kratom,2.095639979110664e-07,3.6233184351681345e-06,3,0,3
20425,krone,6.496483935243052e-06,5.348708166200577e-06,6,3,3
20426,kronor,4.400843956132392e-06,1.8979287041356905e-06,3,2,1
20427,la,8.592123914353715e-06,1.8979287041356905e-06,6,4,2
20428,lab,2.326160376812834e-05,1.3975656821362803e-05,21,12,9
20429,label,3.1644163684570994e-05,4.1581892517881935e-05,40,16,24
20430,labeled,8.592123914353715e-06,1.3975656821362803e-05,16,5,11
20431,labeling,1.278340387257504e-05,1.8979287041356905e-06,7,6,1
20432,labelled,1.0687763893464371e-05,1.2250267090330355e-05,15,5,10
20433,labelling,6.496483935243052e-06,1.8979287041356905e-06,6,3,3
20434,labor,0.00010918284291166549,0.00011232287149021227,133,60,73
20435,laboratory,1.9070323809907035e-05,1.052487735929791e-05,16,10,6
20436,laborer,6.496483935243052e-06,1.2250267090330355e-05,11,3,8
20437,labour,2.7452883726349685e-05,4.6758061710979285e-05,43,13,30
20438,labourer,2.3052039770217305e-06,7.074097897233022e-06,5,1,4
20439,laced,2.095639979110664e-07,7.074097897233022e-06,4,0,4
20440,lack,0.0001154697628489974,0.0001571830044970555,163,65,98
20441,lacked,1.0687763893464371e-05,5.348708166200577e-06,8,5,3
20442,lacking,1.6974683830796368e-05,8.79948762826546e-06,13,8,5
20443,lackluster,4.400843956132392e-06,3.6233184351681345e-06,4,2,2
20444,ladder,4.400843956132392e-06,7.074097897233022e-06,6,2,4
20445,laden,2.3052039770217305e-06,3.6233184351681345e-06,4,2,2
20446,lady,5.6791843433898893e-05,6.401195902130366e-05,71,31,40
20447,lag,1.0687763893464371e-05,7.074097897233022e-06,10,5,5
20448,lagging,6.496483935243052e-06,3.6233184351681345e-06,6,3,3
20449,lagoon,2.095639979110664e-07,7.074097897233022e-06,5,1,4
20450,laid,2.954852370546031e-05,2.2602605476525032e-05,30,16,14
20451,lake,2.5357243747239038e-05,3.122955413168725e-05,35,13,22
20452,lamb,2.095639979110664e-07,7.074097897233022e-06,4,0,4
20453,lambast,6.496483935243052e-06,1.7253897310324457e-07,4,3,1
20454,lambasted,4.400843956132392e-06,1.052487735929791e-05,8,2,6
20455,lame,2.095639979110664e-07,8.79948762826546e-06,5,0,5
20456,lamented,2.095639979110664e-07,3.6233184351681345e-06,3,1,2
20457,lamenting,4.400843956132392e-06,3.6233184351681345e-06,4,2,2
20458,lamp,2.3052039770217305e-06,1.8979287041356905e-06,3,1,2
20459,land,0.000304077360968957,0.00035042665437268953,382,164,218
20460,landed,1.6974683830796368e-05,1.9151826014460126e-05,23,10,13
20461,lander,6.496483935243052e-06,1.8979287041356905e-06,4,3,1
20462,landfall,2.095639979110664e-07,5.348708166200577e-06,3,0,3
20463,landfill,8.592123914353715e-06,8.79948762826546e-06,9,4,5
20464,landing,1.9070323809907035e-05,4.8483451442011706e-05,42,10,32
20465,landlord,8.592123914353715e-06,1.052487735929791e-05,10,4,6
20466,landmark,6.517440335034157e-05,5.711040009717395e-05,70,33,37
20467,landmine,1.6974683830796368e-05,1.3975656821362803e-05,17,9,8
20468,landowner,4.400843956132392e-06,5.348708166200577e-06,6,2,4
20469,landscape,2.954852370546031e-05,2.087721574549256e-05,28,15,13
20470,landslide,8.592123914353715e-06,2.2602605476525032e-05,20,4,16
20471,lane,1.0687763893464371e-05,2.2602605476525032e-05,20,6,14
20472,language,0.00010499156295344414,0.00010024514337298497,124,57,67
20473,languish,2.3052039770217305e-06,3.6233184351681345e-06,5,1,4
20474,lap,2.3052039770217305e-06,5.348708166200577e-06,4,1,3
20475,lapse,2.3052039770217305e-06,1.3975656821362803e-05,9,1,8
20476,laptop,2.5357243747239038e-05,2.777877466962238e-05,29,13,16
20477,large,0.00016576512234765329,0.00018996540938667205,208,86,122
20478,largely,5.6791843433898893e-05,6.056117955923882e-05,71,32,39
20479,larger,4.212236358012434e-05,5.3659620635109e-05,59,25,34
20480,largescale,3.1644163684570994e-05,1.570104655239525e-05,24,15,9
20481,largest,0.00037532912025871974,0.0003814836695312734,431,190,241
20482,largestever,6.496483935243052e-06,3.6233184351681345e-06,5,3,2
20483,laser,1.278340387257504e-05,8.79948762826546e-06,13,8,5
20484,lash,4.212236358012434e-05,5.5385010366141504e-05,56,23,33
20485,lashed,1.6974683830796368e-05,1.2250267090330355e-05,16,8,8
20486,lashing,4.400843956132392e-06,5.348708166200577e-06,7,2,5
20487,last,0.0010585077534487955,0.0009939970240477913,1200,550,650
20488,lastditch,4.400843956132392e-06,3.6233184351681345e-06,5,2,3
20489,lasted,4.400843956132392e-06,1.3975656821362803e-05,10,2,8
20490,lasting,1.0687763893464371e-05,1.570104655239525e-05,15,5,10
20491,lastminute,1.9070323809907035e-05,8.79948762826546e-06,16,9,7
20492,lastresort,4.400843956132392e-06,1.7253897310324457e-07,3,2,1
20493,late,0.00013642616264010403,0.00017788768126944505,182,72,110
20494,lately,2.326160376812834e-05,1.2250267090330355e-05,20,12,8
20495,latenight,2.3052039770217305e-06,3.6233184351681345e-06,3,1,2
20496,later,0.00016157384238943198,0.00016580995315221804,193,86,107
20497,latest,0.00028940788111518276,0.00033834892625546234,368,148,220
20498,latimescom,4.400843956132392e-06,3.6233184351681345e-06,4,2,2
20499,latrine,2.095639979110664e-07,7.074097897233022e-06,4,0,4
20500,latte,4.400843956132392e-06,5.348708166200577e-06,5,2,3
20501,latter,2.3052039770217305e-06,7.074097897233022e-06,8,3,5
20502,lauded,8.592123914353715e-06,1.8979287041356905e-06,5,4,1
20503,laugh,2.116596378901769e-05,2.4327995207557487e-05,27,11,16
20504,laughable,2.095639979110664e-07,1.2250267090330355e-05,7,0,7
20505,laughed,4.400843956132392e-06,8.79948762826546e-06,7,2,5
20506,laughing,1.6974683830796368e-05,1.3975656821362803e-05,18,9,9
20507,laughter,2.3052039770217305e-06,8.79948762826546e-06,7,2,5
20508,launch,0.00028102532119873944,0.00024172710131764556,305,150,155
20509,launched,0.00016157384238943198,0.0001364783277246665,173,85,88
20510,launcher,2.326160376812834e-05,1.052487735929791e-05,19,12,7
20511,launching,3.1644163684570994e-05,3.2954943862719716e-05,38,16,22
20512,launder,2.3052039770217305e-06,3.6233184351681345e-06,5,2,3
20513,laundered,4.400843956132392e-06,1.8979287041356905e-06,3,2,1
20514,laundering,3.3739803663681634e-05,3.8131113055817005e-05,41,18,23
20515,laundry,2.095639979110664e-07,7.074097897233022e-06,6,0,6
20516,laureate,2.116596378901769e-05,2.2602605476525032e-05,25,11,14
20517,lava,2.3052039770217305e-06,3.6233184351681345e-06,3,1,2
20518,lavish,2.326160376812834e-05,1.2250267090330355e-05,20,11,9
20519,law,0.0013414191506287356,0.0013822097135300908,1616,719,897
20520,lawful,1.278340387257504e-05,8.79948762826546e-06,13,6,7
20521,lawles,2.3052039770217305e-06,3.6233184351681345e-06,4,2,2
20522,lawlessnes,4.400843956132392e-06,7.074097897233022e-06,7,2,5
20523,lawmaker,0.00023701688163741595,0.0002900380137865542,306,125,181
20524,lawn,4.400843956132392e-06,5.348708166200577e-06,7,4,3
20525,lawsuit,0.0001783389622223174,0.00017271151207634748,202,93,109
20526,lawyer,0.0002537820014703013,0.00026243177809003493,302,134,168
20527,lax,2.3052039770217305e-06,7.074097897233022e-06,5,1,4
20528,lay,4.002672360101368e-05,5.1934230904076595e-05,58,25,33
20529,layer,1.278340387257504e-05,1.570104655239525e-05,16,6,10
20530,laying,2.326160376812834e-05,1.3975656821362803e-05,19,11,8
20531,layoff,1.0687763893464371e-05,8.79948762826546e-06,11,5,6
20532,lazy,4.400843956132392e-06,8.79948762826546e-06,8,2,6
20533,lb,1.278340387257504e-05,5.348708166200577e-06,9,6,3
20534,le,0.00030617300094806777,0.00034697587491062454,399,167,232
20535,lead,0.0003355119606556169,0.00033489814679339735,394,180,214
20536,leader,0.0010522208335114636,0.0010336809878615377,1198,543,655
20537,leadership,0.0001259479627445509,0.0001364783277246665,153,64,89
20538,leading,0.00018672152213876006,0.00016926073261428268,219,106,113
20539,leadup,2.3052039770217305e-06,3.6233184351681345e-06,3,1,2
20540,leaf,0.00010080028299522283,0.00010714670229711469,116,52,64
20541,leaflet,2.116596378901769e-05,1.2250267090330355e-05,23,10,13
20542,leafy,2.3052039770217305e-06,3.6233184351681345e-06,3,1,2
20543,league,6.496483935243052e-06,1.052487735929791e-05,10,4,6
20544,leak,0.0001825302421805385,0.00017098612234531542,211,94,117
20545,leaked,0.00010708720293255492,9.679436391092026e-05,118,55,63
20546,leaker,1.0687763893464371e-05,1.742643628342769e-05,18,7,11
20547,leaking,4.6313643538345614e-05,4.6758061710979285e-05,54,27,27
20548,lean,6.496483935243052e-06,7.074097897233022e-06,8,4,4
20549,leaning,4.400843956132392e-06,7.074097897233022e-06,7,2,5
20550,leap,1.278340387257504e-05,1.2250267090330355e-05,16,8,8
20551,leapt,2.3052039770217305e-06,3.6233184351681345e-06,3,1,2
20552,learn,9.660900303700153e-05,0.0001036959228350498,125,53,72
20553,learned,6.517440335034157e-05,8.299124606266055e-05,87,35,52
20554,learner,4.400843956132392e-06,1.7253897310324457e-07,3,2,1
20555,learning,4.840928351745632e-05,7.436429740749831e-05,74,25,49
20556,learnt,6.496483935243052e-06,7.074097897233022e-06,8,3,5
20557,lease,1.6974683830796368e-05,3.6233184351681345e-06,13,11,2
20558,leash,4.400843956132392e-06,1.8979287041356905e-06,3,2,1
20559,leasing,2.3052039770217305e-06,3.6233184351681345e-06,4,2,2
20560,least,0.0005995625980235608,0.0005868050475241346,703,317,386
20561,leather,6.496483935243052e-06,5.348708166200577e-06,6,3,3
20562,leave,0.00025797328142852257,0.0002727841164762295,320,138,182
20563,leaving,0.00013642616264010403,0.0001295767688005365,157,76,81
20564,lecture,1.48790438516857e-05,1.2250267090330355e-05,16,9,7
20565,lecturer,2.095639979110664e-07,3.6233184351681345e-06,3,1,2
20566,led,0.0001825302421805385,0.00016063378395912072,196,94,102
20567,leeway,6.496483935243052e-06,1.7253897310324457e-07,3,3,0
20568,left,0.000385807320154273,0.00035042665437268953,416,195,221
20569,leftist,2.7452883726349685e-05,8.79948762826546e-06,20,14,6
20570,leftleaning,4.400843956132392e-06,1.8979287041356905e-06,3,2,1
20571,leftover,6.496483935243052e-06,5.348708166200577e-06,7,3,4
20572,leftwing,6.496483935243052e-06,1.052487735929791e-05,10,4,6
20573,leg,4.4218003559234974e-05,3.2954943862719716e-05,44,23,21
20574,legacy,3.7931083621902995e-05,4.8483451442011706e-05,51,19,32
20575,legal,0.0003459901605511704,0.0003694059414140463,422,183,239
20576,legalisation,2.095639979110664e-07,3.6233184351681345e-06,3,0,3
20577,legalise,2.954852370546031e-05,2.2602605476525032e-05,29,14,15
20578,legalised,8.592123914353715e-06,5.348708166200577e-06,7,4,3
20579,legalising,6.496483935243052e-06,5.348708166200577e-06,6,3,3
20580,legality,4.400843956132392e-06,7.074097897233022e-06,9,3,6
20581,legalization,4.4218003559234974e-05,5.711040009717395e-05,68,28,40
20582,legalize,4.6313643538345614e-05,5.711040009717395e-05,62,25,37
20583,legalized,1.6974683830796368e-05,2.4327995207557487e-05,26,9,17
20584,legalizing,1.6974683830796368e-05,2.4327995207557487e-05,26,8,18
20585,legally,4.4218003559234974e-05,4.50326719799468e-05,52,22,30
20586,legend,1.278340387257504e-05,1.052487735929791e-05,15,8,7
20587,legendary,8.592123914353715e-06,8.79948762826546e-06,12,5,7
20588,legion,2.3052039770217305e-06,1.3975656821362803e-05,10,1,9
20589,legislate,2.3052039770217305e-06,1.052487735929791e-05,8,2,6
20590,legislation,0.0002055822819507562,0.00023655093212454826,256,108,148
20591,legislative,2.954852370546031e-05,5.883578982820635e-05,54,15,39
20592,legislator,3.583544364279237e-05,3.985650278684949e-05,46,20,26
20593,legislature,2.5357243747239038e-05,5.3659620635109e-05,45,14,31
20594,legit,4.400843956132392e-06,1.8979287041356905e-06,4,3,1
20595,legitimacy,2.116596378901769e-05,1.742643628342769e-05,20,10,10
20596,legitimate,2.5357243747239038e-05,3.985650278684949e-05,41,16,25
20597,legitimately,4.400843956132392e-06,1.7253897310324457e-07,3,2,1
20598,legitimise,4.400843956132392e-06,1.8979287041356905e-06,3,2,1
20599,legitimize,4.400843956132392e-06,1.8979287041356905e-06,3,2,1
20600,legitimized,4.400843956132392e-06,3.6233184351681345e-06,4,2,2
20601,lemon,2.3052039770217305e-06,5.348708166200577e-06,5,1,4
20602,len,2.095639979110664e-07,5.348708166200577e-06,4,0,4
20603,lend,1.278340387257504e-05,1.9151826014460126e-05,19,8,11
20604,lender,4.4218003559234974e-05,2.2602605476525032e-05,38,24,14
20605,lending,6.496483935243052e-06,8.79948762826546e-06,11,4,7
20606,length,1.0687763893464371e-05,1.9151826014460126e-05,19,7,12
20607,lengthy,6.496483935243052e-06,1.3975656821362803e-05,14,5,9
20608,leniency,2.095639979110664e-07,5.348708166200577e-06,3,0,3
20609,lenient,2.095639979110664e-07,7.074097897233022e-06,4,0,4
20610,lent,4.400843956132392e-06,3.6233184351681345e-06,4,2,2
20611,leopard,1.48790438516857e-05,8.79948762826546e-06,12,7,5
20612,leprosy,2.3052039770217305e-06,3.6233184351681345e-06,3,1,2
20613,lesbian,2.5357243747239038e-05,3.640572332478458e-05,37,15,22
20614,lessen,1.0687763893464371e-05,3.6233184351681345e-06,8,5,3
20615,lesser,2.095639979110664e-07,5.348708166200577e-06,3,0,3
20616,lesson,9.660900303700153e-05,7.954046660059569e-05,100,50,50
20617,let,0.00028521660115696105,0.0002900380137865542,338,150,188
20618,lethal,2.5357243747239038e-05,2.2602605476525032e-05,28,14,14
20619,letter,0.0002055822819507562,0.00018133846073150993,224,105,119
20620,letting,3.7931083621902995e-05,3.640572332478458e-05,44,21,23
20621,lettuce,2.095639979110664e-07,1.8979287041356905e-06,3,0,3
20622,leukemia,4.400843956132392e-06,5.348708166200577e-06,7,2,5
20623,level,0.0003166512008436211,0.0002986649624417165,360,170,190
20624,leveled,2.3052039770217305e-06,5.348708166200577e-06,7,3,4
20625,leverage,2.116596378901769e-05,1.2250267090330355e-05,17,10,7
20626,leveraging,6.496483935243052e-06,8.79948762826546e-06,8,3,5
20627,levy,1.0687763893464371e-05,1.8979287041356905e-06,8,6,2
20628,lewd,4.400843956132392e-06,7.074097897233022e-06,6,2,4
20629,liability,3.3739803663681634e-05,1.742643628342769e-05,29,17,12
20630,liable,1.9070323809907035e-05,8.79948762826546e-06,14,9,5
20631,liaison,2.3052039770217305e-06,3.6233184351681345e-06,3,1,2
20632,liar,1.48790438516857e-05,2.4327995207557487e-05,24,9,15
20633,libel,1.48790438516857e-05,1.9151826014460126e-05,19,7,12
20634,liberal,7.984388320411623e-05,7.954046660059569e-05,93,45,48
20635,liberalism,8.592123914353715e-06,1.7253897310324457e-07,5,5,0
20636,liberate,6.496483935243052e-06,5.348708166200577e-06,11,5,6
20637,liberated,8.592123914353715e-06,3.6233184351681345e-06,6,4,2
20638,liberating,8.592123914353715e-06,1.7253897310324457e-07,4,4,0
20639,liberation,1.48790438516857e-05,7.074097897233022e-06,12,8,4
20640,libertarian,4.400843956132392e-06,3.6233184351681345e-06,4,2,2
20641,liberty,5.050492349656699e-05,4.330728224891437e-05,54,26,28
20642,librarian,6.496483935243052e-06,7.074097897233022e-06,7,3,4
20643,library,2.954852370546031e-05,3.122955413168725e-05,34,14,20
20644,licence,2.326160376812834e-05,1.2250267090330355e-05,20,12,8
20645,license,3.7931083621902995e-05,4.8483451442011706e-05,55,21,34
20646,licensed,2.3052039770217305e-06,7.074097897233022e-06,6,1,5
20647,licensing,4.400843956132392e-06,5.348708166200577e-06,6,2,4
20648,lick,4.400843956132392e-06,1.8979287041356905e-06,3,2,1
20649,licking,2.095639979110664e-07,3.6233184351681345e-06,3,0,3
20650,lid,8.592123914353715e-06,3.6233184351681345e-06,7,4,3
20651,lie,0.00015738256243121094,0.0001295767688005365,173,86,87
20652,lied,4.6313643538345614e-05,3.468033359375216e-05,46,26,20
20653,lieutenant,6.496483935243052e-06,1.742643628342769e-05,13,3,10
20654,life,0.0009579170344514836,0.0009750177370064346,1160,506,654
20655,lifeboat,6.496483935243052e-06,3.6233184351681345e-06,6,3,3
20656,lifechanging,4.400843956132392e-06,1.052487735929791e-05,8,2,6
20657,lifeles,2.3052039770217305e-06,3.6233184351681345e-06,3,1,2
20658,lifeline,1.0687763893464371e-05,7.074097897233022e-06,10,5,5
20659,lifelong,1.278340387257504e-05,7.074097897233022e-06,12,7,5
20660,lifesaving,1.6974683830796368e-05,2.4327995207557487e-05,25,10,15
20661,lifestyle,4.212236358012434e-05,1.3975656821362803e-05,29,20,9
20662,lifethreatening,8.592123914353715e-06,3.6233184351681345e-06,6,4,2
20663,lifetime,3.3739803663681634e-05,2.2602605476525032e-05,32,18,14
20664,lift,6.307876337123095e-05,3.8131113055817005e-05,60,32,28
20665,lifted,1.9070323809907035e-05,3.640572332478458e-05,36,11,25
20666,lifting,1.0687763893464371e-05,2.2602605476525032e-05,21,7,14
20667,liftoff,2.3052039770217305e-06,3.6233184351681345e-06,3,1,2
20668,light,0.00016576512234765329,0.00014683066611086105,183,90,93
20669,lighter,4.400843956132392e-06,1.8979287041356905e-06,4,2,2
20670,lighting,1.278340387257504e-05,1.052487735929791e-05,12,6,6
20671,lightly,8.592123914353715e-06,8.79948762826546e-06,10,5,5
20672,lightning,6.496483935243052e-06,7.074097897233022e-06,8,3,5
20673,lightyear,8.592123914353715e-06,1.8979287041356905e-06,5,4,1
20674,like,0.001194724352090989,0.0012459039247785283,1420,632,788
20675,liked,1.9070323809907035e-05,1.2250267090330355e-05,16,9,7
20676,likeliest,2.3052039770217305e-06,3.6233184351681345e-06,3,1,2
20677,likelihood,1.9070323809907035e-05,1.570104655239525e-05,19,10,9
20678,likely,0.0003732334802796091,0.00036768055168301384,440,198,242
20679,liken,2.3052039770217305e-06,7.074097897233022e-06,6,1,5
20680,likened,6.496483935243052e-06,1.052487735929791e-05,11,5,6
20681,limb,1.48790438516857e-05,8.79948762826546e-06,13,8,5
20682,limbo,6.496483935243052e-06,1.2250267090330355e-05,13,3,10
20683,limestone,4.400843956132392e-06,1.8979287041356905e-06,3,2,1
20684,limit,0.00012385232276544028,0.00014683066611086105,157,62,95
20685,limitation,8.592123914353715e-06,1.8979287041356905e-06,7,4,3
20686,limited,5.6791843433898893e-05,4.6758061710979285e-05,61,30,31
20687,limiting,2.7452883726349685e-05,1.570104655239525e-05,24,13,11
20688,limitles,4.400843956132392e-06,3.6233184351681345e-06,4,2,2
20689,line,0.0002160604818463093,0.00027796028566932717,303,114,189
20690,lineage,2.3052039770217305e-06,5.348708166200577e-06,4,1,3
20691,lined,8.592123914353715e-06,1.3975656821362803e-05,14,5,9
20692,liner,4.400843956132392e-06,3.6233184351681345e-06,4,2,2
20693,lineup,4.400843956132392e-06,3.6233184351681345e-06,4,2,2
20694,linger,6.496483935243052e-06,3.6233184351681345e-06,5,3,2
20695,lingerie,2.3052039770217305e-06,5.348708166200577e-06,4,1,3
20696,lingering,6.496483935243052e-06,7.074097897233022e-06,7,3,4
20697,linguist,2.3052039770217305e-06,7.074097897233022e-06,5,1,4
20698,lining,1.6974683830796368e-05,1.3975656821362803e-05,17,8,9
20699,link,0.00015947820241032126,0.0001485560558418934,181,80,101
20700,linked,0.0001343305226609934,0.00012612598933847184,156,74,82
20701,linking,2.116596378901769e-05,1.2250267090330355e-05,18,10,8
20702,lion,5.888748341300963e-05,5.711040009717395e-05,68,29,39
20703,lip,1.48790438516857e-05,8.79948762826546e-06,13,7,6
20704,lipstick,6.496483935243052e-06,1.7253897310324457e-07,3,3,0
20705,liquid,1.0687763893464371e-05,1.570104655239525e-05,16,5,11
20706,liquor,6.496483935243052e-06,7.074097897233022e-06,7,3,4
20707,list,0.00023282560167919462,0.0002106700861590614,260,121,139
20708,listed,2.7452883726349685e-05,2.4327995207557487e-05,27,13,14
20709,listen,5.050492349656699e-05,4.8483451442011706e-05,56,27,29
20710,listened,1.278340387257504e-05,7.074097897233022e-06,10,6,4
20711,listening,3.3739803663681634e-05,1.3975656821362803e-05,27,18,9
20712,listing,1.48790438516857e-05,1.570104655239525e-05,16,7,9
20713,lit,1.6974683830796368e-05,1.052487735929791e-05,14,8,6
20714,liter,8.592123914353715e-06,5.348708166200577e-06,8,4,4
20715,literacy,1.278340387257504e-05,1.2250267090330355e-05,17,8,9
20716,literally,4.840928351745632e-05,2.9504164400654783e-05,48,29,19
20717,literary,4.400843956132392e-06,1.7253897310324457e-07,3,3,0
20718,literature,1.0687763893464371e-05,1.3975656821362803e-05,15,6,9
20719,lithium,2.3052039770217305e-06,3.6233184351681345e-06,3,1,2
20720,litigation,1.0687763893464371e-05,7.074097897233022e-06,12,6,6
20721,litre,2.116596378901769e-05,1.2250267090330355e-05,18,11,7
20722,litter,2.3052039770217305e-06,1.8979287041356905e-06,3,2,1
20723,littered,6.496483935243052e-06,3.6233184351681345e-06,7,4,3
20724,little,0.00035646836044672355,0.0003072919110968788,392,187,205
20725,littleknown,6.496483935243052e-06,5.348708166200577e-06,6,3,3
20726,livable,4.400843956132392e-06,3.6233184351681345e-06,4,2,2
20727,live,0.0003795204002169411,0.00033834892625546234,423,202,221
20728,lived,4.002672360101368e-05,5.020884117304414e-05,57,23,34
20729,livelihood,1.0687763893464371e-05,1.570104655239525e-05,16,6,10
20730,lively,4.400843956132392e-06,5.348708166200577e-06,5,2,3
20731,liver,4.400843956132392e-06,5.348708166200577e-06,6,2,4
20732,livestock,8.592123914353715e-06,1.052487735929791e-05,10,4,6
20733,living,0.0002726427612822975,0.00023310015266248305,296,146,150
20734,lizard,2.3052039770217305e-06,1.8979287041356905e-06,3,2,1
20735,ll,5.4696203454788295e-05,5.1934230904076595e-05,68,30,38
20736,load,1.48790438516857e-05,1.052487735929791e-05,13,7,6
20737,loaded,1.48790438516857e-05,1.052487735929791e-05,13,7,6
20738,loan,0.0001385218026192147,0.0001347529379936339,163,78,85
20739,loathe,2.3052039770217305e-06,3.6233184351681345e-06,3,1,2
20740,loathed,2.3052039770217305e-06,3.6233184351681345e-06,3,1,2
20741,lobbied,1.0687763893464371e-05,5.348708166200577e-06,9,6,3
20742,lobby,4.002672360101368e-05,5.020884117304414e-05,53,23,30
20743,lobbying,3.1644163684570994e-05,3.8131113055817005e-05,39,15,24
20744,lobbyist,5.050492349656699e-05,3.122955413168725e-05,47,26,21
20745,lobster,6.496483935243052e-06,3.6233184351681345e-06,6,4,2
20746,local,0.00027892968121962896,0.0003193696392141053,348,142,206
20747,locally,6.496483935243052e-06,7.074097897233022e-06,8,4,4
20748,locate,6.496483935243052e-06,1.7253897310324457e-07,5,4,1
20749,located,2.954852370546031e-05,2.087721574549256e-05,28,15,13
20750,location,5.6791843433898893e-05,6.746273848336857e-05,72,31,41
20751,lock,2.326160376812834e-05,1.570104655239525e-05,20,11,9
20752,lockdown,1.278340387257504e-05,1.2250267090330355e-05,13,6,7
20753,locked,5.050492349656699e-05,5.1934230904076595e-05,59,24,35
20754,locker,6.496483935243052e-06,5.348708166200577e-06,6,3,3
20755,locking,2.3052039770217305e-06,7.074097897233022e-06,6,2,4
20756,locust,4.400843956132392e-06,7.074097897233022e-06,6,2,4
20757,lodge,4.400843956132392e-06,5.348708166200577e-06,6,2,4
20758,lodged,1.278340387257504e-05,1.8979287041356905e-06,8,6,2
20759,lofty,2.095639979110664e-07,1.8979287041356905e-06,3,0,3
20760,log,2.116596378901769e-05,2.777877466962238e-05,28,11,17
20761,logged,4.400843956132392e-06,3.6233184351681345e-06,5,2,3
20762,logger,1.278340387257504e-05,1.570104655239525e-05,15,6,9
20763,logging,3.1644163684570994e-05,1.570104655239525e-05,24,15,9
20764,logic,1.9070323809907035e-05,1.570104655239525e-05,19,9,10
20765,logical,4.400843956132392e-06,1.7253897310324457e-07,3,2,1
20766,logistic,6.496483935243052e-06,3.6233184351681345e-06,5,3,2
20767,logo,6.496483935243052e-06,1.052487735929791e-05,11,3,8
20768,lone,1.48790438516857e-05,1.052487735929791e-05,16,8,8
20769,loneliest,4.400843956132392e-06,3.6233184351681345e-06,4,2,2
20770,lonely,1.278340387257504e-05,1.2250267090330355e-05,14,7,7
20771,loner,4.400843956132392e-06,1.8979287041356905e-06,3,2,1
20772,long,0.00043819831963203963,0.00042116763334501973,513,237,276
20773,longawaited,1.0687763893464371e-05,8.79948762826546e-06,10,5,5
20774,longdelayed,2.095639979110664e-07,5.348708166200577e-06,3,0,3
20775,longer,0.00029779044103162505,0.00021239547589009395,292,152,140
20776,longerterm,2.3052039770217305e-06,5.348708166200577e-06,4,1,3
20777,longest,1.9070323809907035e-05,2.777877466962238e-05,28,10,18
20778,longestrunning,2.3052039770217305e-06,3.6233184351681345e-06,3,1,2
20779,longestserving,2.095639979110664e-07,3.6233184351681345e-06,3,0,3
20780,longheld,2.3052039770217305e-06,1.8979287041356905e-06,4,1,3
20781,longlasting,2.3052039770217305e-06,3.6233184351681345e-06,3,1,2
20782,longrange,1.9070323809907035e-05,1.3975656821362803e-05,18,9,9
20783,longrunning,1.0687763893464371e-05,1.3975656821362803e-05,15,6,9
20784,longshot,4.400843956132392e-06,3.6233184351681345e-06,4,2,2
20785,longsought,2.3052039770217305e-06,7.074097897233022e-06,5,1,4
20786,longstanding,1.0687763893464371e-05,2.087721574549256e-05,18,5,13
20787,longterm,6.72700433294523e-05,5.5385010366141504e-05,73,36,37
20788,longtime,3.3739803663681634e-05,3.122955413168725e-05,36,16,20
20789,look,0.000459154719423146,0.00045912620742773343,537,243,294
20790,looked,3.7931083621902995e-05,2.9504164400654783e-05,38,19,19
20791,looking,0.0002181561218254202,0.00020376852723493182,241,111,130
20792,loom,2.116596378901769e-05,1.3975656821362803e-05,22,14,8
20793,loomed,4.400843956132392e-06,1.8979287041356905e-06,3,2,1
20794,looming,1.9070323809907035e-05,2.777877466962238e-05,26,10,16
20795,loop,2.095639979110664e-07,1.8979287041356905e-06,4,1,3
20796,loophole,2.954852370546031e-05,2.2602605476525032e-05,30,15,15
20797,loose,1.48790438516857e-05,1.742643628342769e-05,20,9,11
20798,loosely,2.095639979110664e-07,5.348708166200577e-06,3,0,3
20799,loosen,6.496483935243052e-06,3.6233184351681345e-06,5,3,2
20800,loot,4.400843956132392e-06,7.074097897233022e-06,7,3,4
20801,looted,2.5357243747239038e-05,1.052487735929791e-05,18,12,6
20802,looter,6.496483935243052e-06,3.6233184351681345e-06,6,3,3
20803,looting,1.48790438516857e-05,1.570104655239525e-05,18,7,11
20804,lord,2.7452883726349685e-05,8.79948762826546e-06,19,14,5
20805,lorry,2.095639979110664e-07,7.074097897233022e-06,5,0,5
20806,los,0.00015109564249387862,0.00012094982014537423,158,80,78
20807,lose,0.00023072996170008382,0.0002089446964280291,256,119,137
20808,loser,2.5357243747239038e-05,2.6053384938589907e-05,30,14,16
20809,losing,0.00011756540282810809,0.00011232287149021227,131,62,69
20810,lost,0.0003124599208853996,0.00029521418297965093,349,163,186
20811,lot,0.0003271294007391747,0.0003417997057175273,390,172,218
20812,lottery,2.326160376812834e-05,2.4327995207557487e-05,32,13,19
20813,lotto,4.400843956132392e-06,1.8979287041356905e-06,3,2,1
20814,loud,1.0687763893464371e-05,2.2602605476525032e-05,20,6,14
20815,louder,1.0687763893464371e-05,8.79948762826546e-06,11,6,5
20816,loudest,8.592123914353715e-06,3.6233184351681345e-06,6,4,2
20817,loudly,8.592123914353715e-06,3.6233184351681345e-06,6,4,2
20818,loudspeaker,1.0687763893464371e-05,3.6233184351681345e-06,7,5,2
20819,lounge,2.3052039770217305e-06,5.348708166200577e-06,4,1,3
20820,lousy,2.3052039770217305e-06,5.348708166200577e-06,4,1,3
20821,love,0.00019929536201342395,0.0002313747629314509,256,107,149
20822,loved,3.583544364279237e-05,4.8483451442011706e-05,49,19,30
20823,lovely,2.3052039770217305e-06,5.348708166200577e-06,4,1,3
20824,lover,1.48790438516857e-05,2.2602605476525032e-05,20,7,13
20825,loving,8.592123914353715e-06,1.9151826014460126e-05,17,5,12
20826,low,0.00018881716211787043,0.0001347529379936339,183,100,83
20827,lowcarbon,4.400843956132392e-06,1.8979287041356905e-06,3,2,1
20828,lowcost,1.278340387257504e-05,1.052487735929791e-05,14,7,7
20829,lower,0.00010918284291166549,0.00010887209202814718,132,60,72
20830,lowered,1.0687763893464371e-05,7.074097897233022e-06,9,5,4
20831,lowering,4.400843956132392e-06,1.052487735929791e-05,10,3,7
20832,lowest,5.050492349656699e-05,3.640572332478458e-05,49,28,21
20833,lowincome,6.496483935243052e-06,2.777877466962238e-05,23,5,18
20834,lowkey,2.3052039770217305e-06,3.6233184351681345e-06,3,1,2
20835,lowlevel,4.400843956132392e-06,3.6233184351681345e-06,7,2,5
20836,lowwage,6.496483935243052e-06,7.074097897233022e-06,8,3,5
20837,loyal,2.326160376812834e-05,2.4327995207557487e-05,26,12,14
20838,loyalist,1.0687763893464371e-05,1.570104655239525e-05,15,5,10
20839,loyalty,2.7452883726349685e-05,2.9504164400654783e-05,31,14,17
20840,luck,2.954852370546031e-05,2.087721574549256e-05,29,16,13
20841,lucky,2.326160376812834e-05,2.087721574549256e-05,23,11,12
20842,lucrative,1.9070323809907035e-05,1.742643628342769e-05,23,12,11
20843,luger,2.3052039770217305e-06,3.6233184351681345e-06,3,1,2
20844,luggage,8.592123914353715e-06,1.7253897310324457e-07,5,4,1
20845,lulled,4.400843956132392e-06,1.7253897310324457e-07,3,2,1
20846,lump,8.592123914353715e-06,5.348708166200577e-06,7,4,3
20847,lunar,1.278340387257504e-05,3.6233184351681345e-06,9,7,2
20848,lunch,2.326160376812834e-05,3.2954943862719716e-05,33,12,21
20849,lung,1.48790438516857e-05,2.6053384938589907e-05,25,9,16
20850,lurch,2.3052039770217305e-06,5.348708166200577e-06,4,1,3
20851,lurched,8.592123914353715e-06,1.8979287041356905e-06,5,4,1
20852,lure,8.592123914353715e-06,1.052487735929791e-05,10,4,6
20853,lured,6.496483935243052e-06,3.6233184351681345e-06,6,3,3
20854,lurk,4.400843956132392e-06,3.6233184351681345e-06,4,2,2
20855,lurking,2.3052039770217305e-06,7.074097897233022e-06,5,1,4
20856,luxuriou,2.3052039770217305e-06,5.348708166200577e-06,6,1,5
20857,luxury,3.1644163684570994e-05,3.8131113055817005e-05,47,18,29
20858,lying,4.4218003559234974e-05,3.640572332478458e-05,48,22,26
20859,lymphoma,2.3052039770217305e-06,7.074097897233022e-06,5,1,4
20860,lynch,2.3052039770217305e-06,7.074097897233022e-06,5,1,4
20861,lynched,6.496483935243052e-06,3.6233184351681345e-06,5,3,2
20862,lynching,6.496483935243052e-06,1.2250267090330355e-05,10,3,7
20863,lyric,1.0687763893464371e-05,3.6233184351681345e-06,8,6,2
20864,machete,1.9070323809907035e-05,5.348708166200577e-06,12,9,3
20865,machine,6.517440335034157e-05,6.228656929027126e-05,75,35,40
20866,machinegun,4.400843956132392e-06,3.6233184351681345e-06,5,2,3
20867,machinery,4.400843956132392e-06,5.348708166200577e-06,6,3,3
20868,mackerel,2.095639979110664e-07,3.6233184351681345e-06,3,1,2
20869,mad,2.116596378901769e-05,1.570104655239525e-05,21,11,10
20870,made,0.0006268059177519991,0.0007127584978895026,782,333,449
20871,madeup,4.400843956132392e-06,1.8979287041356905e-06,3,2,1
20872,madnes,4.400843956132392e-06,1.052487735929791e-05,8,2,6
20873,mafia,2.326160376812834e-05,2.4327995207557487e-05,29,12,17
20874,magazine,6.517440335034157e-05,6.056117955923882e-05,74,35,39
20875,magic,2.5357243747239038e-05,1.9151826014460126e-05,28,14,14
20876,magical,1.0687763893464371e-05,1.570104655239525e-05,15,5,10
20877,magically,4.400843956132392e-06,1.8979287041356905e-06,3,2,1
20878,magistrate,4.400843956132392e-06,5.348708166200577e-06,5,2,3
20879,magnate,1.278340387257504e-05,1.052487735929791e-05,13,6,7
20880,magnet,6.496483935243052e-06,7.074097897233022e-06,7,3,4
20881,magnetic,2.116596378901769e-05,8.79948762826546e-06,15,10,5
20882,magnitude,6.098312339212028e-05,4.6758061710979285e-05,59,30,29
20883,maid,1.9070323809907035e-05,1.9151826014460126e-05,21,10,11
20884,maiden,4.400843956132392e-06,3.6233184351681345e-06,4,2,2
20885,mail,1.48790438516857e-05,2.2602605476525032e-05,24,9,15
20886,mailbox,6.496483935243052e-06,1.8979287041356905e-06,4,3,1
20887,mailed,1.278340387257504e-05,1.8979287041356905e-06,7,6,1
20888,mailin,2.3052039770217305e-06,5.348708166200577e-06,5,1,4
20889,mailing,4.400843956132392e-06,5.348708166200577e-06,6,2,4
20890,maimed,2.095639979110664e-07,3.6233184351681345e-06,3,0,3
20891,maiming,2.095639979110664e-07,3.6233184351681345e-06,3,0,3
20892,main,0.00011127848289077625,0.00010887209202814718,131,60,71
20893,mainland,2.7452883726349685e-05,1.742643628342769e-05,25,14,11
20894,mainly,2.326160376812834e-05,3.122955413168725e-05,34,12,22
20895,mainstream,3.7931083621902995e-05,2.777877466962238e-05,35,18,17
20896,maintain,6.098312339212028e-05,4.8483451442011706e-05,62,31,31
20897,maintained,8.592123914353715e-06,1.9151826014460126e-05,17,6,11
20898,maintaining,8.592123914353715e-06,1.2250267090330355e-05,13,4,9
20899,maintenance,8.592123914353715e-06,1.052487735929791e-05,10,4,6
20900,maize,1.6974683830796368e-05,5.348708166200577e-06,11,8,3
20901,majestic,6.496483935243052e-06,1.8979287041356905e-06,4,3,1
20902,major,0.0004067637199453794,0.00045222464850360367,503,213,290
20903,majority,0.00016995640230587486,0.00017098612234531542,206,89,117
20904,make,0.0011067074729683413,0.001325271852406021,1459,605,854
20905,makeover,2.095639979110664e-07,5.348708166200577e-06,4,1,3
20906,maker,6.307876337123095e-05,5.5385010366141504e-05,71,33,38
20907,makeshift,8.592123914353715e-06,3.6233184351681345e-06,7,5,2
20908,makeup,6.496483935243052e-06,7.074097897233022e-06,8,4,4
20909,making,0.0003941898800707157,0.00042634380253811694,475,205,270
20910,malaise,4.400843956132392e-06,1.8979287041356905e-06,3,2,1
20911,malaria,2.116596378901769e-05,1.742643628342769e-05,24,12,12
20912,male,8.613080314144832e-05,7.954046660059569e-05,98,46,52
20913,malfeasance,2.3052039770217305e-06,7.074097897233022e-06,5,1,4
20914,malfunction,2.3052039770217305e-06,3.6233184351681345e-06,4,2,2
20915,maliciou,4.400843956132392e-06,1.3975656821362803e-05,10,2,8
20916,maligned,2.3052039770217305e-06,3.6233184351681345e-06,3,1,2
20917,mall,2.5357243747239038e-05,1.570104655239525e-05,25,15,10
20918,malnourished,6.496483935243052e-06,5.348708166200577e-06,8,4,4
20919,malnutrition,8.592123914353715e-06,1.3975656821362803e-05,14,5,9
20920,malware,1.6974683830796368e-05,1.3975656821362803e-05,17,9,8
20921,mammal,2.326160376812834e-05,1.570104655239525e-05,24,14,10
20922,mammoth,1.278340387257504e-05,1.570104655239525e-05,20,9,11
20923,man,0.0013749493902945051,0.0013942874416473182,1624,723,901
20924,manage,2.7452883726349685e-05,4.50326719799468e-05,47,15,32
20925,managed,2.7452883726349685e-05,4.330728224891437e-05,40,14,26
20926,management,3.7931083621902995e-05,3.468033359375216e-05,45,22,23
20927,manager,0.00010708720293255492,9.851975364195259e-05,118,54,64
20928,managing,2.326160376812834e-05,1.9151826014460126e-05,24,12,12
20929,mandate,2.7452883726349685e-05,2.087721574549256e-05,28,15,13
20930,mandated,2.3052039770217305e-06,7.074097897233022e-06,6,1,5
20931,mandatory,2.954852370546031e-05,4.6758061710979285e-05,49,15,34
20932,mane,4.400843956132392e-06,1.8979287041356905e-06,3,2,1
20933,maneuver,4.400843956132392e-06,7.074097897233022e-06,6,2,4
20934,maneuvering,2.095639979110664e-07,5.348708166200577e-06,3,0,3
20935,manga,6.496483935243052e-06,7.074097897233022e-06,8,3,5
20936,mangrove,1.0687763893464371e-05,3.6233184351681345e-06,7,5,2
20937,manhunt,4.400843956132392e-06,3.6233184351681345e-06,5,3,2
20938,mania,4.400843956132392e-06,3.6233184351681345e-06,4,2,2
20939,manifesto,1.48790438516857e-05,5.348708166200577e-06,12,8,4
20940,manipulate,8.592123914353715e-06,1.3975656821362803e-05,16,5,11
20941,manipulated,1.278340387257504e-05,1.3975656821362803e-05,14,6,8
20942,manipulating,1.0687763893464371e-05,3.6233184351681345e-06,7,5,2
20943,manipulation,2.954852370546031e-05,2.2602605476525032e-05,28,15,13
20944,mankind,1.48790438516857e-05,7.074097897233022e-06,12,8,4
20945,manmade,1.278340387257504e-05,8.79948762826546e-06,12,6,6
20946,manned,4.400843956132392e-06,1.2250267090330355e-05,12,3,9
20947,mannequin,4.400843956132392e-06,3.6233184351681345e-06,4,2,2
20948,manner,2.116596378901769e-05,2.777877466962238e-05,27,11,16
20949,mansion,1.278340387257504e-05,2.087721574549256e-05,18,6,12
20950,manslaughter,1.48790438516857e-05,2.4327995207557487e-05,21,7,14
20951,mantle,2.3052039770217305e-06,3.6233184351681345e-06,3,1,2
20952,mantra,8.592123914353715e-06,1.8979287041356905e-06,5,4,1
20953,manual,1.278340387257504e-05,8.79948762826546e-06,12,6,6
20954,manufacture,1.0687763893464371e-05,1.052487735929791e-05,11,5,6
20955,manufactured,1.278340387257504e-05,5.348708166200577e-06,9,6,3
20956,manufacturer,3.7931083621902995e-05,5.883578982820635e-05,62,24,38
20957,manufacturing,2.5357243747239038e-05,3.640572332478458e-05,38,13,25
20958,manuscript,2.5357243747239038e-05,8.79948762826546e-06,18,12,6
20959,many,0.0008845696351826108,0.0008732197428755202,1031,471,560
20960,map,0.00010080028299522283,7.091351794543343e-05,97,53,44
20961,maple,4.400843956132392e-06,5.348708166200577e-06,5,2,3
20962,mapped,2.3052039770217305e-06,7.074097897233022e-06,5,1,4
20963,mapping,8.592123914353715e-06,7.074097897233022e-06,9,5,4
20964,mar,4.400843956132392e-06,5.348708166200577e-06,5,2,3
20965,marathon,2.326160376812834e-05,1.742643628342769e-05,24,12,12
20966,marble,2.3052039770217305e-06,7.074097897233022e-06,5,1,4
20967,march,0.00011756540282810809,9.679436391092026e-05,123,62,61
20968,marched,2.954852370546031e-05,2.087721574549256e-05,28,15,13
20969,marcher,8.592123914353715e-06,1.8979287041356905e-06,5,4,1
20970,marching,1.0687763893464371e-05,1.742643628342769e-05,15,5,10
20971,margin,2.5357243747239038e-05,2.6053384938589907e-05,30,14,16
20972,marginal,2.3052039770217305e-06,1.8979287041356905e-06,3,2,1
20973,marginalised,2.3052039770217305e-06,3.6233184351681345e-06,3,1,2
20974,marginalized,4.400843956132392e-06,5.348708166200577e-06,7,3,4
20975,marijuana,0.00015738256243121094,0.0001951415785797695,211,84,127
20976,marine,5.4696203454788295e-05,6.918812821440096e-05,68,27,41
20977,marital,8.592123914353715e-06,3.6233184351681345e-06,6,4,2
20978,maritime,1.6974683830796368e-05,1.2250267090330355e-05,17,9,8
20979,mark,0.0001154697628489974,0.00010024514337298497,126,65,61
20980,marked,2.116596378901769e-05,3.640572332478458e-05,36,13,23
20981,marker,4.400843956132392e-06,5.348708166200577e-06,5,2,3
20982,market,0.0003376076006347278,0.00033662353652443006,393,174,219
20983,marketer,1.48790438516857e-05,1.9151826014460126e-05,20,7,13
20984,marketing,5.6791843433898893e-05,8.989280498679035e-05,90,31,59
20985,marketplace,8.592123914353715e-06,7.074097897233022e-06,14,6,8
20986,marking,1.278340387257504e-05,1.742643628342769e-05,18,7,11
20987,marred,6.496483935243052e-06,5.348708166200577e-06,6,3,3
20988,marriage,0.0002055822819507562,0.00023482554239351563,262,114,148
20989,married,6.936568330856297e-05,5.5385010366141504e-05,69,35,34
20990,marry,4.212236358012434e-05,6.056117955923882e-05,61,22,39
20991,marrying,1.48790438516857e-05,1.2250267090330355e-05,15,8,7
20992,martial,4.400843956132392e-06,1.3975656821362803e-05,12,4,8
20993,martyr,1.278340387257504e-05,5.348708166200577e-06,9,6,3
20994,martyrdom,1.0687763893464371e-05,1.8979287041356905e-06,6,5,1
20995,mas,0.0003355119606556169,0.00029176340351758643,361,171,190
20996,mascot,2.095639979110664e-07,5.348708166200577e-06,3,0,3
20997,mask,4.840928351745632e-05,5.020884117304414e-05,55,25,30
20998,masked,1.48790438516857e-05,1.3975656821362803e-05,16,7,9
20999,masking,4.400843956132392e-06,1.8979287041356905e-06,3,2,1
21000,masquerading,4.400843956132392e-06,7.074097897233022e-06,6,2,4
21001,massacre,0.00014061744259832545,0.00017271151207634748,186,77,109
21002,massacred,1.278340387257504e-05,1.3975656821362803e-05,18,7,11
21003,massacring,4.400843956132392e-06,1.8979287041356905e-06,3,2,1
21004,masse,6.496483935243052e-06,5.348708166200577e-06,7,3,4
21005,massed,2.3052039770217305e-06,3.6233184351681345e-06,3,1,2
21006,massing,6.496483935243052e-06,3.6233184351681345e-06,5,3,2
21007,massive,0.00020767792192986646,0.00018996540938667205,229,109,120
21008,massively,4.400843956132392e-06,8.79948762826546e-06,10,3,7
21009,master,1.48790438516857e-05,3.122955413168725e-05,28,8,20
21010,masterful,4.400843956132392e-06,3.6233184351681345e-06,4,2,2
21011,mastermind,8.592123914353715e-06,1.3975656821362803e-05,14,4,10
21012,masterminded,6.496483935243052e-06,1.7253897310324457e-07,4,3,1
21013,masterminding,2.3052039770217305e-06,3.6233184351681345e-06,3,1,2
21014,masterpiece,2.3052039770217305e-06,7.074097897233022e-06,5,1,4
21015,masturbation,2.3052039770217305e-06,1.8979287041356905e-06,4,2,2
21016,mat,1.0687763893464371e-05,1.7253897310324457e-07,6,5,1
21017,match,5.888748341300963e-05,5.883578982820635e-05,69,31,38
21018,matched,4.400843956132392e-06,7.074097897233022e-06,6,2,4
21019,matching,4.400843956132392e-06,5.348708166200577e-06,5,2,3
21020,matchup,2.3052039770217305e-06,3.6233184351681345e-06,3,1,2
21021,mate,2.5357243747239038e-05,2.9504164400654783e-05,29,12,17
21022,material,0.00010708720293255492,8.126585633162811e-05,107,55,52
21023,materialize,4.400843956132392e-06,1.8979287041356905e-06,3,2,1
21024,maternal,1.48790438516857e-05,8.79948762826546e-06,13,7,6
21025,maternity,6.496483935243052e-06,1.052487735929791e-05,9,3,6
21026,math,2.7452883726349685e-05,2.087721574549256e-05,29,15,14
21027,mathematic,6.496483935243052e-06,7.074097897233022e-06,7,3,4
21028,mathematical,2.095639979110664e-07,5.348708166200577e-06,3,0,3
21029,mating,6.496483935243052e-06,3.6233184351681345e-06,6,4,2
21030,matter,0.00023282560167919462,0.00022274781427628854,261,119,142
21031,mattered,2.3052039770217305e-06,3.6233184351681345e-06,3,1,2
21032,mature,8.592123914353715e-06,1.8979287041356905e-06,7,4,3
21033,maturity,2.095639979110664e-07,3.6233184351681345e-06,3,0,3
21034,mausoleum,4.400843956132392e-06,1.8979287041356905e-06,3,2,1
21035,maven,2.3052039770217305e-06,3.6233184351681345e-06,3,1,2
21036,maximize,2.3052039770217305e-06,1.3975656821362803e-05,10,2,8
21037,maximum,3.3739803663681634e-05,2.4327995207557487e-05,35,18,17
21038,may,0.0011381420726550005,0.0012459039247785283,1404,605,799
21039,maybe,5.888748341300963e-05,4.330728224891437e-05,62,31,31
21040,mayhem,6.496483935243052e-06,3.6233184351681345e-06,6,4,2
21041,mayor,0.00011966104280721883,0.0001485560558418934,159,63,96
21042,mayoral,6.496483935243052e-06,3.6233184351681345e-06,7,4,3
21043,me,8.613080314144832e-05,8.989280498679035e-05,102,46,56
21044,meager,8.592123914353715e-06,1.7253897310324457e-07,6,5,1
21045,meal,3.1644163684570994e-05,3.2954943862719716e-05,39,18,21
21046,mean,0.0003124599208853996,0.00036768055168301384,394,164,230
21047,meaning,2.954852370546031e-05,5.020884117304414e-05,50,15,35
21048,meaningful,2.326160376812834e-05,2.087721574549256e-05,25,12,13
21049,meaningfully,4.400843956132392e-06,1.8979287041356905e-06,3,2,1
21050,meaningles,2.095639979110664e-07,8.79948762826546e-06,5,0,5
21051,meant,6.72700433294523e-05,6.401195902130366e-05,75,34,41
21052,meantime,6.496483935243052e-06,3.6233184351681345e-06,5,3,2
21053,meanwhile,6.496483935243052e-06,7.074097897233022e-06,7,3,4
21054,measles,8.592123914353715e-06,1.052487735929791e-05,11,4,7
21055,measure,0.0002160604818463093,0.0002141208656211263,251,117,134
21056,measured,1.0687763893464371e-05,1.2250267090330355e-05,12,5,7
21057,measurement,8.592123914353715e-06,5.348708166200577e-06,8,5,3
21058,measuring,6.496483935243052e-06,1.3975656821362803e-05,13,3,10
21059,meat,8.403516316233764e-05,9.679436391092026e-05,102,42,60
21060,mechanic,1.0687763893464371e-05,1.8979287041356905e-06,8,5,3
21061,mechanism,2.116596378901769e-05,1.570104655239525e-05,21,11,10
21062,med,2.3052039770217305e-06,3.6233184351681345e-06,3,1,2
21063,medal,2.954852370546031e-05,2.2602605476525032e-05,31,18,13
21064,medalist,8.592123914353715e-06,1.8979287041356905e-06,5,4,1
21065,meddle,2.095639979110664e-07,5.348708166200577e-06,3,0,3
21066,meddling,1.9070323809907035e-05,1.570104655239525e-05,23,12,11
21067,media,1.278340387257504e-05,8.79948762826546e-06,12,6,6
21068,median,4.400843956132392e-06,8.79948762826546e-06,9,3,6
21069,mediate,2.3052039770217305e-06,5.348708166200577e-06,5,1,4
21070,medic,1.278340387257504e-05,1.9151826014460126e-05,19,7,12
21071,medical,0.00019091280209698145,0.0002089446964280291,238,102,136
21072,medically,6.496483935243052e-06,8.79948762826546e-06,8,3,5
21073,medication,1.6974683830796368e-05,1.742643628342769e-05,24,10,14
21074,medicinal,1.48790438516857e-05,1.3975656821362803e-05,17,9,8
21075,medicine,7.565260324589493e-05,6.056117955923882e-05,78,40,38
21076,medieval,2.7452883726349685e-05,1.2250267090330355e-05,21,13,8
21077,mediocre,6.496483935243052e-06,3.6233184351681345e-06,7,5,2
21078,mediocrity,2.095639979110664e-07,5.348708166200577e-06,3,0,3
21079,medium,0.0006058495179608927,0.000566100370751745,687,316,371
21080,mediumrange,2.3052039770217305e-06,3.6233184351681345e-06,3,1,2
21081,meet,0.00015109564249387862,0.00018306385046254245,189,76,113
21082,meeting,0.00023282560167919462,0.00026588255755210003,298,121,177
21083,mega,4.400843956132392e-06,7.074097897233022e-06,7,2,5
21084,megacity,8.592123914353715e-06,5.348708166200577e-06,7,4,3
21085,megadonor,4.400843956132392e-06,1.052487735929791e-05,8,2,6
21086,melamine,2.3052039770217305e-06,7.074097897233022e-06,6,2,4
21087,melt,1.278340387257504e-05,1.052487735929791e-05,12,6,6
21088,meltdown,3.3739803663681634e-05,4.8483451442011706e-05,45,16,29
21089,melted,1.0687763893464371e-05,1.3975656821362803e-05,13,5,8
21090,melting,1.278340387257504e-05,2.777877466962238e-05,24,6,18
21091,member,0.0006100407979191138,0.0005229656274759339,650,313,337
21092,membership,4.6313643538345614e-05,4.50326719799468e-05,51,23,28
21093,meme,1.0687763893464371e-05,5.348708166200577e-06,8,5,3
21094,memo,6.307876337123095e-05,3.122955413168725e-05,52,31,21
21095,memoir,1.278340387257504e-05,1.742643628342769e-05,16,6,10
21096,memorable,6.496483935243052e-06,8.79948762826546e-06,9,3,6
21097,memorial,2.116596378901769e-05,1.742643628342769e-05,29,13,16
21098,memory,6.307876337123095e-05,3.985650278684949e-05,57,32,25
21099,menace,1.0687763893464371e-05,8.79948762826546e-06,10,5,5
21100,menacing,6.496483935243052e-06,1.8979287041356905e-06,4,3,1
21101,menstrual,4.400843956132392e-06,7.074097897233022e-06,6,2,4
21102,mental,7.984388320411623e-05,9.851975364195259e-05,105,42,63
21103,mentality,1.0687763893464371e-05,3.6233184351681345e-06,7,5,2
21104,mentally,3.583544364279237e-05,2.777877466962238e-05,37,19,18
21105,mention,6.098312339212028e-05,3.122955413168725e-05,49,29,20
21106,mentioned,1.6974683830796368e-05,1.2250267090330355e-05,16,8,8
21107,mentioning,2.3052039770217305e-06,5.348708166200577e-06,6,2,4
21108,mentor,8.592123914353715e-06,2.6053384938589907e-05,19,4,15
21109,mentoring,2.095639979110664e-07,5.348708166200577e-06,3,0,3
21110,menu,1.6974683830796368e-05,1.052487735929791e-05,15,8,7
21111,mercenary,1.278340387257504e-05,5.348708166200577e-06,12,7,5
21112,merchandise,2.095639979110664e-07,3.6233184351681345e-06,4,1,3
21113,merchant,1.9070323809907035e-05,1.2250267090330355e-05,21,9,12
21114,merciles,6.496483935243052e-06,1.8979287041356905e-06,5,4,1
21115,mercilessly,2.095639979110664e-07,3.6233184351681345e-06,4,0,4
21116,mercury,6.496483935243052e-06,8.79948762826546e-06,9,4,5
21117,mercy,8.592123914353715e-06,1.2250267090330355e-05,15,5,10
21118,mere,1.9070323809907035e-05,2.087721574549256e-05,22,9,13
21119,merely,2.954852370546031e-05,3.122955413168725e-05,33,14,19
21120,merge,4.400843956132392e-06,3.6233184351681345e-06,5,2,3
21121,merged,4.400843956132392e-06,1.8979287041356905e-06,3,2,1
21122,merger,1.48790438516857e-05,8.79948762826546e-06,15,8,7
21123,merit,1.48790438516857e-05,1.052487735929791e-05,14,7,7
21124,meritocracy,6.496483935243052e-06,1.7253897310324457e-07,3,3,0
21125,mes,3.1644163684570994e-05,3.8131113055817005e-05,44,17,27
21126,message,0.0002181561218254202,0.0002400017115866128,275,114,161
21127,messaging,1.48790438516857e-05,1.3975656821362803e-05,17,9,8
21128,messed,8.592123914353715e-06,1.8979287041356905e-06,6,4,2
21129,messenger,6.496483935243052e-06,7.074097897233022e-06,8,3,5
21130,messianic,2.3052039770217305e-06,1.8979287041356905e-06,3,2,1
21131,messing,2.3052039770217305e-06,3.6233184351681345e-06,3,1,2
21132,messy,2.095639979110664e-07,1.3975656821362803e-05,10,0,10
21133,met,8.403516316233764e-05,8.644202552472544e-05,103,49,54
21134,metadatum,1.278340387257504e-05,8.79948762826546e-06,12,6,6
21135,metal,5.888748341300963e-05,5.020884117304414e-05,65,31,34
21136,metaphor,6.496483935243052e-06,1.570104655239525e-05,13,3,10
21137,meteor,4.400843956132392e-06,8.79948762826546e-06,7,2,5
21138,meteorite,1.0687763893464371e-05,5.348708166200577e-06,8,5,3
21139,meter,2.116596378901769e-05,1.9151826014460126e-05,23,10,13
21140,meth,1.48790438516857e-05,1.742643628342769e-05,17,7,10
21141,methamphetamine,2.3052039770217305e-06,7.074097897233022e-06,5,1,4
21142,methane,2.116596378901769e-05,1.742643628342769e-05,21,11,10
21143,method,4.840928351745632e-05,5.1934230904076595e-05,58,24,34
21144,methodically,2.3052039770217305e-06,3.6233184351681345e-06,3,1,2
21145,methodology,2.3052039770217305e-06,5.348708166200577e-06,4,1,3
21146,metre,2.326160376812834e-05,2.2602605476525032e-05,24,11,13
21147,metric,1.0687763893464371e-05,2.6053384938589907e-05,24,5,19
21148,metro,8.592123914353715e-06,5.348708166200577e-06,10,6,4
21149,metropoli,2.3052039770217305e-06,5.348708166200577e-06,6,3,3
21150,metropolitan,4.400843956132392e-06,1.2250267090330355e-05,9,2,7
21151,mi,2.3052039770217305e-06,3.6233184351681345e-06,3,1,2
21152,mic,4.400843956132392e-06,3.6233184351681345e-06,4,2,2
21153,microbe,6.496483935243052e-06,1.8979287041356905e-06,4,3,1
21154,microcephaly,4.400843956132392e-06,3.6233184351681345e-06,4,2,2
21155,microchip,1.0687763893464371e-05,3.6233184351681345e-06,8,6,2
21156,microcosm,4.400843956132392e-06,1.8979287041356905e-06,3,2,1
21157,microphone,1.278340387257504e-05,1.052487735929791e-05,13,6,7
21158,microscope,2.3052039770217305e-06,3.6233184351681345e-06,3,1,2
21159,microscopic,2.3052039770217305e-06,1.8979287041356905e-06,3,1,2
21160,microwave,4.400843956132392e-06,5.348708166200577e-06,5,2,3
21161,mid,4.400843956132392e-06,3.6233184351681345e-06,5,2,3
21162,mid1990,4.400843956132392e-06,1.8979287041356905e-06,3,2,1
21163,mid2017,4.400843956132392e-06,1.8979287041356905e-06,3,2,1
21164,midair,4.400843956132392e-06,5.348708166200577e-06,6,3,3
21165,midcentury,6.496483935243052e-06,1.8979287041356905e-06,4,3,1
21166,middle,9.451336305789087e-05,0.00011059748175917965,126,53,73
21167,middleclas,1.278340387257504e-05,1.2250267090330355e-05,15,7,8
21168,middleincome,6.496483935243052e-06,5.348708166200577e-06,7,3,4
21169,middleman,4.400843956132392e-06,1.8979287041356905e-06,3,2,1
21170,midflight,2.3052039770217305e-06,5.348708166200577e-06,5,1,4
21171,midnight,1.9070323809907035e-05,1.9151826014460126e-05,20,9,11
21172,midrange,2.3052039770217305e-06,1.8979287041356905e-06,3,2,1
21173,midsize,2.095639979110664e-07,5.348708166200577e-06,3,0,3
21174,midst,1.9070323809907035e-05,2.777877466962238e-05,29,11,18
21175,midterm,2.116596378901769e-05,3.122955413168725e-05,34,10,24
21176,midwife,8.592123914353715e-06,7.074097897233022e-06,9,5,4
21177,might,0.00038161604019605166,0.0004056391257657278,462,200,262
21178,mightier,4.400843956132392e-06,5.348708166200577e-06,5,2,3
21179,mighty,2.3052039770217305e-06,3.6233184351681345e-06,4,2,2
21180,migrant,0.00015947820241032126,0.0001847892401935746,203,79,124
21181,migrate,6.496483935243052e-06,1.8979287041356905e-06,4,3,1
21182,migrated,4.400843956132392e-06,1.7253897310324457e-07,3,3,0
21183,migration,2.326160376812834e-05,2.2602605476525032e-05,26,12,14
21184,mil,2.3052039770217305e-06,7.074097897233022e-06,6,2,4
21185,mild,1.278340387257504e-05,3.6233184351681345e-06,9,6,3
21186,mildly,4.400843956132392e-06,1.7253897310324457e-07,3,2,1
21187,mile,0.00012804360272366158,0.00012094982014537423,143,71,72
21188,milestone,3.3739803663681634e-05,1.3975656821362803e-05,26,16,10
21189,militancy,4.400843956132392e-06,5.348708166200577e-06,5,2,3
21190,militant,0.00023072996170008382,0.00022102242454525643,267,121,146
21191,militarily,6.496483935243052e-06,5.348708166200577e-06,7,3,4
21192,militarized,2.3052039770217305e-06,3.6233184351681345e-06,4,1,3
21193,military,0.0010165949538665823,0.0009094529272272013,1109,538,571
21194,militarybacked,2.095639979110664e-07,3.6233184351681345e-06,3,0,3
21195,militarystyle,2.3052039770217305e-06,5.348708166200577e-06,5,2,3
21196,militia,5.4696203454788295e-05,4.6758061710979285e-05,55,26,29
21197,militiaman,8.592123914353715e-06,1.8979287041356905e-06,5,4,1
21198,milk,5.050492349656699e-05,5.5385010366141504e-05,63,26,37
21199,mill,8.592123914353715e-06,5.348708166200577e-06,9,6,3
21200,millennial,3.1644163684570994e-05,1.570104655239525e-05,24,15,9
21201,millennium,1.0687763893464371e-05,1.8979287041356905e-06,7,5,2
21202,million,0.0013686624703571737,0.0011734375560751658,1473,712,761
21203,millionaire,2.7452883726349685e-05,2.9504164400654783e-05,32,14,18
21204,millionyear,2.095639979110664e-07,5.348708166200577e-06,4,1,3
21205,millionyearold,4.400843956132392e-06,3.6233184351681345e-06,4,2,2
21206,mimic,2.3052039770217305e-06,8.79948762826546e-06,6,1,5
21207,min,8.592123914353715e-06,1.7253897310324457e-07,4,4,0
21208,minaret,1.0687763893464371e-05,1.2250267090330355e-05,12,5,7
21209,mince,2.3052039770217305e-06,3.6233184351681345e-06,4,1,3
21210,mind,0.0001552869224521,0.00015028144557292604,177,77,100
21211,mindboggling,6.496483935243052e-06,3.6233184351681345e-06,6,3,3
21212,minded,2.3052039770217305e-06,1.7253897310324457e-07,3,1,2
21213,mindful,1.0687763893464371e-05,7.074097897233022e-06,10,5,5
21214,mindfulnes,4.400843956132392e-06,1.8979287041356905e-06,4,2,2
21215,mindset,1.0687763893464371e-05,8.79948762826546e-06,13,5,8
21216,mine,0.00010918284291166549,0.00013130215853156914,138,57,81
21217,mined,4.400843956132392e-06,1.8979287041356905e-06,3,2,1
21218,miner,5.888748341300963e-05,5.883578982820635e-05,65,28,37
21219,mineral,1.9070323809907035e-05,1.052487735929791e-05,23,14,9
21220,mingling,4.400843956132392e-06,1.8979287041356905e-06,4,2,2
21221,mini,2.3052039770217305e-06,5.348708166200577e-06,4,1,3
21222,miniature,6.496483935243052e-06,1.7253897310324457e-07,3,3,0
21223,minimal,2.095639979110664e-07,1.3975656821362803e-05,8,0,8
21224,minimize,8.592123914353715e-06,7.074097897233022e-06,9,5,4
21225,minimum,7.355696326678427e-05,6.573734875233614e-05,88,37,51
21226,minimumwage,4.400843956132392e-06,1.8979287041356905e-06,3,2,1
21227,mining,5.888748341300963e-05,7.781507686956326e-05,85,37,48
21228,miniskirt,2.3052039770217305e-06,1.2250267090330355e-05,8,1,7
21229,minister,0.0004759198392560313,0.00044704847931050624,540,250,290
21230,ministry,3.3739803663681634e-05,4.330728224891437e-05,46,17,29
21231,minivan,6.496483935243052e-06,1.8979287041356905e-06,4,3,1
21232,minke,8.592123914353715e-06,1.8979287041356905e-06,5,4,1
21233,minor,6.098312339212028e-05,5.020884117304414e-05,59,30,29
21234,minority,0.0001259479627445509,0.00013992910718673112,158,67,91
21235,minu,2.095639979110664e-07,8.79948762826546e-06,6,1,5
21236,minute,0.00013223488268188294,0.00012612598933847184,149,71,78
21237,miracle,2.5357243747239038e-05,1.2250267090330355e-05,23,15,8
21238,miraculou,2.3052039770217305e-06,7.074097897233022e-06,5,1,4
21239,mired,2.3052039770217305e-06,3.6233184351681345e-06,4,1,3
21240,mirror,2.7452883726349685e-05,2.777877466962238e-05,29,13,16
21241,mis,4.4218003559234974e-05,4.50326719799468e-05,59,24,35
21242,misappropriating,2.095639979110664e-07,5.348708166200577e-06,3,0,3
21243,miscalculation,2.095639979110664e-07,5.348708166200577e-06,4,0,4
21244,miscarriage,4.400843956132392e-06,5.348708166200577e-06,6,2,4
21245,miscarry,2.3052039770217305e-06,3.6233184351681345e-06,4,1,3
21246,mischief,2.3052039770217305e-06,3.6233184351681345e-06,3,1,2
21247,misconception,4.400843956132392e-06,3.6233184351681345e-06,4,2,2
21248,misconduct,4.840928351745632e-05,4.1581892517881935e-05,49,24,25
21249,misdeed,2.3052039770217305e-06,3.6233184351681345e-06,3,1,2
21250,misdemeanor,2.3052039770217305e-06,3.6233184351681345e-06,3,1,2
21251,miserable,6.496483935243052e-06,8.79948762826546e-06,9,3,6
21252,misery,4.400843956132392e-06,8.79948762826546e-06,7,2,5
21253,misguided,8.592123914353715e-06,1.052487735929791e-05,10,4,6
21254,mishandling,2.3052039770217305e-06,3.6233184351681345e-06,3,1,2
21255,mishap,2.3052039770217305e-06,5.348708166200577e-06,6,2,4
21256,misidentified,2.3052039770217305e-06,3.6233184351681345e-06,3,1,2
21257,misinformation,1.48790438516857e-05,1.570104655239525e-05,18,9,9
21258,mislead,6.496483935243052e-06,3.6233184351681345e-06,6,3,3
21259,misleading,4.212236358012434e-05,2.4327995207557487e-05,36,20,16
21260,misled,1.0687763893464371e-05,1.3975656821362803e-05,15,6,9
21261,mismanaged,4.400843956132392e-06,3.6233184351681345e-06,4,2,2
21262,mismanagement,1.278340387257504e-05,1.8979287041356905e-06,7,6,1
21263,mismatched,4.400843956132392e-06,1.8979287041356905e-06,3,2,1
21264,misogyny,1.0687763893464371e-05,1.8979287041356905e-06,6,5,1
21265,misrepresented,4.400843956132392e-06,1.8979287041356905e-06,3,2,1
21266,misrepresenting,2.3052039770217305e-06,3.6233184351681345e-06,3,1,2
21267,missed,3.583544364279237e-05,2.6053384938589907e-05,35,19,16
21268,missile,0.0002726427612822975,0.0003176442494830731,348,143,205
21269,missing,0.00021396484186719832,0.00018306385046254245,237,112,125
21270,mission,0.0001552869224521,0.00013992910718673112,176,84,92
21271,missionary,1.48790438516857e-05,3.6233184351681345e-06,10,7,3
21272,missle,2.3052039770217305e-06,3.6233184351681345e-06,3,1,2
21273,misstep,4.400843956132392e-06,7.074097897233022e-06,6,2,4
21274,mistake,0.00012385232276544028,0.00011577365095227703,134,59,75
21275,mistaken,1.6974683830796368e-05,2.087721574549256e-05,20,8,12
21276,mistakenly,1.0687763893464371e-05,1.9151826014460126e-05,18,5,13
21277,mistaking,8.592123914353715e-06,1.8979287041356905e-06,5,4,1
21278,mistook,2.3052039770217305e-06,1.052487735929791e-05,10,1,9
21279,mistres,4.400843956132392e-06,1.8979287041356905e-06,3,2,1
21280,mistrial,6.496483935243052e-06,1.7253897310324457e-07,3,3,0
21281,mistrust,4.400843956132392e-06,3.6233184351681345e-06,4,2,2
21282,misunderstanding,2.3052039770217305e-06,8.79948762826546e-06,6,1,5
21283,misunderstood,8.592123914353715e-06,7.074097897233022e-06,8,4,4
21284,misuse,1.6974683830796368e-05,1.3975656821362803e-05,17,9,8
21285,misused,8.592123914353715e-06,7.074097897233022e-06,9,5,4
21286,misusing,2.3052039770217305e-06,3.6233184351681345e-06,3,1,2
21287,mitigation,2.3052039770217305e-06,3.6233184351681345e-06,3,1,2
21288,mix,2.7452883726349685e-05,1.570104655239525e-05,23,13,10
21289,mixed,2.116596378901769e-05,2.6053384938589907e-05,26,10,16
21290,mixing,8.592123914353715e-06,5.348708166200577e-06,9,6,3
21291,mixture,2.3052039770217305e-06,7.074097897233022e-06,7,1,6
21292,mln,8.592123914353715e-06,1.7253897310324457e-07,4,4,0
21293,mn,2.095639979110664e-07,5.348708166200577e-06,3,0,3
21294,moat,6.496483935243052e-06,1.7253897310324457e-07,3,3,0
21295,mob,5.050492349656699e-05,5.5385010366141504e-05,60,26,34
21296,mobile,9.24177230787802e-05,8.989280498679035e-05,107,51,56
21297,mobility,6.496483935243052e-06,5.348708166200577e-06,9,4,5
21298,mobilize,1.0687763893464371e-05,1.570104655239525e-05,15,6,9
21299,mobilized,2.3052039770217305e-06,7.074097897233022e-06,5,1,4
21300,mobilizing,6.496483935243052e-06,3.6233184351681345e-06,5,3,2
21301,mobster,1.0687763893464371e-05,1.8979287041356905e-06,8,6,2
21302,mock,1.48790438516857e-05,2.6053384938589907e-05,25,7,18
21303,mocked,2.326160376812834e-05,1.052487735929791e-05,18,11,7
21304,mockery,4.400843956132392e-06,7.074097897233022e-06,6,2,4
21305,mocking,1.0687763893464371e-05,1.2250267090330355e-05,12,5,7
21306,mockingly,4.400843956132392e-06,3.6233184351681345e-06,4,2,2
21307,mode,1.9070323809907035e-05,1.742643628342769e-05,22,11,11
21308,model,0.00011127848289077625,0.0001278513790695043,134,57,77
21309,modeled,2.3052039770217305e-06,3.6233184351681345e-06,4,1,3
21310,moderate,4.002672360101368e-05,3.640572332478458e-05,45,20,25
21311,moderator,1.278340387257504e-05,8.79948762826546e-06,11,6,5
21312,modern,9.660900303700153e-05,9.161819471782287e-05,110,49,61
21313,modernday,8.592123914353715e-06,8.79948762826546e-06,10,5,5
21314,modernization,2.3052039770217305e-06,3.6233184351681345e-06,3,1,2
21315,modernize,2.095639979110664e-07,5.348708166200577e-06,3,0,3
21316,modest,1.0687763893464371e-05,1.570104655239525e-05,16,6,10
21317,modestly,8.592123914353715e-06,1.7253897310324457e-07,4,4,0
21318,modification,4.400843956132392e-06,3.6233184351681345e-06,4,2,2
21319,modified,3.1644163684570994e-05,1.9151826014460126e-05,27,15,12
21320,modify,2.3052039770217305e-06,3.6233184351681345e-06,3,1,2
21321,mogul,4.212236358012434e-05,2.777877466962238e-05,41,23,18
21322,mold,8.592123914353715e-06,1.7253897310324457e-07,4,4,0
21323,mole,2.3052039770217305e-06,3.6233184351681345e-06,3,1,2
21324,molecule,8.592123914353715e-06,3.6233184351681345e-06,6,4,2
21325,molestation,2.3052039770217305e-06,5.348708166200577e-06,5,2,3
21326,molested,8.592123914353715e-06,7.074097897233022e-06,8,4,4
21327,molester,2.3052039770217305e-06,1.8979287041356905e-06,3,2,1
21328,molesting,2.3052039770217305e-06,3.6233184351681345e-06,3,1,2
21329,mom,5.260056347567764e-05,4.8483451442011706e-05,56,26,30
21330,moment,0.00016995640230587486,0.00021239547589009395,229,93,136
21331,momentary,2.095639979110664e-07,3.6233184351681345e-06,3,1,2
21332,momentou,4.400843956132392e-06,1.8979287041356905e-06,3,2,1
21333,momentum,2.5357243747239038e-05,2.087721574549256e-05,29,15,14
21334,mommy,2.3052039770217305e-06,1.8979287041356905e-06,3,2,1
21335,monarch,1.278340387257504e-05,7.074097897233022e-06,11,6,5
21336,monarchy,3.3739803663681634e-05,1.3975656821362803e-05,25,17,8
21337,monastery,1.278340387257504e-05,1.052487735929791e-05,14,6,8
21338,monetary,8.592123914353715e-06,2.2602605476525032e-05,19,6,13
21339,money,0.0007315879167075325,0.0006489190778413025,807,381,426
21340,moneylaundering,2.3052039770217305e-06,5.348708166200577e-06,5,1,4
21341,moneymaking,4.400843956132392e-06,1.7253897310324457e-07,3,2,1
21342,mongering,4.400843956132392e-06,3.6233184351681345e-06,4,2,2
21343,monitor,6.517440335034157e-05,5.3659620635109e-05,74,37,37
21344,monitored,2.116596378901769e-05,1.3975656821362803e-05,21,10,11
21345,monitoring,4.002672360101368e-05,4.330728224891437e-05,49,21,28
21346,monk,2.7452883726349685e-05,2.2602605476525032e-05,29,13,16
21347,monkey,2.116596378901769e-05,3.122955413168725e-05,29,10,19
21348,monopoly,2.116596378901769e-05,2.087721574549256e-05,27,12,15
21349,monsoon,2.095639979110664e-07,1.052487735929791e-05,6,0,6
21350,monster,1.9070323809907035e-05,1.2250267090330355e-05,18,10,8
21351,monstrou,4.400843956132392e-06,5.348708166200577e-06,6,3,3
21352,montage,2.3052039770217305e-06,3.6233184351681345e-06,3,1,2
21353,month,0.0008531350354959509,0.0008956498093789422,1029,442,587
21354,monthlong,4.400843956132392e-06,1.7253897310324457e-07,3,2,1
21355,monthly,3.1644163684570994e-05,2.777877466962238e-05,37,19,18
21356,monument,3.1644163684570994e-05,2.6053384938589907e-05,32,16,16
21357,monumental,6.496483935243052e-06,1.052487735929791e-05,11,3,8
21358,mood,1.278340387257504e-05,2.087721574549256e-05,18,6,12
21359,moon,5.260056347567764e-05,3.985650278684949e-05,51,26,25
21360,moonshot,4.400843956132392e-06,3.6233184351681345e-06,4,2,2
21361,moose,4.400843956132392e-06,3.6233184351681345e-06,5,2,3
21362,moral,7.146132328767358e-05,8.816741525575797e-05,97,37,60
21363,morale,2.3052039770217305e-06,3.6233184351681345e-06,3,1,2
21364,morality,1.0687763893464371e-05,8.79948762826546e-06,15,7,8
21365,morally,2.326160376812834e-05,2.087721574549256e-05,23,11,12
21366,moratorium,1.278340387257504e-05,1.570104655239525e-05,16,7,9
21367,more,2.3052039770217305e-06,5.348708166200577e-06,5,2,3
21368,morgue,2.3052039770217305e-06,1.052487735929791e-05,8,2,6
21369,morning,0.00015109564249387862,0.00011922443041434203,161,84,77
21370,moron,4.400843956132392e-06,1.8979287041356905e-06,3,2,1
21371,mortal,6.496483935243052e-06,3.6233184351681345e-06,5,3,2
21372,mortality,1.48790438516857e-05,1.2250267090330355e-05,15,8,7
21373,mortar,1.48790438516857e-05,2.9504164400654783e-05,28,9,19
21374,mortgage,5.050492349656699e-05,4.6758061710979285e-05,59,31,28
21375,mosaic,2.3052039770217305e-06,3.6233184351681345e-06,3,1,2
21376,mosque,0.00012175668278632962,9.851975364195259e-05,126,62,64
21377,mosquito,1.9070323809907035e-05,1.052487735929791e-05,16,9,7
21378,mosquitoborne,4.400843956132392e-06,3.6233184351681345e-06,5,2,3
21379,most,2.3052039770217305e-06,3.6233184351681345e-06,3,1,2
21380,mostly,6.936568330856297e-05,8.989280498679035e-05,94,36,58
21381,mostvisited,2.3052039770217305e-06,1.8979287041356905e-06,3,2,1
21382,mostwanted,2.3052039770217305e-06,3.6233184351681345e-06,4,2,2
21383,moth,2.095639979110664e-07,5.348708166200577e-06,3,0,3
21384,mother,0.00019929536201342395,0.00020031774777286686,239,105,134
21385,mothership,2.095639979110664e-07,5.348708166200577e-06,3,0,3
21386,motif,8.592123914353715e-06,5.348708166200577e-06,10,6,4
21387,motion,3.7931083621902995e-05,3.468033359375216e-05,38,18,20
21388,motivate,8.592123914353715e-06,1.2250267090330355e-05,12,4,8
21389,motivated,2.5357243747239038e-05,1.9151826014460126e-05,29,15,14
21390,motivating,4.400843956132392e-06,1.8979287041356905e-06,4,3,1
21391,motivation,1.0687763893464371e-05,1.2250267090330355e-05,13,5,8
21392,motivator,4.400843956132392e-06,1.8979287041356905e-06,4,2,2
21393,motive,8.592123914353715e-06,1.052487735929791e-05,12,5,7
21394,motor,2.3052039770217305e-06,3.6233184351681345e-06,3,1,2
21395,motorbike,4.400843956132392e-06,1.8979287041356905e-06,4,3,1
21396,motorcade,2.095639979110664e-07,8.79948762826546e-06,6,0,6
21397,motorcycle,1.9070323809907035e-05,1.742643628342769e-05,19,9,10
21398,motorcyclist,6.496483935243052e-06,1.8979287041356905e-06,4,3,1
21399,motorist,1.278340387257504e-05,1.052487735929791e-05,12,6,6
21400,motorway,1.278340387257504e-05,3.6233184351681345e-06,8,6,2
21401,motto,6.496483935243052e-06,5.348708166200577e-06,6,3,3
21402,mount,3.583544364279237e-05,3.2954943862719716e-05,39,18,21
21403,mountain,8.193952318322689e-05,4.6758061710979285e-05,71,41,30
21404,mountainou,2.3052039770217305e-06,3.6233184351681345e-06,3,1,2
21405,mountaintop,2.095639979110664e-07,7.074097897233022e-06,4,0,4
21406,mounted,1.6974683830796368e-05,1.052487735929791e-05,18,10,8
21407,mounting,3.7931083621902995e-05,3.468033359375216e-05,40,19,21
21408,mourn,1.278340387257504e-05,1.570104655239525e-05,15,6,9
21409,mourner,6.496483935243052e-06,1.2250267090330355e-05,11,3,8
21410,mourning,1.6974683830796368e-05,8.79948762826546e-06,13,8,5
21411,mouse,1.278340387257504e-05,2.6053384938589907e-05,24,7,17
21412,mouth,1.6974683830796368e-05,2.2602605476525032e-05,26,11,15
21413,move,0.0004235288397782649,0.0004988101712414799,550,224,326
21414,moved,6.098312339212028e-05,7.781507686956326e-05,79,31,48
21415,movement,0.0001971997220343134,0.00018996540938667205,231,104,127
21416,movie,6.72700433294523e-05,8.4716635793693e-05,87,34,53
21417,moviegoer,2.3052039770217305e-06,1.8979287041356905e-06,3,1,2
21418,moving,7.565260324589493e-05,0.0001019705331040174,111,43,68
21419,mph,1.0687763893464371e-05,1.8979287041356905e-06,8,7,1
21420,much,0.000700153317020872,0.0007472662925101516,846,371,475
21421,muchneeded,8.592123914353715e-06,1.8979287041356905e-06,6,4,2
21422,mud,1.48790438516857e-05,7.074097897233022e-06,12,8,4
21423,mudslide,6.496483935243052e-06,1.8979287041356905e-06,5,4,1
21424,mug,6.496483935243052e-06,5.348708166200577e-06,6,3,3
21425,mugging,2.3052039770217305e-06,3.6233184351681345e-06,3,1,2
21426,mule,4.400843956132392e-06,1.8979287041356905e-06,3,2,1
21427,mull,1.278340387257504e-05,8.79948762826546e-06,12,7,5
21428,mulling,2.3052039770217305e-06,3.6233184351681345e-06,3,1,2
21429,multibillion,8.592123914353715e-06,1.3975656821362803e-05,13,4,9
21430,multibilliondollar,2.095639979110664e-07,5.348708166200577e-06,4,0,4
21431,multicultural,2.3052039770217305e-06,3.6233184351681345e-06,4,2,2
21432,multiculturalism,2.3052039770217305e-06,1.8979287041356905e-06,3,1,2
21433,multilateral,2.095639979110664e-07,5.348708166200577e-06,3,0,3
21434,multimillion,8.592123914353715e-06,5.348708166200577e-06,12,6,6
21435,multimillionaire,2.095639979110664e-07,7.074097897233022e-06,4,0,4
21436,multimilliondollar,6.496483935243052e-06,5.348708166200577e-06,7,3,4
21437,multinational,3.1644163684570994e-05,2.087721574549256e-05,31,16,15
21438,multiple,5.6791843433898893e-05,7.263890767646595e-05,76,29,47
21439,multiply,2.3052039770217305e-06,1.8979287041356905e-06,4,2,2
21440,multipolar,8.592123914353715e-06,1.7253897310324457e-07,4,4,0
21441,multitude,4.400843956132392e-06,1.7253897310324457e-07,3,3,0
21442,mum,4.400843956132392e-06,8.79948762826546e-06,8,2,6
21443,mummified,2.3052039770217305e-06,3.6233184351681345e-06,3,1,2
21444,mummy,6.496483935243052e-06,1.8979287041356905e-06,5,3,2
21445,mundane,6.496483935243052e-06,3.6233184351681345e-06,5,3,2
21446,municipal,1.9070323809907035e-05,1.2250267090330355e-05,18,9,9
21447,municipality,6.496483935243052e-06,8.79948762826546e-06,9,4,5
21448,munition,1.0687763893464371e-05,3.6233184351681345e-06,8,5,3
21449,mural,2.3052039770217305e-06,5.348708166200577e-06,4,1,3
21450,murder,0.0002621645613867441,0.0002883126240555216,328,139,189
21451,murdered,9.451336305789087e-05,9.506897417988779e-05,110,49,61
21452,murderer,1.9070323809907035e-05,3.2954943862719716e-05,34,12,22
21453,murdering,2.116596378901769e-05,2.6053384938589907e-05,31,12,19
21454,murderou,1.0687763893464371e-05,7.074097897233022e-06,11,6,5
21455,murky,4.400843956132392e-06,3.6233184351681345e-06,4,2,2
21456,muscle,6.496483935243052e-06,1.570104655239525e-05,15,3,12
21457,museum,4.212236358012434e-05,3.985650278684949e-05,48,22,26
21458,mushroom,6.496483935243052e-06,5.348708166200577e-06,7,4,3
21459,music,9.24177230787802e-05,0.00010024514337298497,109,45,64
21460,musical,6.496483935243052e-06,3.6233184351681345e-06,7,3,4
21461,musician,2.116596378901769e-05,1.052487735929791e-05,16,10,6
21462,muslim,1.0687763893464371e-05,1.9151826014460126e-05,18,5,13
21463,must,0.0005262151987546874,0.000529867186400064,625,270,355
21464,mustard,4.400843956132392e-06,8.79948762826546e-06,7,2,5
21465,muster,6.496483935243052e-06,5.348708166200577e-06,6,3,3
21466,mustered,2.095639979110664e-07,5.348708166200577e-06,3,0,3
21467,mustpas,2.095639979110664e-07,7.074097897233022e-06,4,0,4
21468,mutant,2.3052039770217305e-06,1.8979287041356905e-06,3,2,1
21469,mutate,2.095639979110664e-07,3.6233184351681345e-06,3,1,2
21470,mutation,4.400843956132392e-06,5.348708166200577e-06,5,2,3
21471,mutilated,2.3052039770217305e-06,8.79948762826546e-06,6,1,5
21472,mutilation,3.583544364279237e-05,3.122955413168725e-05,41,19,22
21473,mutiny,4.400843956132392e-06,5.348708166200577e-06,6,2,4
21474,mutual,1.48790438516857e-05,1.3975656821362803e-05,18,8,10
21475,mutually,2.3052039770217305e-06,1.8979287041356905e-06,3,2,1
21476,muzzle,6.496483935243052e-06,1.7253897310324457e-07,4,3,1
21477,myriad,2.3052039770217305e-06,8.79948762826546e-06,8,2,6
21478,mysteriou,4.840928351745632e-05,2.4327995207557487e-05,43,28,15
21479,mysteriously,1.278340387257504e-05,8.79948762826546e-06,13,7,6
21480,mystery,4.6313643538345614e-05,3.985650278684949e-05,50,22,28
21481,myth,4.212236358012434e-05,3.640572332478458e-05,47,23,24
21482,mythical,2.3052039770217305e-06,3.6233184351681345e-06,3,1,2
21483,nab,4.400843956132392e-06,1.8979287041356905e-06,3,2,1
21484,nabbed,2.3052039770217305e-06,5.348708166200577e-06,4,1,3
21485,nagging,2.095639979110664e-07,7.074097897233022e-06,4,0,4
21486,nail,1.48790438516857e-05,8.79948762826546e-06,14,9,5
21487,naive,4.400843956132392e-06,1.8979287041356905e-06,3,2,1
21488,naked,3.7931083621902995e-05,4.50326719799468e-05,47,20,27
21489,name,0.0003627552803840558,0.00032109502894513814,396,189,207
21490,named,0.0001259479627445509,9.334358444885519e-05,129,68,61
21491,nameles,4.400843956132392e-06,1.8979287041356905e-06,3,2,1
21492,namely,4.400843956132392e-06,1.8979287041356905e-06,4,2,2
21493,naming,6.496483935243052e-06,1.052487735929791e-05,12,3,9
21494,nanny,8.592123914353715e-06,7.074097897233022e-06,8,4,4
21495,nanoparticle,4.400843956132392e-06,3.6233184351681345e-06,4,2,2
21496,nanotechnology,2.3052039770217305e-06,7.074097897233022e-06,5,1,4
21497,nap,2.3052039770217305e-06,3.6233184351681345e-06,3,1,2
21498,narcissism,4.400843956132392e-06,1.8979287041356905e-06,3,2,1
21499,narcissist,4.400843956132392e-06,1.8979287041356905e-06,3,2,1
21500,narcissistic,4.400843956132392e-06,3.6233184351681345e-06,5,2,3
21501,narcotic,1.0687763893464371e-05,8.79948762826546e-06,12,6,6
21502,narrative,2.5357243747239038e-05,2.6053384938589907e-05,28,12,16
21503,narrow,1.48790438516857e-05,2.2602605476525032e-05,24,10,14
21504,narrowed,4.400843956132392e-06,3.6233184351681345e-06,5,2,3
21505,narrowly,4.400843956132392e-06,8.79948762826546e-06,9,3,6
21506,nascent,2.095639979110664e-07,5.348708166200577e-06,3,0,3
21507,nasty,1.0687763893464371e-05,1.570104655239525e-05,16,6,10
21508,nation,0.000540884678608462,0.0005799034886000049,660,280,380
21509,national,0.0004235288397782649,0.000472929325275993,527,221,306
21510,nationalisation,6.496483935243052e-06,1.7253897310324457e-07,4,3,1
21511,nationalise,6.496483935243052e-06,1.8979287041356905e-06,4,3,1
21512,nationalised,2.3052039770217305e-06,3.6233184351681345e-06,3,1,2
21513,nationalism,2.326160376812834e-05,8.79948762826546e-06,17,11,6
21514,nationalist,3.7931083621902995e-05,4.1581892517881935e-05,45,20,25
21515,nationalistic,6.496483935243052e-06,3.6233184351681345e-06,5,3,2
21516,nationality,1.48790438516857e-05,1.3975656821362803e-05,15,7,8
21517,nationalize,1.0687763893464371e-05,5.348708166200577e-06,9,6,3
21518,nationalizing,2.3052039770217305e-06,1.8979287041356905e-06,3,1,2
21519,nationally,2.3052039770217305e-06,5.348708166200577e-06,6,2,4
21520,nationwide,3.3739803663681634e-05,4.8483451442011706e-05,49,20,29
21521,native,2.326160376812834e-05,4.8483451442011706e-05,43,14,29
21522,nativeborn,2.3052039770217305e-06,3.6233184351681345e-06,3,1,2
21523,natural,9.451336305789087e-05,0.00010024514337298497,115,49,66
21524,naturalized,2.095639979110664e-07,5.348708166200577e-06,3,0,3
21525,naturally,2.095639979110664e-07,8.79948762826546e-06,5,0,5
21526,nature,6.517440335034157e-05,7.091351794543343e-05,76,34,42
21527,nautical,4.400843956132392e-06,3.6233184351681345e-06,4,2,2
21528,naval,4.6313643538345614e-05,3.640572332478458e-05,46,23,23
21529,navigate,6.496483935243052e-06,5.348708166200577e-06,7,3,4
21530,navigating,2.3052039770217305e-06,5.348708166200577e-06,5,2,3
21531,navigation,8.592123914353715e-06,1.8979287041356905e-06,6,4,2
21532,navy,6.517440335034157e-05,4.8483451442011706e-05,70,35,35
21533,nazi,6.496483935243052e-06,1.7253897310324457e-07,3,3,0
21534,near,0.00036694656034227697,0.00035732821329681935,430,199,231
21535,nearby,3.583544364279237e-05,2.777877466962238e-05,39,19,20
21536,nearest,2.3052039770217305e-06,5.348708166200577e-06,6,3,3
21537,nearing,2.3052039770217305e-06,8.79948762826546e-06,8,3,5
21538,nearly,0.00031874684082273133,0.0003176442494830731,376,171,205
21539,necessarily,2.7452883726349685e-05,2.777877466962238e-05,30,14,16
21540,necessary,5.888748341300963e-05,8.816741525575797e-05,83,30,53
21541,necessity,1.0687763893464371e-05,1.3975656821362803e-05,14,5,9
21542,neck,2.954852370546031e-05,1.570104655239525e-05,27,17,10
21543,necklace,6.496483935243052e-06,1.8979287041356905e-06,5,3,2
21544,need,0.0008573263154541722,0.0009543130602340453,1071,450,621
21545,needed,0.00010918284291166549,0.0001278513790695043,139,55,84
21546,needing,2.3052039770217305e-06,3.6233184351681345e-06,3,1,2
21547,needle,1.0687763893464371e-05,7.074097897233022e-06,11,5,6
21548,needlessly,2.3052039770217305e-06,5.348708166200577e-06,4,1,3
21549,needy,2.095639979110664e-07,7.074097897233022e-06,6,1,5
21550,negative,3.583544364279237e-05,6.918812821440096e-05,63,19,44
21551,negatively,2.3052039770217305e-06,7.074097897233022e-06,5,1,4
21552,neglect,1.278340387257504e-05,1.742643628342769e-05,17,6,11
21553,neglected,2.3052039770217305e-06,7.074097897233022e-06,7,1,6
21554,negligence,1.0687763893464371e-05,1.570104655239525e-05,14,5,9
21555,negotiable,2.3052039770217305e-06,3.6233184351681345e-06,4,2,2
21556,negotiate,3.583544364279237e-05,1.742643628342769e-05,28,17,11
21557,negotiated,1.278340387257504e-05,1.570104655239525e-05,15,6,9
21558,negotiating,2.954852370546031e-05,2.2602605476525032e-05,29,16,13
21559,negotiation,4.4218003559234974e-05,7.954046660059569e-05,77,26,51
21560,negotiator,1.278340387257504e-05,1.2250267090330355e-05,13,6,7
21561,neighbor,4.6313643538345614e-05,5.1934230904076595e-05,59,25,34
21562,neighborhood,6.307876337123095e-05,4.50326719799468e-05,59,30,29
21563,neighboring,1.48790438516857e-05,2.4327995207557487e-05,21,7,14
21564,neighbour,1.9070323809907035e-05,1.742643628342769e-05,20,9,11
21565,neighbourhood,1.0687763893464371e-05,3.6233184351681345e-06,8,5,3
21566,neighbouring,4.400843956132392e-06,1.3975656821362803e-05,11,3,8
21567,neither,4.212236358012434e-05,3.122955413168725e-05,44,25,19
21568,neoNazi,5.888748341300963e-05,3.640572332478458e-05,54,31,23
21569,neocon,4.400843956132392e-06,3.6233184351681345e-06,4,2,2
21570,neonazi,4.400843956132392e-06,3.6233184351681345e-06,5,2,3
21571,neonicotinoid,1.278340387257504e-05,5.348708166200577e-06,13,8,5
21572,nephew,1.0687763893464371e-05,1.8979287041356905e-06,6,5,1
21573,nepotism,2.3052039770217305e-06,3.6233184351681345e-06,3,1,2
21574,nerve,8.592123914353715e-06,1.742643628342769e-05,16,4,12
21575,nervou,1.0687763893464371e-05,1.742643628342769e-05,19,8,11
21576,nervously,2.3052039770217305e-06,3.6233184351681345e-06,3,1,2
21577,nest,1.278340387257504e-05,7.074097897233022e-06,12,8,4
21578,nesting,6.496483935243052e-06,1.7253897310324457e-07,3,3,0
21579,net,8.403516316233764e-05,0.00010714670229711469,107,42,65
21580,netizen,4.400843956132392e-06,1.8979287041356905e-06,4,2,2
21581,netted,4.400843956132392e-06,1.8979287041356905e-06,4,2,2
21582,netting,2.3052039770217305e-06,3.6233184351681345e-06,3,1,2
21583,network,0.0002055822819507562,0.00022102242454525643,242,105,137
21584,networked,4.400843956132392e-06,1.8979287041356905e-06,3,2,1
21585,networking,1.0687763893464371e-05,1.570104655239525e-05,18,7,11
21586,neurological,4.400843956132392e-06,1.8979287041356905e-06,3,2,1
21587,neurosurgeon,6.496483935243052e-06,1.570104655239525e-05,14,4,10
21588,neutral,8.592123914353715e-06,7.074097897233022e-06,9,4,5
21589,neutrality,3.1644163684570994e-05,4.330728224891437e-05,45,17,28
21590,never,0.0003899986001124942,0.00044704847931050624,506,212,294
21591,neverbeforeseen,4.400843956132392e-06,3.6233184351681345e-06,4,2,2
21592,neverending,4.400843956132392e-06,3.6233184351681345e-06,4,2,2
21593,nevertheles,2.3052039770217305e-06,5.348708166200577e-06,4,1,3
21594,new,0.002437438859703612,0.0021827905487291446,2701,1270,1431
21595,newbie,2.095639979110664e-07,5.348708166200577e-06,3,0,3
21596,newborn,2.326160376812834e-05,1.9151826014460126e-05,28,15,13
21597,newcomer,2.3052039770217305e-06,5.348708166200577e-06,4,1,3
21598,newest,1.48790438516857e-05,1.9151826014460126e-05,21,7,14
21599,newfound,8.592123914353715e-06,3.6233184351681345e-06,6,4,2
21600,newly,6.098312339212028e-05,5.883578982820635e-05,73,33,40
21601,newlyelected,6.496483935243052e-06,1.7253897310324457e-07,3,3,0
21602,newlywed,6.496483935243052e-06,1.8979287041356905e-06,4,3,1
21603,news,0.0008070309559555164,0.0008214580509445471,963,431,532
21604,newscast,4.400843956132392e-06,1.8979287041356905e-06,3,2,1
21605,newspaper,0.0001741476822640959,0.00018824001965563945,216,91,125
21606,next,0.0004905893191098062,0.0004936340020483826,584,262,322
21607,nice,5.260056347567764e-05,4.50326719799468e-05,60,29,31
21608,nicer,2.3052039770217305e-06,1.8979287041356905e-06,3,2,1
21609,niche,4.400843956132392e-06,1.7253897310324457e-07,3,2,1
21610,nickname,2.3052039770217305e-06,5.348708166200577e-06,4,1,3
21611,nicknamed,4.400843956132392e-06,1.8979287041356905e-06,5,2,3
21612,niece,8.592123914353715e-06,8.79948762826546e-06,10,4,6
21613,night,0.0002726427612822975,0.0002192970348142235,284,137,147
21614,nightclub,1.6974683830796368e-05,1.3975656821362803e-05,19,8,11
21615,nightmare,5.6791843433898893e-05,3.122955413168725e-05,48,28,20
21616,nightmarish,2.3052039770217305e-06,3.6233184351681345e-06,4,1,3
21617,nighttime,6.496483935243052e-06,1.8979287041356905e-06,4,3,1
21618,nightvision,2.095639979110664e-07,3.6233184351681345e-06,3,1,2
21619,nimble,2.3052039770217305e-06,1.8979287041356905e-06,3,1,2
21620,nine,0.00010918284291166549,0.00010024514337298497,124,56,68
21621,ninemonth,2.3052039770217305e-06,3.6233184351681345e-06,3,1,2
21622,nineyearold,2.3052039770217305e-06,3.6233184351681345e-06,4,2,2
21623,ninja,2.3052039770217305e-06,3.6233184351681345e-06,3,1,2
21624,ninth,4.400843956132392e-06,1.2250267090330355e-05,10,2,8
21625,niqab,8.592123914353715e-06,1.2250267090330355e-05,12,4,8
21626,nitrogen,4.400843956132392e-06,1.8979287041356905e-06,3,2,1
21627,nix,6.496483935243052e-06,3.6233184351681345e-06,5,3,2
21628,nobel,2.095639979110664e-07,5.348708166200577e-06,3,0,3
21629,noble,2.3052039770217305e-06,8.79948762826546e-06,9,3,6
21630,nobody,1.9070323809907035e-05,4.1581892517881935e-05,38,9,29
21631,nobrainer,4.400843956132392e-06,8.79948762826546e-06,7,2,5
21632,noconfidence,2.3052039770217305e-06,5.348708166200577e-06,4,1,3
21633,nod,2.3052039770217305e-06,1.2250267090330355e-05,8,1,7
21634,nofly,4.400843956132392e-06,1.570104655239525e-05,11,2,9
21635,noise,1.6974683830796368e-05,1.742643628342769e-05,19,8,11
21636,nominate,1.0687763893464371e-05,8.79948762826546e-06,11,6,5
21637,nominated,8.592123914353715e-06,2.087721574549256e-05,18,4,14
21638,nominating,4.400843956132392e-06,7.074097897233022e-06,7,2,5
21639,nomination,0.0001154697628489974,0.00010542131256608228,135,59,76
21640,nominee,0.00035437272046761313,0.0002900380137865542,374,184,190
21641,non,4.400843956132392e-06,8.79948762826546e-06,9,2,7
21642,nonJew,2.095639979110664e-07,3.6233184351681345e-06,3,0,3
21643,nonJewish,2.3052039770217305e-06,5.348708166200577e-06,4,1,3
21644,nonMuslim,6.496483935243052e-06,1.742643628342769e-05,15,4,11
21645,noncitizen,6.496483935243052e-06,3.6233184351681345e-06,5,3,2
21646,none,3.1644163684570994e-05,3.8131113055817005e-05,41,17,24
21647,nonetheles,8.592123914353715e-06,7.074097897233022e-06,8,4,4
21648,nonexistent,6.496483935243052e-06,1.2250267090330355e-05,12,3,9
21649,nongovernmental,2.3052039770217305e-06,3.6233184351681345e-06,4,2,2
21650,nonhuman,4.400843956132392e-06,3.6233184351681345e-06,4,2,2
21651,nonmember,2.3052039770217305e-06,3.6233184351681345e-06,4,2,2
21652,nonpartisan,1.0687763893464371e-05,1.2250267090330355e-05,13,5,8
21653,nonpermanent,2.095639979110664e-07,3.6233184351681345e-06,3,0,3
21654,nonprofit,6.517440335034157e-05,6.746273848336857e-05,75,33,42
21655,nonproliferation,2.3052039770217305e-06,3.6233184351681345e-06,3,1,2
21656,nonreligiou,4.400843956132392e-06,1.8979287041356905e-06,3,2,1
21657,nonsense,4.400843956132392e-06,1.570104655239525e-05,12,3,9
21658,nonstop,2.3052039770217305e-06,5.348708166200577e-06,5,2,3
21659,nonuser,4.400843956132392e-06,1.8979287041356905e-06,3,2,1
21660,nonviolent,1.48790438516857e-05,2.6053384938589907e-05,26,9,17
21661,nonwhite,4.400843956132392e-06,5.348708166200577e-06,5,2,3
21662,noodle,4.400843956132392e-06,1.8979287041356905e-06,3,2,1
21663,noon,4.400843956132392e-06,1.8979287041356905e-06,3,2,1
21664,noone,2.3052039770217305e-06,5.348708166200577e-06,4,1,3
21665,noose,4.400843956132392e-06,3.6233184351681345e-06,5,2,3
21666,norm,1.6974683830796368e-05,2.6053384938589907e-05,26,8,18
21667,normal,5.260056347567764e-05,5.020884117304414e-05,57,27,30
21668,normalize,8.592123914353715e-06,3.6233184351681345e-06,6,4,2
21669,normally,1.6974683830796368e-05,1.9151826014460126e-05,20,9,11
21670,noroviru,2.095639979110664e-07,3.6233184351681345e-06,3,1,2
21671,north,6.517440335034157e-05,7.436429740749831e-05,84,35,49
21672,northeast,1.278340387257504e-05,2.2602605476525032e-05,19,6,13
21673,northeastern,1.6974683830796368e-05,1.3975656821362803e-05,16,8,8
21674,northern,0.0001343305226609934,0.00014165449691776373,164,72,92
21675,northwest,3.3739803663681634e-05,7.074097897233022e-06,23,16,7
21676,northwestern,6.496483935243052e-06,7.074097897233022e-06,7,3,4
21677,nose,1.0687763893464371e-05,2.777877466962238e-05,24,6,18
21678,nostalgia,8.592123914353715e-06,3.6233184351681345e-06,6,4,2
21679,not,8.592123914353715e-06,7.074097897233022e-06,9,5,4
21680,notable,2.3052039770217305e-06,7.074097897233022e-06,5,1,4
21681,notably,4.400843956132392e-06,5.348708166200577e-06,6,3,3
21682,notch,2.3052039770217305e-06,3.6233184351681345e-06,5,1,4
21683,notched,6.496483935243052e-06,1.8979287041356905e-06,4,3,1
21684,note,7.355696326678427e-05,6.056117955923882e-05,76,37,39
21685,notebook,8.592123914353715e-06,5.348708166200577e-06,7,4,3
21686,noted,3.3739803663681634e-05,3.640572332478458e-05,43,20,23
21687,noteworthy,2.095639979110664e-07,7.074097897233022e-06,4,0,4
21688,nothing,0.00022863432172097337,0.00018996540938667205,241,124,117
21689,notice,5.6791843433898893e-05,5.020884117304414e-05,58,27,31
21690,noticed,1.48790438516857e-05,1.9151826014460126e-05,22,10,12
21691,noticing,2.095639979110664e-07,5.348708166200577e-06,3,0,3
21692,notification,4.400843956132392e-06,7.074097897233022e-06,6,2,4
21693,notified,1.0687763893464371e-05,3.6233184351681345e-06,8,5,3
21694,notify,2.3052039770217305e-06,1.7253897310324457e-07,3,2,1
21695,noting,4.400843956132392e-06,1.8979287041356905e-06,3,2,1
21696,notion,2.326160376812834e-05,2.2602605476525032e-05,28,13,15
21697,notoriou,4.4218003559234974e-05,3.468033359375216e-05,44,22,22
21698,notoriously,1.278340387257504e-05,1.8979287041356905e-06,7,6,1
21699,novel,1.48790438516857e-05,1.570104655239525e-05,19,9,10
21700,novelist,2.3052039770217305e-06,5.348708166200577e-06,4,1,3
21701,now,4.400843956132392e-06,1.3975656821362803e-05,10,2,8
21702,nowhere,1.0687763893464371e-05,2.4327995207557487e-05,22,7,15
21703,nuance,2.095639979110664e-07,3.6233184351681345e-06,3,0,3
21704,nuanced,6.496483935243052e-06,3.6233184351681345e-06,5,3,2
21705,nuclear,0.0008300829957257336,0.0007300123951998276,905,421,484
21706,nucleararmed,2.3052039770217305e-06,3.6233184351681345e-06,3,1,2
21707,nuclearcapable,6.496483935243052e-06,5.348708166200577e-06,6,3,3
21708,nude,1.48790438516857e-05,1.3975656821362803e-05,16,8,8
21709,nudge,2.3052039770217305e-06,7.074097897233022e-06,5,1,4
21710,nudity,2.3052039770217305e-06,5.348708166200577e-06,4,1,3
21711,nugget,4.400843956132392e-06,1.8979287041356905e-06,3,2,1
21712,nuisance,4.400843956132392e-06,3.6233184351681345e-06,6,2,4
21713,nuke,5.260056347567764e-05,3.8131113055817005e-05,48,26,22
21714,nullify,6.496483935243052e-06,7.074097897233022e-06,8,3,5
21715,numb,2.095639979110664e-07,8.79948762826546e-06,5,0,5
21716,number,0.000459154719423146,0.0005402195247862584,600,247,353
21717,numbered,2.3052039770217305e-06,3.6233184351681345e-06,4,2,2
21718,numerou,3.3739803663681634e-05,3.2954943862719716e-05,39,17,22
21719,nun,1.9070323809907035e-05,8.79948762826546e-06,19,11,8
21720,nurse,3.7931083621902995e-05,5.3659620635109e-05,56,19,37
21721,nursery,8.592123914353715e-06,5.348708166200577e-06,7,4,3
21722,nursing,4.400843956132392e-06,8.79948762826546e-06,8,2,6
21723,nurture,2.3052039770217305e-06,1.8979287041356905e-06,4,3,1
21724,nurtured,2.3052039770217305e-06,3.6233184351681345e-06,3,1,2
21725,nurturing,2.095639979110664e-07,3.6233184351681345e-06,3,0,3
21726,nut,1.278340387257504e-05,7.074097897233022e-06,12,6,6
21727,nutrition,1.278340387257504e-05,5.348708166200577e-06,9,6,3
21728,oak,2.3052039770217305e-06,1.8979287041356905e-06,3,2,1
21729,oasi,4.400843956132392e-06,5.348708166200577e-06,5,2,3
21730,oath,1.6974683830796368e-05,2.777877466962238e-05,29,13,16
21731,obese,1.0687763893464371e-05,1.2250267090330355e-05,12,5,7
21732,obesity,2.954852370546031e-05,2.2602605476525032e-05,30,16,14
21733,obey,8.592123914353715e-06,8.79948762826546e-06,9,4,5
21734,obeying,4.400843956132392e-06,1.8979287041356905e-06,3,2,1
21735,obituary,8.592123914353715e-06,7.074097897233022e-06,9,4,5
21736,object,5.050492349656699e-05,5.020884117304414e-05,55,25,30
21737,objected,6.496483935243052e-06,7.074097897233022e-06,7,3,4
21738,objecting,2.3052039770217305e-06,1.8979287041356905e-06,3,1,2
21739,objection,1.9070323809907035e-05,1.2250267090330355e-05,18,11,7
21740,objectionable,2.095639979110664e-07,5.348708166200577e-06,3,0,3
21741,objective,2.5357243747239038e-05,1.052487735929791e-05,23,15,8
21742,objectively,2.3052039770217305e-06,3.6233184351681345e-06,3,1,2
21743,objector,4.400843956132392e-06,3.6233184351681345e-06,4,2,2
21744,obligated,2.3052039770217305e-06,3.6233184351681345e-06,3,1,2
21745,obligation,3.3739803663681634e-05,3.640572332478458e-05,41,16,25
21746,obligatory,2.3052039770217305e-06,3.6233184351681345e-06,3,1,2
21747,oblige,8.592123914353715e-06,1.8979287041356905e-06,6,4,2
21748,obliged,6.496483935243052e-06,3.6233184351681345e-06,6,3,3
21749,obliterate,2.3052039770217305e-06,3.6233184351681345e-06,3,1,2
21750,obnoxiou,2.3052039770217305e-06,5.348708166200577e-06,5,1,4
21751,obscene,1.278340387257504e-05,7.074097897233022e-06,13,8,5
21752,obscenity,1.0687763893464371e-05,3.6233184351681345e-06,7,5,2
21753,obscure,1.9070323809907035e-05,1.052487735929791e-05,16,9,7
21754,obscured,4.400843956132392e-06,3.6233184351681345e-06,5,2,3
21755,observance,2.3052039770217305e-06,3.6233184351681345e-06,3,1,2
21756,observation,1.278340387257504e-05,1.3975656821362803e-05,14,6,8
21757,observatory,4.400843956132392e-06,1.8979287041356905e-06,3,2,1
21758,observe,1.0687763893464371e-05,7.074097897233022e-06,10,6,4
21759,observed,1.278340387257504e-05,1.3975656821362803e-05,15,6,9
21760,observer,3.1644163684570994e-05,3.468033359375216e-05,39,17,22
21761,observing,6.496483935243052e-06,1.7253897310324457e-07,3,3,0
21762,obsessed,1.48790438516857e-05,1.2250267090330355e-05,15,8,7
21763,obsession,1.278340387257504e-05,1.2250267090330355e-05,15,7,8
21764,obsolete,1.278340387257504e-05,7.074097897233022e-06,11,7,4
21765,obstacle,1.6974683830796368e-05,1.570104655239525e-05,19,9,10
21766,obstruct,2.3052039770217305e-06,1.8979287041356905e-06,4,1,3
21767,obstructing,6.496483935243052e-06,5.348708166200577e-06,6,3,3
21768,obstruction,1.278340387257504e-05,1.2250267090330355e-05,15,7,8
21769,obtain,3.1644163684570994e-05,4.8483451442011706e-05,47,17,30
21770,obtained,5.050492349656699e-05,3.468033359375216e-05,47,25,22
21771,obtaining,1.6974683830796368e-05,1.2250267090330355e-05,16,9,7
21772,obviou,2.954852370546031e-05,3.8131113055817005e-05,39,16,23
21773,obviously,1.48790438516857e-05,2.2602605476525032e-05,23,9,14
21774,occasion,1.0687763893464371e-05,1.2250267090330355e-05,14,6,8
21775,occasional,4.400843956132392e-06,5.348708166200577e-06,6,2,4
21776,occasionally,6.496483935243052e-06,5.348708166200577e-06,6,3,3
21777,occupation,6.307876337123095e-05,5.1934230904076595e-05,72,35,37
21778,occupied,5.888748341300963e-05,5.1934230904076595e-05,64,29,35
21779,occupier,2.3052039770217305e-06,1.8979287041356905e-06,4,1,3
21780,occupy,2.5357243747239038e-05,2.087721574549256e-05,29,16,13
21781,occupying,2.116596378901769e-05,7.074097897233022e-06,16,12,4
21782,occur,2.116596378901769e-05,2.6053384938589907e-05,26,10,16
21783,occurred,3.7931083621902995e-05,3.468033359375216e-05,40,19,21
21784,occurrence,4.400843956132392e-06,1.7253897310324457e-07,4,3,1
21785,occurring,4.400843956132392e-06,3.6233184351681345e-06,6,4,2
21786,ocean,0.00011337412286988677,0.00010714670229711469,123,55,68
21787,odd,5.260056347567764e-05,4.6758061710979285e-05,55,26,29
21788,odiou,2.3052039770217305e-06,5.348708166200577e-06,4,1,3
21789,of,2.3052039770217305e-06,1.8979287041356905e-06,3,1,2
21790,off,2.095639979110664e-07,5.348708166200577e-06,3,0,3
21791,offduty,6.496483935243052e-06,1.8979287041356905e-06,4,3,1
21792,offence,3.1644163684570994e-05,3.2954943862719716e-05,36,15,21
21793,offend,1.48790438516857e-05,5.348708166200577e-06,11,7,4
21794,offended,1.0687763893464371e-05,1.742643628342769e-05,15,5,10
21795,offender,3.583544364279237e-05,4.1581892517881935e-05,45,18,27
21796,offending,1.6974683830796368e-05,1.052487735929791e-05,15,8,7
21797,offense,2.954852370546031e-05,3.122955413168725e-05,33,15,18
21798,offensive,0.00011337412286988677,0.00010714670229711469,130,58,72
21799,offer,0.0002537820014703013,0.00023310015266248305,288,133,155
21800,offered,0.00010708720293255492,0.00010024514337298497,127,61,66
21801,offering,6.72700433294523e-05,6.228656929027126e-05,72,32,40
21802,office,0.0003522770804885024,0.00033662353652443006,415,190,225
21803,officeholder,2.3052039770217305e-06,5.348708166200577e-06,4,1,3
21804,officer,0.00044658087954848203,0.000438421530655344,523,235,288
21805,official,0.0011234725928012258,0.001000898582971921,1253,595,658
21806,officially,8.193952318322689e-05,7.781507686956326e-05,92,41,51
21807,officials,2.3052039770217305e-06,3.6233184351681345e-06,4,1,3
21808,offlimit,1.278340387257504e-05,3.6233184351681345e-06,8,6,2
21809,offline,1.278340387257504e-05,1.9151826014460126e-05,17,6,11
21810,offset,4.400843956132392e-06,5.348708166200577e-06,5,2,3
21811,offshoot,2.3052039770217305e-06,3.6233184351681345e-06,4,1,3
21812,offshore,8.193952318322689e-05,6.573734875233614e-05,81,41,40
21813,offshoring,2.3052039770217305e-06,5.348708166200577e-06,4,1,3
21814,offspring,2.3052039770217305e-06,3.6233184351681345e-06,3,1,2
21815,often,0.00023282560167919462,0.00027450950620726186,301,129,172
21816,oftforgotten,2.3052039770217305e-06,3.6233184351681345e-06,3,1,2
21817,oh,6.496483935243052e-06,8.79948762826546e-06,9,3,6
21818,oil,0.0007085358769373152,0.0005747273194069072,742,368,374
21819,oilfield,4.400843956132392e-06,7.074097897233022e-06,7,2,5
21820,oilrich,6.496483935243052e-06,8.79948762826546e-06,8,3,5
21821,oilsand,8.592123914353715e-06,1.7253897310324457e-07,4,4,0
21822,ok,6.496483935243052e-06,1.8979287041356905e-06,5,4,1
21823,okay,1.6974683830796368e-05,1.9151826014460126e-05,22,9,13
21824,old,0.0004256244797573756,0.00037630750033817615,471,218,253
21825,older,2.954852370546031e-05,3.640572332478458e-05,41,16,25
21826,oldest,6.517440335034157e-05,5.020884117304414e-05,69,32,37
21827,oldfashioned,8.592123914353715e-06,5.348708166200577e-06,9,5,4
21828,oligarch,1.0687763893464371e-05,1.052487735929791e-05,12,5,7
21829,oligarchy,2.3052039770217305e-06,7.074097897233022e-06,5,1,4
21830,olive,1.9070323809907035e-05,1.2250267090330355e-05,18,10,8
21831,olympic,4.400843956132392e-06,7.074097897233022e-06,6,2,4
21832,omicron,6.496483935243052e-06,1.8979287041356905e-06,4,3,1
21833,ominou,4.400843956132392e-06,1.8979287041356905e-06,3,2,1
21834,omission,4.400843956132392e-06,8.79948762826546e-06,7,2,5
21835,omit,4.400843956132392e-06,1.8979287041356905e-06,3,2,1
21836,omnibu,2.3052039770217305e-06,5.348708166200577e-06,5,2,3
21837,on,4.400843956132392e-06,3.6233184351681345e-06,4,2,2
21838,onair,2.095639979110664e-07,5.348708166200577e-06,4,1,3
21839,onboard,2.3052039770217305e-06,1.570104655239525e-05,11,1,10
21840,onboarding,1.0687763893464371e-05,3.6233184351681345e-06,7,5,2
21841,onceinalifetime,2.3052039770217305e-06,3.6233184351681345e-06,3,1,2
21842,oncologist,2.3052039770217305e-06,3.6233184351681345e-06,3,1,2
21843,oncoming,2.3052039770217305e-06,3.6233184351681345e-06,3,1,2
21844,one,0.0022676920213956474,0.0024433243981150455,2757,1203,1554
21845,onechild,4.400843956132392e-06,3.6233184351681345e-06,5,3,2
21846,oneday,4.400843956132392e-06,3.6233184351681345e-06,4,2,2
21847,onefifth,4.400843956132392e-06,1.8979287041356905e-06,3,2,1
21848,onequarter,2.3052039770217305e-06,3.6233184351681345e-06,5,2,3
21849,onesizefitsall,2.095639979110664e-07,5.348708166200577e-06,3,0,3
21850,onestate,2.095639979110664e-07,5.348708166200577e-06,3,0,3
21851,onethird,1.9070323809907035e-05,1.052487735929791e-05,17,9,8
21852,onetime,2.3052039770217305e-06,1.2250267090330355e-05,9,1,8
21853,oneway,4.400843956132392e-06,5.348708166200577e-06,5,2,3
21854,oneyear,8.592123914353715e-06,3.6233184351681345e-06,6,4,2
21855,oneyearold,2.3052039770217305e-06,3.6233184351681345e-06,4,2,2
21856,ongoing,5.050492349656699e-05,8.989280498679035e-05,78,25,53
21857,online,0.00031036428090628937,0.0002486286602417749,325,163,162
21858,onlooker,4.400843956132392e-06,1.8979287041356905e-06,3,2,1
21859,onsite,2.3052039770217305e-06,1.8979287041356905e-06,3,2,1
21860,onslaught,4.400843956132392e-06,5.348708166200577e-06,6,2,4
21861,onstage,2.3052039770217305e-06,3.6233184351681345e-06,3,1,2
21862,onto,6.098312339212028e-05,4.8483451442011706e-05,60,30,30
21863,onu,4.400843956132392e-06,1.8979287041356905e-06,3,2,1
21864,onward,4.400843956132392e-06,1.8979287041356905e-06,3,2,1
21865,op,1.9070323809907035e-05,8.79948762826546e-06,22,9,13
21866,oped,2.116596378901769e-05,1.742643628342769e-05,23,11,12
21867,open,0.00036065964040494494,0.00040391373603469537,448,187,261
21868,openair,6.496483935243052e-06,1.7253897310324457e-07,3,3,0
21869,opened,0.00012385232276544028,7.781507686956326e-05,110,61,49
21870,openended,2.095639979110664e-07,7.074097897233022e-06,4,0,4
21871,opening,8.193952318322689e-05,5.5385010366141504e-05,84,46,38
21872,openly,4.4218003559234974e-05,2.2602605476525032e-05,40,23,17
21873,opennes,6.496483935243052e-06,3.6233184351681345e-06,6,4,2
21874,operate,3.3739803663681634e-05,3.640572332478458e-05,44,19,25
21875,operated,1.0687763893464371e-05,1.2250267090330355e-05,13,5,8
21876,operating,3.1644163684570994e-05,4.8483451442011706e-05,54,21,33
21877,operation,0.0002265386817418625,0.0002089446964280291,251,116,135
21878,operational,6.496483935243052e-06,5.348708166200577e-06,6,3,3
21879,operative,3.583544364279237e-05,2.9504164400654783e-05,37,18,19
21880,operator,3.7931083621902995e-05,4.1581892517881935e-05,46,21,25
21881,opinion,0.00011337412286988677,0.00010024514337298497,128,61,67
21882,opioid,2.326160376812834e-05,3.640572332478458e-05,35,12,23
21883,opium,1.0687763893464371e-05,2.087721574549256e-05,18,6,12
21884,opponent,8.403516316233764e-05,8.816741525575797e-05,102,43,59
21885,opportunity,0.00011966104280721883,0.00019341618884873702,190,68,122
21886,oppose,6.517440335034157e-05,8.816741525575797e-05,91,34,57
21887,opposed,5.6791843433898893e-05,5.1934230904076595e-05,67,31,36
21888,opposing,3.3739803663681634e-05,4.330728224891437e-05,44,17,27
21889,opposite,3.7931083621902995e-05,2.2602605476525032e-05,38,23,15
21890,opposition,0.00024120816159563723,0.0002469032705107427,293,132,161
21891,oppressed,8.592123914353715e-06,5.348708166200577e-06,7,4,3
21892,oppression,8.592123914353715e-06,1.9151826014460126e-05,18,5,13
21893,oppressive,6.496483935243052e-06,1.742643628342769e-05,13,3,10
21894,oppressor,6.496483935243052e-06,3.6233184351681345e-06,5,3,2
21895,opt,6.496483935243052e-06,1.3975656821362803e-05,12,3,9
21896,opted,8.592123914353715e-06,1.570104655239525e-05,13,4,9
21897,optic,8.592123914353715e-06,1.7253897310324457e-07,4,4,0
21898,optical,2.3052039770217305e-06,7.074097897233022e-06,5,1,4
21899,optimism,4.400843956132392e-06,1.052487735929791e-05,10,2,8
21900,optimistic,1.278340387257504e-05,1.3975656821362803e-05,16,8,8
21901,opting,2.3052039770217305e-06,7.074097897233022e-06,5,1,4
21902,option,0.00012175668278632962,0.00011232287149021227,139,66,73
21903,optional,2.3052039770217305e-06,1.8979287041356905e-06,3,1,2
21904,opus,4.400843956132392e-06,8.79948762826546e-06,7,2,5
21905,or,6.496483935243052e-06,3.6233184351681345e-06,5,3,2
21906,oral,1.278340387257504e-05,1.052487735929791e-05,12,6,6
21907,orange,1.0687763893464371e-05,1.9151826014460126e-05,16,5,11
21908,orangutan,1.6974683830796368e-05,8.79948762826546e-06,13,8,5
21909,orb,2.095639979110664e-07,3.6233184351681345e-06,3,0,3
21910,orbit,4.6313643538345614e-05,1.742643628342769e-05,39,24,15
21911,orbiter,4.400843956132392e-06,3.6233184351681345e-06,4,2,2
21912,orbiting,8.592123914353715e-06,1.8979287041356905e-06,5,4,1
21913,orchestrated,6.496483935243052e-06,5.348708166200577e-06,6,3,3
21914,orchestrating,2.3052039770217305e-06,3.6233184351681345e-06,3,1,2
21915,ordeal,1.6974683830796368e-05,7.074097897233022e-06,14,8,6
21916,order,0.0005115457189009127,0.0005091625096276747,595,270,325
21917,ordered,0.0002160604818463093,0.00018996540938667205,232,110,122
21918,ordering,2.954852370546031e-05,1.9151826014460126e-05,26,15,11
21919,ordinance,2.3052039770217305e-06,1.8979287041356905e-06,5,2,3
21920,ordinary,3.7931083621902995e-05,4.330728224891437e-05,50,20,30
21921,ordination,4.400843956132392e-06,1.8979287041356905e-06,3,2,1
21922,ordnance,2.3052039770217305e-06,3.6233184351681345e-06,3,1,2
21923,ore,6.496483935243052e-06,3.6233184351681345e-06,6,4,2
21924,organ,2.954852370546031e-05,7.263890767646595e-05,64,18,46
21925,organic,1.48790438516857e-05,1.570104655239525e-05,18,9,9
21926,organisation,4.4218003559234974e-05,4.6758061710979285e-05,53,24,29
21927,organise,6.496483935243052e-06,3.6233184351681345e-06,5,3,2
21928,organised,1.6974683830796368e-05,2.087721574549256e-05,21,8,13
21929,organiser,2.3052039770217305e-06,7.074097897233022e-06,6,1,5
21930,organising,8.592123914353715e-06,1.8979287041356905e-06,6,5,1
21931,organism,1.0687763893464371e-05,5.348708166200577e-06,9,5,4
21932,organization,0.00024120816159563723,0.0002538048294348729,286,124,162
21933,organizational,6.496483935243052e-06,8.79948762826546e-06,9,4,5
21934,organize,1.0687763893464371e-05,1.3975656821362803e-05,14,6,8
21935,organized,4.4218003559234974e-05,6.746273848336857e-05,66,24,42
21936,organizer,2.5357243747239038e-05,2.6053384938589907e-05,31,12,19
21937,organizing,1.48790438516857e-05,1.570104655239525e-05,16,7,9
21938,orgy,4.400843956132392e-06,3.6233184351681345e-06,4,2,2
21939,orientation,2.095639979110664e-07,1.052487735929791e-05,8,0,8
21940,oriented,2.095639979110664e-07,5.348708166200577e-06,3,0,3
21941,origin,4.6313643538345614e-05,3.122955413168725e-05,44,25,19
21942,original,4.6313643538345614e-05,4.50326719799468e-05,55,25,30
21943,originally,5.050492349656699e-05,5.3659620635109e-05,58,25,33
21944,originate,2.3052039770217305e-06,5.348708166200577e-06,5,1,4
21945,originated,6.496483935243052e-06,5.348708166200577e-06,7,3,4
21946,orphan,1.0687763893464371e-05,8.79948762826546e-06,10,5,5
21947,orphanage,8.592123914353715e-06,7.074097897233022e-06,8,4,4
21948,orphaned,8.592123914353715e-06,1.7253897310324457e-07,4,4,0
21949,orthodoxy,6.496483935243052e-06,5.348708166200577e-06,6,3,3
21950,ostensibly,4.400843956132392e-06,3.6233184351681345e-06,4,2,2
21951,other,0.0003208424808018424,0.00029521418297965093,355,164,191
21952,others,2.3052039770217305e-06,3.6233184351681345e-06,3,1,2
21953,otherwise,6.72700433294523e-05,5.883578982820635e-05,68,34,34
21954,ought,2.5357243747239038e-05,2.4327995207557487e-05,27,13,14
21955,ounce,4.400843956132392e-06,3.6233184351681345e-06,4,2,2
21956,oust,4.400843956132392e-06,1.742643628342769e-05,16,3,13
21957,ousted,2.954852370546031e-05,2.2602605476525032e-05,31,14,17
21958,ouster,1.48790438516857e-05,5.348708166200577e-06,11,8,3
21959,ousting,4.400843956132392e-06,7.074097897233022e-06,7,2,5
21960,out,8.592123914353715e-06,8.79948762826546e-06,9,4,5
21961,outage,1.0687763893464371e-05,1.3975656821362803e-05,14,5,9
21962,outbreak,0.00010918284291166549,0.00010714670229711469,130,63,67
21963,outburst,2.3052039770217305e-06,7.074097897233022e-06,6,1,5
21964,outcome,4.840928351745632e-05,4.1581892517881935e-05,52,25,27
21965,outcry,2.116596378901769e-05,1.3975656821362803e-05,19,11,8
21966,outdated,2.116596378901769e-05,8.79948762826546e-06,16,10,6
21967,outdo,2.3052039770217305e-06,3.6233184351681345e-06,3,1,2
21968,outdoor,1.9070323809907035e-05,1.3975656821362803e-05,18,10,8
21969,outed,4.400843956132392e-06,3.6233184351681345e-06,4,2,2
21970,outer,4.400843956132392e-06,3.6233184351681345e-06,4,2,2
21971,outfit,1.278340387257504e-05,7.074097897233022e-06,11,7,4
21972,outgoing,1.6974683830796368e-05,1.2250267090330355e-05,16,9,7
21973,outing,2.3052039770217305e-06,7.074097897233022e-06,5,1,4
21974,outlandish,2.095639979110664e-07,8.79948762826546e-06,5,0,5
21975,outlaw,1.9070323809907035e-05,2.087721574549256e-05,24,11,13
21976,outlawed,1.278340387257504e-05,1.742643628342769e-05,18,6,12
21977,outlawing,1.48790438516857e-05,7.074097897233022e-06,11,7,4
21978,outlet,3.1644163684570994e-05,3.640572332478458e-05,40,16,24
21979,outlier,2.3052039770217305e-06,7.074097897233022e-06,6,1,5
21980,outline,1.0687763893464371e-05,1.570104655239525e-05,16,6,10
21981,outlined,1.48790438516857e-05,5.348708166200577e-06,10,7,3
21982,outlining,8.592123914353715e-06,3.6233184351681345e-06,6,4,2
21983,outlive,2.095639979110664e-07,5.348708166200577e-06,3,0,3
21984,outlook,1.48790438516857e-05,1.052487735929791e-05,16,7,9
21985,outnumber,8.592123914353715e-06,1.8979287041356905e-06,5,4,1
21986,outofdate,2.095639979110664e-07,3.6233184351681345e-06,3,0,3
21987,outofpocket,2.3052039770217305e-06,1.8979287041356905e-06,3,1,2
21988,outoftouch,2.095639979110664e-07,5.348708166200577e-06,3,0,3
21989,outpaced,2.095639979110664e-07,3.6233184351681345e-06,3,1,2
21990,outpacing,2.3052039770217305e-06,3.6233184351681345e-06,3,1,2
21991,outperform,4.400843956132392e-06,1.8979287041356905e-06,4,2,2
21992,outperforming,2.095639979110664e-07,5.348708166200577e-06,4,0,4
21993,outpost,1.6974683830796368e-05,1.2250267090330355e-05,17,9,8
21994,outpouring,2.3052039770217305e-06,5.348708166200577e-06,4,1,3
21995,output,1.0687763893464371e-05,1.570104655239525e-05,14,5,9
21996,outrage,6.936568330856297e-05,6.056117955923882e-05,78,37,41
21997,outraged,3.1644163684570994e-05,1.9151826014460126e-05,29,16,13
21998,outrageou,2.326160376812834e-05,2.087721574549256e-05,24,11,13
21999,outreach,1.48790438516857e-05,5.348708166200577e-06,10,7,3
22000,outright,1.48790438516857e-05,1.2250267090330355e-05,16,7,9
22001,outside,0.00021396484186719832,0.00019859235804183437,241,116,125
22002,outsider,6.496483935243052e-06,4.1581892517881935e-05,28,3,25
22003,outskirt,6.496483935243052e-06,8.79948762826546e-06,10,4,6
22004,outsmart,4.400843956132392e-06,1.7253897310324457e-07,3,2,1
22005,outsource,2.3052039770217305e-06,5.348708166200577e-06,5,2,3
22006,outsourcing,8.592123914353715e-06,8.79948762826546e-06,9,4,5
22007,outspoken,1.278340387257504e-05,2.087721574549256e-05,24,9,15
22008,outstanding,1.48790438516857e-05,7.074097897233022e-06,11,7,4
22009,outstrip,2.3052039770217305e-06,5.348708166200577e-06,5,1,4
22010,outstripped,2.3052039770217305e-06,3.6233184351681345e-06,3,1,2
22011,outweigh,4.400843956132392e-06,1.052487735929791e-05,9,2,7
22012,ovation,4.400843956132392e-06,3.6233184351681345e-06,5,3,2
22013,oven,4.400843956132392e-06,5.348708166200577e-06,5,2,3
22014,over,2.3052039770217305e-06,3.6233184351681345e-06,3,1,2
22015,overall,4.002672360101368e-05,4.8483451442011706e-05,48,19,29
22016,overblown,2.3052039770217305e-06,3.6233184351681345e-06,3,1,2
22017,overboard,8.592123914353715e-06,3.6233184351681345e-06,7,5,2
22018,overcome,2.116596378901769e-05,3.2954943862719716e-05,32,12,20
22019,overconsumption,4.400843956132392e-06,3.6233184351681345e-06,4,2,2
22020,overcrowded,2.3052039770217305e-06,3.6233184351681345e-06,4,1,3
22021,overcrowding,2.3052039770217305e-06,5.348708166200577e-06,4,1,3
22022,overdose,2.326160376812834e-05,1.9151826014460126e-05,24,12,12
22023,overdraft,6.496483935243052e-06,3.6233184351681345e-06,6,4,2
22024,overdrive,8.592123914353715e-06,1.7253897310324457e-07,4,4,0
22025,overdue,4.400843956132392e-06,5.348708166200577e-06,6,3,3
22026,overfishing,1.0687763893464371e-05,5.348708166200577e-06,8,5,3
22027,overflowing,2.3052039770217305e-06,3.6233184351681345e-06,3,1,2
22028,overhaul,2.116596378901769e-05,3.640572332478458e-05,35,11,24
22029,overheard,2.3052039770217305e-06,7.074097897233022e-06,5,1,4
22030,overheating,4.400843956132392e-06,1.8979287041356905e-06,3,2,1
22031,overjoyed,2.3052039770217305e-06,1.8979287041356905e-06,3,2,1
22032,overload,2.3052039770217305e-06,5.348708166200577e-06,4,1,3
22033,overlook,6.496483935243052e-06,8.79948762826546e-06,10,4,6
22034,overlooked,1.278340387257504e-05,8.79948762826546e-06,11,6,5
22035,overlooking,2.095639979110664e-07,8.79948762826546e-06,5,0,5
22036,overly,6.496483935243052e-06,5.348708166200577e-06,7,4,3
22037,overnight,3.583544364279237e-05,1.742643628342769e-05,28,17,11
22038,override,4.400843956132392e-06,7.074097897233022e-06,8,3,5
22039,overrule,6.496483935243052e-06,5.348708166200577e-06,7,4,3
22040,overruled,2.3052039770217305e-06,7.074097897233022e-06,5,1,4
22041,overrun,2.3052039770217305e-06,1.2250267090330355e-05,8,1,7
22042,oversaw,4.400843956132392e-06,1.8979287041356905e-06,3,2,1
22043,oversea,4.840928351745632e-05,6.573734875233614e-05,69,30,39
22044,oversee,1.48790438516857e-05,1.570104655239525e-05,19,8,11
22045,overseeing,4.400843956132392e-06,8.79948762826546e-06,8,2,6
22046,overshadowed,2.3052039770217305e-06,1.8979287041356905e-06,3,2,1
22047,oversight,2.7452883726349685e-05,3.468033359375216e-05,38,15,23
22048,overstated,1.278340387257504e-05,3.6233184351681345e-06,8,6,2
22049,overstepped,4.400843956132392e-06,1.8979287041356905e-06,4,3,1
22050,overt,4.400843956132392e-06,5.348708166200577e-06,8,4,4
22051,overtake,1.48790438516857e-05,1.9151826014460126e-05,23,7,16
22052,overtaken,8.592123914353715e-06,1.8979287041356905e-06,8,4,4
22053,overtaking,8.592123914353715e-06,1.8979287041356905e-06,5,4,1
22054,overthrew,2.3052039770217305e-06,5.348708166200577e-06,4,1,3
22055,overthrow,1.9070323809907035e-05,1.9151826014460126e-05,23,10,13
22056,overthrowing,2.3052039770217305e-06,5.348708166200577e-06,5,2,3
22057,overthrown,2.3052039770217305e-06,1.052487735929791e-05,8,1,7
22058,overtime,1.278340387257504e-05,1.052487735929791e-05,14,7,7
22059,overtly,2.3052039770217305e-06,3.6233184351681345e-06,3,1,2
22060,overtone,4.400843956132392e-06,1.8979287041356905e-06,3,2,1
22061,overtook,2.095639979110664e-07,5.348708166200577e-06,3,0,3
22062,overturn,3.7931083621902995e-05,2.6053384938589907e-05,36,19,17
22063,overturned,2.116596378901769e-05,1.742643628342769e-05,23,10,13
22064,overturning,2.3052039770217305e-06,3.6233184351681345e-06,3,1,2
22065,overview,2.3052039770217305e-06,3.6233184351681345e-06,3,1,2
22066,overweight,8.592123914353715e-06,5.348708166200577e-06,7,4,3
22067,overwhelm,6.496483935243052e-06,1.8979287041356905e-06,4,3,1
22068,overwhelmed,4.400843956132392e-06,2.6053384938589907e-05,18,3,15
22069,overwhelming,3.1644163684570994e-05,2.4327995207557487e-05,37,18,19
22070,overwhelmingly,3.1644163684570994e-05,3.122955413168725e-05,35,16,19
22071,overwork,4.400843956132392e-06,1.8979287041356905e-06,3,2,1
22072,overzealou,2.3052039770217305e-06,5.348708166200577e-06,4,1,3
22073,owe,3.583544364279237e-05,4.330728224891437e-05,44,18,26
22074,owed,6.496483935243052e-06,1.570104655239525e-05,14,3,11
22075,owing,2.3052039770217305e-06,5.348708166200577e-06,4,1,3
22076,own,1.278340387257504e-05,2.9504164400654783e-05,28,7,21
22077,owned,3.7931083621902995e-05,4.6758061710979285e-05,50,20,30
22078,owner,0.00015738256243121094,0.0001364783277246665,177,85,92
22079,ownership,2.5357243747239038e-05,2.4327995207557487e-05,28,13,15
22080,owning,6.496483935243052e-06,1.742643628342769e-05,13,3,10
22081,oxygen,1.9070323809907035e-05,8.79948762826546e-06,14,9,5
22082,ozone,6.496483935243052e-06,3.6233184351681345e-06,6,4,2
22083,pa,0.0001154697628489974,0.0001382037174556987,155,62,93
22084,pace,2.5357243747239038e-05,2.9504164400654783e-05,31,12,19
22085,pacific,4.400843956132392e-06,5.348708166200577e-06,5,2,3
22086,pacifist,2.095639979110664e-07,3.6233184351681345e-06,3,1,2
22087,pacing,4.400843956132392e-06,3.6233184351681345e-06,4,2,2
22088,pack,2.326160376812834e-05,2.6053384938589907e-05,29,13,16
22089,package,5.050492349656699e-05,5.5385010366141504e-05,59,25,34
22090,packaging,2.116596378901769e-05,1.2250267090330355e-05,17,10,7
22091,packed,6.496483935243052e-06,2.087721574549256e-05,17,4,13
22092,packet,1.0687763893464371e-05,3.6233184351681345e-06,9,6,3
22093,packing,4.400843956132392e-06,3.6233184351681345e-06,4,2,2
22094,pact,3.583544364279237e-05,3.985650278684949e-05,46,18,28
22095,pad,2.3052039770217305e-06,1.2250267090330355e-05,10,1,9
22096,paedophile,4.840928351745632e-05,3.122955413168725e-05,46,24,22
22097,paedophilia,4.400843956132392e-06,1.8979287041356905e-06,5,2,3
22098,pagan,4.400843956132392e-06,5.348708166200577e-06,6,3,3
22099,page,0.00010080028299522283,9.851975364195259e-05,120,54,66
22100,pageant,4.400843956132392e-06,1.3975656821362803e-05,11,2,9
22101,paid,0.00022025176180453062,0.0002106700861590614,254,112,142
22102,pain,4.6313643538345614e-05,6.056117955923882e-05,63,24,39
22103,painful,2.326160376812834e-05,1.9151826014460126e-05,24,12,12
22104,painfully,2.3052039770217305e-06,3.6233184351681345e-06,4,2,2
22105,painkiller,4.400843956132392e-06,5.348708166200577e-06,6,2,4
22106,painles,2.3052039770217305e-06,5.348708166200577e-06,5,2,3
22107,paint,8.592123914353715e-06,3.122955413168725e-05,25,5,20
22108,painted,1.0687763893464371e-05,1.052487735929791e-05,13,6,7
22109,painting,2.116596378901769e-05,2.777877466962238e-05,28,10,18
22110,pair,1.48790438516857e-05,3.468033359375216e-05,31,8,23
22111,pal,2.095639979110664e-07,1.8979287041356905e-06,3,1,2
22112,palace,3.1644163684570994e-05,3.8131113055817005e-05,42,18,24
22113,pale,2.095639979110664e-07,5.348708166200577e-06,3,0,3
22114,palestinian,8.592123914353715e-06,7.074097897233022e-06,9,5,4
22115,palm,2.116596378901769e-05,1.3975656821362803e-05,20,11,9
22116,palpable,6.496483935243052e-06,1.8979287041356905e-06,4,3,1
22117,palsy,2.3052039770217305e-06,1.8979287041356905e-06,5,2,3
22118,paltry,2.095639979110664e-07,3.6233184351681345e-06,3,0,3
22119,pamphlet,2.3052039770217305e-06,5.348708166200577e-06,5,1,4
22120,panda,1.0687763893464371e-05,5.348708166200577e-06,8,5,3
22121,pandemic,5.4696203454788295e-05,5.883578982820635e-05,70,30,40
22122,pander,2.095639979110664e-07,5.348708166200577e-06,3,0,3
22123,panel,0.00012175668278632962,0.0001019705331040174,134,64,70
22124,panhandling,2.095639979110664e-07,3.6233184351681345e-06,3,0,3
22125,panic,4.212236358012434e-05,3.2954943862719716e-05,44,22,22
22126,panned,2.3052039770217305e-06,3.6233184351681345e-06,3,1,2
22127,pant,8.592123914353715e-06,1.2250267090330355e-05,14,5,9
22128,pantry,4.400843956132392e-06,3.6233184351681345e-06,5,2,3
22129,papacy,2.3052039770217305e-06,3.6233184351681345e-06,4,1,3
22130,papal,4.400843956132392e-06,1.8979287041356905e-06,3,2,1
22131,paper,0.00015109564249387862,0.0001347529379936339,159,74,85
22132,paperwork,1.48790438516857e-05,1.3975656821362803e-05,15,7,8
22133,par,1.0687763893464371e-05,8.79948762826546e-06,12,6,6
22134,parachute,6.496483935243052e-06,1.8979287041356905e-06,5,3,2
22135,parachuted,2.3052039770217305e-06,3.6233184351681345e-06,3,1,2
22136,parade,3.1644163684570994e-05,3.122955413168725e-05,39,18,21
22137,paraded,1.0687763893464371e-05,3.6233184351681345e-06,8,5,3
22138,paradigm,2.3052039770217305e-06,1.052487735929791e-05,7,1,6
22139,paradise,1.9070323809907035e-05,3.6233184351681345e-06,11,9,2
22140,paradox,6.496483935243052e-06,7.074097897233022e-06,7,3,4
22141,paragraph,6.496483935243052e-06,7.074097897233022e-06,8,3,5
22142,parallel,1.9070323809907035e-05,2.087721574549256e-05,24,11,13
22143,paralysed,8.592123914353715e-06,7.074097897233022e-06,9,5,4
22144,paralysi,6.496483935243052e-06,1.8979287041356905e-06,4,3,1
22145,paralyzed,1.48790438516857e-05,1.3975656821362803e-05,19,9,10
22146,paramedic,2.3052039770217305e-06,3.6233184351681345e-06,3,1,2
22147,paramilitary,2.7452883726349685e-05,7.074097897233022e-06,20,15,5
22148,paramount,6.496483935243052e-06,1.7253897310324457e-07,3,3,0
22149,paranoia,6.496483935243052e-06,1.052487735929791e-05,9,3,6
22150,paranoid,6.496483935243052e-06,7.074097897233022e-06,9,3,6
22151,paraphrase,4.400843956132392e-06,1.8979287041356905e-06,3,2,1
22152,parasite,6.496483935243052e-06,1.8979287041356905e-06,4,3,1
22153,paratrooper,1.278340387257504e-05,3.6233184351681345e-06,8,6,2
22154,parcel,4.400843956132392e-06,7.074097897233022e-06,6,2,4
22155,parched,2.095639979110664e-07,3.6233184351681345e-06,3,0,3
22156,pardon,3.1644163684570994e-05,3.985650278684949e-05,42,17,25
22157,pardoned,8.592123914353715e-06,7.074097897233022e-06,8,4,4
22158,parent,0.00024539944155385846,0.00024172710131764556,281,127,154
22159,parental,1.48790438516857e-05,8.79948762826546e-06,12,7,5
22160,parenting,2.095639979110664e-07,5.348708166200577e-06,5,0,5
22161,parish,2.3052039770217305e-06,5.348708166200577e-06,4,1,3
22162,parishioner,4.400843956132392e-06,1.8979287041356905e-06,5,3,2
22163,parity,2.3052039770217305e-06,5.348708166200577e-06,4,1,3
22164,park,0.00011127848289077625,8.299124606266055e-05,118,57,61
22165,parked,4.400843956132392e-06,5.348708166200577e-06,5,2,3
22166,parking,1.48790438516857e-05,1.9151826014460126e-05,23,11,12
22167,parliament,0.0002265386817418625,0.00020721930669699654,259,126,133
22168,parliamentarian,1.48790438516857e-05,1.052487735929791e-05,14,7,7
22169,parliamentary,3.7931083621902995e-05,4.1581892517881935e-05,48,21,27
22170,parody,8.592123914353715e-06,7.074097897233022e-06,8,4,4
22171,parole,4.400843956132392e-06,7.074097897233022e-06,7,2,5
22172,part,0.0006289015577311095,0.0006178620626827184,735,331,404
22173,partial,1.9070323809907035e-05,1.9151826014460126e-05,22,10,12
22174,partially,1.0687763893464371e-05,7.074097897233022e-06,9,5,4
22175,participant,1.48790438516857e-05,2.4327995207557487e-05,23,8,15
22176,participate,2.5357243747239038e-05,2.6053384938589907e-05,33,15,18
22177,participated,1.6974683830796368e-05,1.9151826014460126e-05,19,8,11
22178,participating,2.326160376812834e-05,2.2602605476525032e-05,26,12,14
22179,participation,2.326160376812834e-05,2.4327995207557487e-05,31,14,17
22180,particle,3.1644163684570994e-05,1.742643628342769e-05,28,18,10
22181,particular,5.4696203454788295e-05,5.1934230904076595e-05,60,27,33
22182,particularly,5.888748341300963e-05,8.126585633162811e-05,83,32,51
22183,parting,4.400843956132392e-06,5.348708166200577e-06,6,2,4
22184,partisan,3.1644163684570994e-05,4.6758061710979285e-05,46,18,28
22185,partisanship,4.400843956132392e-06,3.6233184351681345e-06,5,2,3
22186,partly,1.9070323809907035e-05,1.3975656821362803e-05,20,11,9
22187,partner,0.00010080028299522283,8.4716635793693e-05,104,53,51
22188,partnering,2.3052039770217305e-06,1.8979287041356905e-06,3,2,1
22189,partnership,3.3739803663681634e-05,1.9151826014460126e-05,31,18,13
22190,parttime,2.3052039770217305e-06,1.8979287041356905e-06,3,1,2
22191,party,0.0006603361574177697,0.0005885304372551671,734,344,390
22192,partying,6.496483935243052e-06,1.7253897310324457e-07,3,3,0
22193,pas,0.00011127848289077625,7.781507686956326e-05,112,55,57
22194,passage,2.954852370546031e-05,2.087721574549256e-05,32,14,18
22195,passed,0.0001762433222432067,0.00017788768126944505,206,89,117
22196,passenger,0.00010289592297433347,0.00012094982014537423,138,52,86
22197,passerby,4.400843956132392e-06,1.7253897310324457e-07,4,4,0
22198,passing,2.954852370546031e-05,6.746273848336857e-05,64,19,45
22199,passion,1.9070323809907035e-05,2.2602605476525032e-05,22,9,13
22200,passionate,8.592123914353715e-06,8.79948762826546e-06,13,6,7
22201,passive,8.592123914353715e-06,5.348708166200577e-06,7,4,3
22202,passively,2.3052039770217305e-06,3.6233184351681345e-06,3,1,2
22203,passport,7.984388320411623e-05,6.918812821440096e-05,89,41,48
22204,passportfree,4.400843956132392e-06,1.8979287041356905e-06,3,2,1
22205,password,1.6974683830796368e-05,1.052487735929791e-05,20,9,11
22206,past,0.00043191139969470744,0.0004125406846898576,491,219,272
22207,pasta,4.400843956132392e-06,8.79948762826546e-06,8,3,5
22208,paste,2.095639979110664e-07,5.348708166200577e-06,3,0,3
22209,pasted,2.3052039770217305e-06,3.6233184351681345e-06,3,1,2
22210,pastor,8.592123914353715e-06,2.087721574549256e-05,20,5,15
22211,pat,2.3052039770217305e-06,1.7253897310324457e-07,3,3,0
22212,patch,2.3052039770217305e-06,7.074097897233022e-06,7,2,5
22213,patched,2.095639979110664e-07,3.6233184351681345e-06,3,0,3
22214,patent,3.3739803663681634e-05,4.1581892517881935e-05,50,19,31
22215,patented,2.095639979110664e-07,5.348708166200577e-06,7,0,7
22216,patently,2.3052039770217305e-06,3.6233184351681345e-06,3,1,2
22217,paternity,2.3052039770217305e-06,1.8979287041356905e-06,3,1,2
22218,path,7.565260324589493e-05,9.679436391092026e-05,108,42,66
22219,pathetic,4.400843956132392e-06,8.79948762826546e-06,9,4,5
22220,pathogen,4.400843956132392e-06,1.8979287041356905e-06,3,2,1
22221,pathological,2.095639979110664e-07,5.348708166200577e-06,3,0,3
22222,pathologist,6.496483935243052e-06,3.6233184351681345e-06,5,3,2
22223,pathway,1.278340387257504e-05,1.742643628342769e-05,16,6,10
22224,patience,6.496483935243052e-06,2.2602605476525032e-05,19,4,15
22225,patient,0.00015738256243121094,0.00016408456342118544,187,79,108
22226,patriot,4.400843956132392e-06,8.79948762826546e-06,8,3,5
22227,patriotic,8.592123914353715e-06,1.2250267090330355e-05,12,4,8
22228,patriotism,1.6974683830796368e-05,1.3975656821362803e-05,16,8,8
22229,patrol,1.9070323809907035e-05,4.1581892517881935e-05,35,10,25
22230,patrolling,6.496483935243052e-06,5.348708166200577e-06,6,3,3
22231,patron,8.592123914353715e-06,5.348708166200577e-06,7,4,3
22232,pattern,4.840928351745632e-05,3.122955413168725e-05,45,24,21
22233,pause,1.278340387257504e-05,1.742643628342769e-05,16,6,10
22234,paused,8.592123914353715e-06,3.6233184351681345e-06,6,4,2
22235,pave,8.592123914353715e-06,8.79948762826546e-06,12,5,7
22236,paved,6.496483935243052e-06,5.348708166200577e-06,6,3,3
22237,paving,2.3052039770217305e-06,3.6233184351681345e-06,5,1,4
22238,pawn,4.400843956132392e-06,1.8979287041356905e-06,3,2,1
22239,pay,0.0005890843981280072,0.0005954319961792964,711,311,400
22240,payback,4.400843956132392e-06,1.8979287041356905e-06,3,2,1
22241,paycheck,1.0687763893464371e-05,8.79948762826546e-06,11,5,6
22242,payday,1.6974683830796368e-05,3.6233184351681345e-06,10,8,2
22243,payed,2.3052039770217305e-06,1.8979287041356905e-06,3,2,1
22244,payer,2.3052039770217305e-06,3.6233184351681345e-06,3,1,2
22245,paying,0.00014690436253565753,0.0001364783277246665,164,75,89
22246,payment,0.00010708720293255492,0.00011577365095227703,139,62,77
22247,payoff,2.3052039770217305e-06,5.348708166200577e-06,4,1,3
22248,payout,2.116596378901769e-05,1.570104655239525e-05,21,12,9
22249,payroll,4.400843956132392e-06,1.3975656821362803e-05,10,2,8
22250,pdf,4.400843956132392e-06,7.074097897233022e-06,6,2,4
22251,peace,0.0002642602013658546,0.0002313747629314509,289,137,152
22252,peaceful,6.72700433294523e-05,5.711040009717395e-05,80,37,43
22253,peacefully,1.0687763893464371e-05,7.074097897233022e-06,11,6,5
22254,peacekeeper,2.7452883726349685e-05,1.570104655239525e-05,29,15,14
22255,peacekeeping,2.3052039770217305e-06,1.3975656821362803e-05,11,1,10
22256,peacetime,2.3052039770217305e-06,3.6233184351681345e-06,4,1,3
22257,peak,2.116596378901769e-05,2.6053384938589907e-05,26,10,16
22258,peanut,4.400843956132392e-06,3.6233184351681345e-06,5,2,3
22259,peasant,1.48790438516857e-05,3.6233184351681345e-06,9,7,2
22260,peculiar,6.496483935243052e-06,1.8979287041356905e-06,4,3,1
22261,pedal,2.3052039770217305e-06,1.8979287041356905e-06,3,2,1
22262,peddled,2.3052039770217305e-06,3.6233184351681345e-06,3,1,2
22263,peddler,2.3052039770217305e-06,3.6233184351681345e-06,4,1,3
22264,peddling,2.3052039770217305e-06,5.348708166200577e-06,4,1,3
22265,pedestrian,8.592123914353715e-06,1.052487735929791e-05,12,6,6
22266,pediatric,4.400843956132392e-06,3.6233184351681345e-06,4,2,2
22267,pedophile,2.326160376812834e-05,4.8483451442011706e-05,42,13,29
22268,pedophilia,8.592123914353715e-06,1.052487735929791e-05,11,4,7
22269,peek,4.400843956132392e-06,3.6233184351681345e-06,4,2,2
22270,peeled,2.095639979110664e-07,5.348708166200577e-06,3,0,3
22271,peeling,2.3052039770217305e-06,3.6233184351681345e-06,3,1,2
22272,peer,3.583544364279237e-05,2.6053384938589907e-05,34,18,16
22273,peerreviewed,2.3052039770217305e-06,5.348708166200577e-06,4,1,3
22274,pelican,4.400843956132392e-06,3.6233184351681345e-06,4,2,2
22275,pelted,2.3052039770217305e-06,5.348708166200577e-06,4,1,3
22276,pen,2.116596378901769e-05,1.742643628342769e-05,22,12,10
22277,penal,2.3052039770217305e-06,3.6233184351681345e-06,4,2,2
22278,penalize,4.400843956132392e-06,7.074097897233022e-06,6,2,4
22279,penalty,0.00013013924270277222,0.00013302754826260141,154,67,87
22280,pencil,2.3052039770217305e-06,3.6233184351681345e-06,3,1,2
22281,pending,1.9070323809907035e-05,2.087721574549256e-05,21,9,12
22282,penetrated,4.400843956132392e-06,1.7253897310324457e-07,3,3,0
22283,penguin,1.48790438516857e-05,1.2250267090330355e-05,14,7,7
22284,peni,4.400843956132392e-06,1.052487735929791e-05,8,2,6
22285,peninsula,1.9070323809907035e-05,2.2602605476525032e-05,25,9,16
22286,penned,6.496483935243052e-06,5.348708166200577e-06,7,4,3
22287,penny,2.5357243747239038e-05,1.3975656821362803e-05,23,12,11
22288,pension,2.954852370546031e-05,6.056117955923882e-05,54,16,38
22289,pensioner,6.496483935243052e-06,1.2250267090330355e-05,15,3,12
22290,people,1.278340387257504e-05,2.2602605476525032e-05,21,7,14
22291,pepper,1.9070323809907035e-05,1.052487735929791e-05,15,9,6
22292,per,0.00023911252161652657,0.0001968669683108019,249,121,128
22293,perceive,2.3052039770217305e-06,3.6233184351681345e-06,4,1,3
22294,perceived,1.6974683830796368e-05,2.087721574549256e-05,24,11,13
22295,percent,0.000465441639360478,0.0005333179658621288,582,252,330
22296,percentage,1.6974683830796368e-05,2.9504164400654783e-05,27,9,18
22297,perception,1.278340387257504e-05,1.3975656821362803e-05,18,8,10
22298,perch,2.095639979110664e-07,5.348708166200577e-06,3,0,3
22299,perennial,2.3052039770217305e-06,3.6233184351681345e-06,3,1,2
22300,perfect,6.098312339212028e-05,7.091351794543343e-05,78,33,45
22301,perfectly,2.116596378901769e-05,1.9151826014460126e-05,22,11,11
22302,perform,2.116596378901769e-05,2.9504164400654783e-05,31,12,19
22303,performance,5.050492349656699e-05,5.020884117304414e-05,58,26,32
22304,performed,2.116596378901769e-05,2.087721574549256e-05,22,10,12
22305,performer,6.496483935243052e-06,1.8979287041356905e-06,4,3,1
22306,performing,2.326160376812834e-05,1.570104655239525e-05,22,12,10
22307,perhap,7.355696326678427e-05,7.263890767646595e-05,83,38,45
22308,peril,1.0687763893464371e-05,1.3975656821362803e-05,15,5,10
22309,perilou,4.400843956132392e-06,1.8979287041356905e-06,4,2,2
22310,period,6.307876337123095e-05,5.5385010366141504e-05,77,36,41
22311,periodic,2.3052039770217305e-06,1.8979287041356905e-06,3,1,2
22312,perished,8.592123914353715e-06,3.6233184351681345e-06,7,4,3
22313,perjury,2.3052039770217305e-06,5.348708166200577e-06,6,3,3
22314,perk,1.0687763893464371e-05,8.79948762826546e-06,11,5,6
22315,permafrost,2.095639979110664e-07,7.074097897233022e-06,4,0,4
22316,permanent,4.6313643538345614e-05,3.122955413168725e-05,48,26,22
22317,permanently,3.1644163684570994e-05,2.9504164400654783e-05,37,18,19
22318,permission,5.4696203454788295e-05,3.468033359375216e-05,54,29,25
22319,permit,3.583544364279237e-05,5.1934230904076595e-05,51,17,34
22320,permitted,2.326160376812834e-05,1.9151826014460126e-05,25,12,13
22321,permitting,8.592123914353715e-06,1.7253897310324457e-07,4,4,0
22322,perniciou,4.400843956132392e-06,1.8979287041356905e-06,3,2,1
22323,perpetrated,8.592123914353715e-06,8.79948762826546e-06,10,5,5
22324,perpetrator,1.6974683830796368e-05,2.087721574549256e-05,22,9,13
22325,perpetual,4.400843956132392e-06,1.2250267090330355e-05,12,2,10
22326,perpetually,4.400843956132392e-06,1.8979287041356905e-06,3,2,1
22327,perpetuate,1.0687763893464371e-05,5.348708166200577e-06,9,5,4
22328,perpetuating,2.3052039770217305e-06,5.348708166200577e-06,4,1,3
22329,perplexed,8.592123914353715e-06,8.79948762826546e-06,9,4,5
22330,persecute,6.496483935243052e-06,1.7253897310324457e-07,3,3,0
22331,persecuted,1.6974683830796368e-05,7.074097897233022e-06,14,8,6
22332,persecution,2.326160376812834e-05,3.468033359375216e-05,33,12,21
22333,persist,1.0687763893464371e-05,1.052487735929791e-05,12,5,7
22334,persistence,6.496483935243052e-06,1.8979287041356905e-06,4,3,1
22335,persistent,8.592123914353715e-06,1.2250267090330355e-05,11,4,7
22336,person,0.0030682264934159217,0.0030696408704798226,3621,1621,2000
22337,persona,6.496483935243052e-06,1.8979287041356905e-06,4,3,1
22338,personal,0.00022234740178364096,0.0002244732040073209,271,124,147
22339,personality,2.5357243747239038e-05,3.2954943862719716e-05,33,13,20
22340,personalization,2.3052039770217305e-06,3.6233184351681345e-06,3,1,2
22341,personally,5.6791843433898893e-05,2.777877466962238e-05,46,27,19
22342,personhood,2.3052039770217305e-06,3.6233184351681345e-06,4,1,3
22343,personnel,3.7931083621902995e-05,3.122955413168725e-05,42,20,22
22344,perspective,3.1644163684570994e-05,2.9504164400654783e-05,37,20,17
22345,persuade,1.0687763893464371e-05,1.570104655239525e-05,20,8,12
22346,persuasive,2.3052039770217305e-06,3.6233184351681345e-06,3,1,2
22347,pervasive,1.6974683830796368e-05,1.3975656821362803e-05,17,8,9
22348,perverse,2.095639979110664e-07,7.074097897233022e-06,4,0,4
22349,pervert,4.400843956132392e-06,1.8979287041356905e-06,3,2,1
22350,perverting,4.400843956132392e-06,3.6233184351681345e-06,4,2,2
22351,pessimistic,2.095639979110664e-07,8.79948762826546e-06,5,0,5
22352,pest,2.3052039770217305e-06,5.348708166200577e-06,6,2,4
22353,pesticide,3.583544364279237e-05,3.468033359375216e-05,43,20,23
22354,pet,4.002672360101368e-05,4.50326719799468e-05,50,22,28
22355,petition,7.984388320411623e-05,5.020884117304414e-05,72,40,32
22356,petitioned,2.095639979110664e-07,3.6233184351681345e-06,3,0,3
22357,petrol,1.9070323809907035e-05,2.4327995207557487e-05,26,10,16
22358,petroleum,4.400843956132392e-06,8.79948762826546e-06,8,2,6
22359,petty,1.48790438516857e-05,8.79948762826546e-06,13,8,5
22360,phantom,2.3052039770217305e-06,3.6233184351681345e-06,3,1,2
22361,pharaoh,8.592123914353715e-06,5.348708166200577e-06,9,4,5
22362,pharma,6.496483935243052e-06,3.6233184351681345e-06,7,3,4
22363,pharmaceutical,2.954852370546031e-05,2.4327995207557487e-05,30,15,15
22364,pharmacy,1.48790438516857e-05,1.052487735929791e-05,14,8,6
22365,phase,2.7452883726349685e-05,3.985650278684949e-05,40,15,25
22366,phased,6.496483935243052e-06,3.6233184351681345e-06,5,3,2
22367,phaseout,2.3052039770217305e-06,3.6233184351681345e-06,3,1,2
22368,phasing,2.3052039770217305e-06,7.074097897233022e-06,6,2,4
22369,phenomenal,2.3052039770217305e-06,5.348708166200577e-06,4,1,3
22370,phenomenon,2.116596378901769e-05,2.087721574549256e-05,24,11,13
22371,philanthropic,1.0687763893464371e-05,7.074097897233022e-06,9,5,4
22372,philanthropist,4.400843956132392e-06,8.79948762826546e-06,8,2,6
22373,philanthropy,4.400843956132392e-06,1.052487735929791e-05,9,3,6
22374,philosopher,4.400843956132392e-06,1.052487735929791e-05,10,2,8
22375,philosophical,2.3052039770217305e-06,7.074097897233022e-06,6,2,4
22376,philosophy,1.48790438516857e-05,8.79948762826546e-06,12,7,5
22377,phone,0.00029150352109429334,0.0002900380137865542,330,150,180
22378,phonehacking,1.9070323809907035e-05,1.2250267090330355e-05,16,9,7
22379,phony,4.400843956132392e-06,7.074097897233022e-06,7,3,4
22380,phosphorou,6.496483935243052e-06,3.6233184351681345e-06,5,3,2
22381,phosphoru,1.48790438516857e-05,8.79948762826546e-06,15,9,6
22382,photo,0.0001971997220343134,0.00018824001965563945,225,100,125
22383,photograph,4.840928351745632e-05,2.777877466962238e-05,39,23,16
22384,photographed,1.278340387257504e-05,1.9151826014460126e-05,19,8,11
22385,photographer,2.5357243747239038e-05,2.777877466962238e-05,34,15,19
22386,photographing,6.496483935243052e-06,3.6233184351681345e-06,5,3,2
22387,photography,4.400843956132392e-06,3.6233184351681345e-06,5,2,3
22388,photojournalist,6.496483935243052e-06,3.6233184351681345e-06,5,3,2
22389,photoshopped,2.3052039770217305e-06,1.8979287041356905e-06,3,1,2
22390,phrase,1.48790438516857e-05,2.9504164400654783e-05,27,9,18
22391,physic,1.0687763893464371e-05,1.3975656821362803e-05,13,5,8
22392,physical,4.4218003559234974e-05,5.3659620635109e-05,60,27,33
22393,physically,1.6974683830796368e-05,1.742643628342769e-05,19,9,10
22394,physician,1.9070323809907035e-05,1.570104655239525e-05,21,10,11
22395,physicist,1.9070323809907035e-05,1.570104655239525e-05,20,9,11
22396,pianist,4.400843956132392e-06,1.7253897310324457e-07,3,3,0
22397,piano,4.400843956132392e-06,3.6233184351681345e-06,4,2,2
22398,pic,8.403516316233764e-05,8.989280498679035e-05,96,41,55
22399,pick,0.00012385232276544028,0.0001036959228350498,138,66,72
22400,picked,3.1644163684570994e-05,1.742643628342769e-05,31,19,12
22401,picket,4.400843956132392e-06,7.074097897233022e-06,7,3,4
22402,picking,2.326160376812834e-05,2.777877466962238e-05,28,12,16
22403,pickup,2.095639979110664e-07,3.6233184351681345e-06,3,0,3
22404,picnic,8.592123914353715e-06,5.348708166200577e-06,7,4,3
22405,picture,0.00015947820241032126,0.00013992910718673112,175,86,89
22406,pictured,2.3052039770217305e-06,8.79948762826546e-06,6,1,5
22407,pictureperfect,2.3052039770217305e-06,1.8979287041356905e-06,3,2,1
22408,pie,4.400843956132392e-06,1.3975656821362803e-05,10,2,8
22409,piece,8.822644312055891e-05,9.679436391092026e-05,109,46,63
22410,piercing,4.400843956132392e-06,8.79948762826546e-06,7,2,5
22411,pig,3.3739803663681634e-05,5.020884117304414e-05,52,21,31
22412,pigeon,4.400843956132392e-06,5.348708166200577e-06,6,3,3
22413,piggy,4.400843956132392e-06,3.6233184351681345e-06,4,2,2
22414,pile,2.326160376812834e-05,2.4327995207557487e-05,29,13,16
22415,piled,8.592123914353715e-06,7.074097897233022e-06,8,4,4
22416,pileup,2.095639979110664e-07,3.6233184351681345e-06,3,0,3
22417,pilgrim,8.592123914353715e-06,8.79948762826546e-06,11,6,5
22418,pilgrimage,1.48790438516857e-05,7.074097897233022e-06,11,7,4
22419,piling,8.592123914353715e-06,3.6233184351681345e-06,6,4,2
22420,pill,4.4218003559234974e-05,3.2954943862719716e-05,41,22,19
22421,pillaging,4.400843956132392e-06,1.8979287041356905e-06,3,2,1
22422,pillar,1.48790438516857e-05,1.2250267090330355e-05,15,8,7
22423,pilot,7.565260324589493e-05,0.00010024514337298497,100,40,60
22424,pin,8.592123914353715e-06,7.074097897233022e-06,8,4,4
22425,pink,4.400843956132392e-06,1.9151826014460126e-05,13,2,11
22426,pinned,4.400843956132392e-06,8.79948762826546e-06,8,3,5
22427,pinpoint,4.400843956132392e-06,3.6233184351681345e-06,5,3,2
22428,pint,4.400843956132392e-06,3.6233184351681345e-06,5,3,2
22429,pioneer,1.278340387257504e-05,1.3975656821362803e-05,17,7,10
22430,pioneering,6.496483935243052e-06,5.348708166200577e-06,7,4,3
22431,pipe,2.954852370546031e-05,2.2602605476525032e-05,28,14,14
22432,pipeline,7.355696326678427e-05,8.299124606266055e-05,99,41,58
22433,piracy,4.6313643538345614e-05,3.8131113055817005e-05,48,23,25
22434,pirate,0.0001154697628489974,8.4716635793693e-05,122,59,63
22435,pirated,6.496483935243052e-06,1.8979287041356905e-06,5,4,1
22436,pissed,1.278340387257504e-05,5.348708166200577e-06,9,6,3
22437,pistol,8.592123914353715e-06,1.3975656821362803e-05,12,4,8
22438,pit,1.9070323809907035e-05,2.087721574549256e-05,24,12,12
22439,pitch,2.326160376812834e-05,2.4327995207557487e-05,26,11,15
22440,pitched,2.3052039770217305e-06,5.348708166200577e-06,6,3,3
22441,pitchfork,2.3052039770217305e-06,3.6233184351681345e-06,3,1,2
22442,pitching,1.278340387257504e-05,5.348708166200577e-06,9,6,3
22443,pitfall,6.496483935243052e-06,3.6233184351681345e-06,7,4,3
22444,pitted,2.095639979110664e-07,3.6233184351681345e-06,3,0,3
22445,pity,4.400843956132392e-06,3.6233184351681345e-06,6,4,2
22446,pivot,4.400843956132392e-06,1.3975656821362803e-05,11,2,9
22447,pivotal,1.0687763893464371e-05,1.2250267090330355e-05,15,6,9
22448,pivoting,2.3052039770217305e-06,3.6233184351681345e-06,3,1,2
22449,pizza,1.0687763893464371e-05,1.2250267090330355e-05,12,5,7
22450,place,0.00037532912025871974,0.0004315199717312144,472,200,272
22451,placed,4.840928351745632e-05,5.3659620635109e-05,63,27,36
22452,placement,2.095639979110664e-07,8.79948762826546e-06,6,0,6
22453,placing,1.0687763893464371e-05,1.3975656821362803e-05,14,6,8
22454,plagiarism,1.0687763893464371e-05,5.348708166200577e-06,8,5,3
22455,plague,2.7452883726349685e-05,2.777877466962238e-05,32,16,16
22456,plagued,1.278340387257504e-05,5.348708166200577e-06,10,6,4
22457,plaguing,8.592123914353715e-06,1.7253897310324457e-07,4,4,0
22458,plain,2.5357243747239038e-05,3.8131113055817005e-05,36,14,22
22459,plainclothe,4.400843956132392e-06,5.348708166200577e-06,5,2,3
22460,plainly,4.400843956132392e-06,3.6233184351681345e-06,4,2,2
22461,plaintiff,1.48790438516857e-05,1.9151826014460126e-05,22,10,12
22462,plan,0.0009830647142008114,0.0009543130602340453,1135,528,607
22463,plane,0.00024539944155385846,0.0002451778807797103,289,129,160
22464,planet,0.00015738256243121094,0.00010714670229711469,158,82,76
22465,planetary,2.3052039770217305e-06,5.348708166200577e-06,6,1,5
22466,planetwarming,4.400843956132392e-06,3.6233184351681345e-06,4,2,2
22467,plankton,4.400843956132392e-06,5.348708166200577e-06,5,2,3
22468,planned,0.00012804360272366158,0.0001347529379936339,148,63,85
22469,planning,0.0001825302421805385,0.00018824001965563945,220,95,125
22470,plant,0.0003438945205720597,0.0002727841164762295,360,180,180
22471,plantation,1.6974683830796368e-05,7.074097897233022e-06,16,10,6
22472,planted,2.5357243747239038e-05,1.570104655239525e-05,22,12,10
22473,planting,2.954852370546031e-05,1.9151826014460126e-05,25,14,11
22474,plaque,4.400843956132392e-06,1.8979287041356905e-06,4,3,1
22475,plasma,6.496483935243052e-06,5.348708166200577e-06,6,3,3
22476,plastic,6.936568330856297e-05,5.1934230904076595e-05,70,33,37
22477,plate,2.954852370546031e-05,1.2250267090330355e-05,24,14,10
22478,platform,5.888748341300963e-05,8.816741525575797e-05,90,34,56
22479,platitude,2.3052039770217305e-06,5.348708166200577e-06,4,1,3
22480,plausible,6.496483935243052e-06,5.348708166200577e-06,6,3,3
22481,play,0.00012804360272366158,0.00011749904068330962,152,75,77
22482,playbook,8.592123914353715e-06,3.6233184351681345e-06,6,4,2
22483,playboy,4.400843956132392e-06,1.8979287041356905e-06,3,2,1
22484,played,5.4696203454788295e-05,5.711040009717395e-05,65,28,37
22485,player,7.565260324589493e-05,7.954046660059569e-05,94,42,52
22486,playground,1.0687763893464371e-05,1.2250267090330355e-05,13,6,7
22487,playing,6.307876337123095e-05,7.608968713853079e-05,78,32,46
22488,plaza,2.3052039770217305e-06,3.6233184351681345e-06,3,1,2
22489,plea,4.4218003559234974e-05,5.883578982820635e-05,64,25,39
22490,plead,2.954852370546031e-05,3.2954943862719716e-05,34,14,20
22491,pleaded,1.6974683830796368e-05,1.570104655239525e-05,20,8,12
22492,pleading,1.0687763893464371e-05,5.348708166200577e-06,8,5,3
22493,pleasant,2.3052039770217305e-06,3.6233184351681345e-06,3,1,2
22494,please,4.002672360101368e-05,3.8131113055817005e-05,46,23,23
22495,pleased,2.326160376812834e-05,1.742643628342769e-05,23,12,11
22496,pleasure,4.400843956132392e-06,8.79948762826546e-06,9,2,7
22497,pledge,9.870464301611217e-05,0.0001036959228350498,116,52,64
22498,pledged,3.1644163684570994e-05,3.468033359375216e-05,39,17,22
22499,pledging,8.592123914353715e-06,3.6233184351681345e-06,7,4,3
22500,plenty,3.583544364279237e-05,4.330728224891437e-05,47,19,28
22501,plethora,2.3052039770217305e-06,1.8979287041356905e-06,3,1,2
22502,plight,8.592123914353715e-06,2.6053384938589907e-05,20,4,16
22503,plot,9.03220830996695e-05,9.506897417988779e-05,107,46,61
22504,plotted,1.278340387257504e-05,8.79948762826546e-06,11,6,5
22505,plotter,6.496483935243052e-06,5.348708166200577e-06,6,3,3
22506,plotting,4.4218003559234974e-05,2.2602605476525032e-05,39,22,17
22507,plow,4.400843956132392e-06,5.348708166200577e-06,5,2,3
22508,plowed,2.3052039770217305e-06,3.6233184351681345e-06,3,1,2
22509,ploy,2.3052039770217305e-06,5.348708166200577e-06,4,1,3
22510,plu,1.278340387257504e-05,1.570104655239525e-05,17,7,10
22511,plug,8.592123914353715e-06,1.2250267090330355e-05,13,5,8
22512,plugging,6.496483935243052e-06,1.8979287041356905e-06,4,3,1
22513,plume,1.0687763893464371e-05,5.348708166200577e-06,10,6,4
22514,plummet,6.496483935243052e-06,8.79948762826546e-06,9,3,6
22515,plummeted,1.278340387257504e-05,3.6233184351681345e-06,10,7,3
22516,plummeting,4.400843956132392e-06,7.074097897233022e-06,6,2,4
22517,plunder,6.496483935243052e-06,1.8979287041356905e-06,4,3,1
22518,plundered,1.0687763893464371e-05,3.6233184351681345e-06,8,5,3
22519,plunge,5.050492349656699e-05,1.3975656821362803e-05,34,25,9
22520,plunged,1.0687763893464371e-05,1.742643628342769e-05,20,7,13
22521,plunging,1.6974683830796368e-05,1.052487735929791e-05,17,10,7
22522,pluralistic,4.400843956132392e-06,3.6233184351681345e-06,4,2,2
22523,plurality,2.3052039770217305e-06,7.074097897233022e-06,5,1,4
22524,plush,2.3052039770217305e-06,5.348708166200577e-06,4,1,3
22525,plutocracy,4.400843956132392e-06,1.8979287041356905e-06,3,2,1
22526,plutocrat,2.095639979110664e-07,7.074097897233022e-06,4,0,4
22527,plutocratic,2.095639979110664e-07,3.6233184351681345e-06,3,0,3
22528,plutonium,4.400843956132392e-06,1.742643628342769e-05,13,3,10
22529,pm,2.5357243747239038e-05,3.2954943862719716e-05,32,13,19
22530,pneumonia,2.095639979110664e-07,5.348708166200577e-06,4,0,4
22531,poached,6.496483935243052e-06,8.79948762826546e-06,9,3,6
22532,poacher,6.517440335034157e-05,5.1934230904076595e-05,69,33,36
22533,poaching,2.5357243747239038e-05,2.777877466962238e-05,30,12,18
22534,pocket,2.7452883726349685e-05,1.742643628342769e-05,23,13,10
22535,pod,6.496483935243052e-06,3.6233184351681345e-06,5,3,2
22536,podcast,6.496483935243052e-06,5.348708166200577e-06,6,3,3
22537,podium,2.3052039770217305e-06,3.6233184351681345e-06,3,1,2
22538,poem,2.116596378901769e-05,1.052487735929791e-05,16,10,6
22539,poet,2.326160376812834e-05,1.052487735929791e-05,18,11,7
22540,poetry,6.496483935243052e-06,1.8979287041356905e-06,4,3,1
22541,point,0.0002663558413449654,0.000302115741903781,331,140,191
22542,pointblank,2.095639979110664e-07,1.8979287041356905e-06,3,0,3
22543,pointed,1.6974683830796368e-05,3.2954943862719716e-05,27,8,19
22544,pointer,4.400843956132392e-06,1.8979287041356905e-06,3,2,1
22545,pointing,2.116596378901769e-05,1.3975656821362803e-05,19,10,9
22546,pointles,1.278340387257504e-05,1.2250267090330355e-05,13,6,7
22547,poised,2.7452883726349685e-05,3.640572332478458e-05,41,15,26
22548,poison,2.7452883726349685e-05,1.9151826014460126e-05,26,13,13
22549,poisoned,3.3739803663681634e-05,3.122955413168725e-05,37,16,21
22550,poisoning,4.4218003559234974e-05,5.020884117304414e-05,58,23,35
22551,poisonou,4.400843956132392e-06,7.074097897233022e-06,6,2,4
22552,poked,6.496483935243052e-06,3.6233184351681345e-06,5,3,2
22553,poker,2.3052039770217305e-06,8.79948762826546e-06,6,1,5
22554,polar,1.278340387257504e-05,2.6053384938589907e-05,22,6,16
22555,polarization,4.400843956132392e-06,3.6233184351681345e-06,4,2,2
22556,polarized,8.592123914353715e-06,3.6233184351681345e-06,6,4,2
22557,polarizing,4.400843956132392e-06,8.79948762826546e-06,8,2,6
22558,pole,8.592123914353715e-06,5.348708166200577e-06,9,6,3
22559,police,0.001494400869103814,0.0013615050367577024,1673,787,886
22560,policeman,4.212236358012434e-05,6.573734875233614e-05,63,21,42
22561,policewoman,4.400843956132392e-06,1.7253897310324457e-07,3,2,1
22562,policing,1.9070323809907035e-05,2.6053384938589907e-05,26,9,17
22563,policy,0.0005639367183786793,0.0006195874524137507,712,301,411
22564,policymaker,1.278340387257504e-05,5.348708166200577e-06,10,6,4
22565,polio,4.212236358012434e-05,3.122955413168725e-05,40,22,18
22566,poliofree,2.3052039770217305e-06,3.6233184351681345e-06,3,1,2
22567,polite,4.400843956132392e-06,5.348708166200577e-06,5,2,3
22568,politic,0.00022025176180453062,0.00017961307100047735,224,115,109
22569,political,0.0007693094363315244,0.0007265616157377627,882,400,482
22570,politically,3.7931083621902995e-05,4.8483451442011706e-05,54,23,31
22571,politician,0.00023911252161652657,0.000286587234324489,310,128,182
22572,politicizing,4.400843956132392e-06,1.8979287041356905e-06,3,2,1
22573,politics,6.496483935243052e-06,3.6233184351681345e-06,5,3,2
22574,poll,0.00031874684082273133,0.0002313747629314509,319,161,158
22575,polled,8.592123914353715e-06,7.074097897233022e-06,8,4,4
22576,pollen,6.496483935243052e-06,1.7253897310324457e-07,3,3,0
22577,pollinator,2.095639979110664e-07,8.79948762826546e-06,5,0,5
22578,polling,6.936568330856297e-05,9.161819471782287e-05,92,34,58
22579,pollster,2.116596378901769e-05,1.9151826014460126e-05,23,10,13
22580,pollutant,2.3052039770217305e-06,1.3975656821362803e-05,9,1,8
22581,pollute,6.496483935243052e-06,1.8979287041356905e-06,8,4,4
22582,polluted,1.6974683830796368e-05,2.087721574549256e-05,22,9,13
22583,polluter,6.496483935243052e-06,1.3975656821362803e-05,13,5,8
22584,polluting,2.095639979110664e-07,1.9151826014460126e-05,14,3,11
22585,pollution,0.00010918284291166549,0.00010714670229711469,124,54,70
22586,polonium,6.496483935243052e-06,3.6233184351681345e-06,5,3,2
22587,polygamy,4.400843956132392e-06,3.6233184351681345e-06,4,2,2
22588,pond,1.0687763893464371e-05,3.6233184351681345e-06,7,5,2
22589,ponder,2.095639979110664e-07,5.348708166200577e-06,4,1,3
22590,pondering,4.400843956132392e-06,7.074097897233022e-06,6,2,4
22591,pontiff,1.6974683830796368e-05,1.8979287041356905e-06,10,8,2
22592,ponytail,2.095639979110664e-07,3.6233184351681345e-06,3,0,3
22593,poo,2.3052039770217305e-06,7.074097897233022e-06,5,1,4
22594,pooch,2.3052039770217305e-06,7.074097897233022e-06,5,1,4
22595,pool,4.002672360101368e-05,3.2954943862719716e-05,41,21,20
22596,pooling,4.400843956132392e-06,3.6233184351681345e-06,4,2,2
22597,poop,4.400843956132392e-06,3.6233184351681345e-06,4,2,2
22598,poor,0.00023282560167919462,0.0001951415785797695,263,131,132
22599,poorer,1.48790438516857e-05,1.2250267090330355e-05,14,7,7
22600,poorest,4.002672360101368e-05,4.330728224891437e-05,50,21,29
22601,poorly,1.9070323809907035e-05,1.570104655239525e-05,19,9,10
22602,pop,2.954852370546031e-05,2.2602605476525032e-05,27,14,13
22603,popcorn,4.400843956132392e-06,3.6233184351681345e-06,4,2,2
22604,pope,4.840928351745632e-05,3.2954943862719716e-05,42,23,19
22605,popped,8.592123914353715e-06,1.8979287041356905e-06,5,4,1
22606,popping,6.496483935243052e-06,5.348708166200577e-06,7,3,4
22607,poppy,1.48790438516857e-05,1.742643628342769e-05,17,7,10
22608,populace,4.400843956132392e-06,1.7253897310324457e-07,3,2,1
22609,popular,0.00012804360272366158,0.00014510527637982858,161,68,93
22610,popularity,2.116596378901769e-05,2.777877466962238e-05,33,13,20
22611,populated,1.0687763893464371e-05,5.348708166200577e-06,9,5,4
22612,population,0.00024749508153296894,0.0003003903521727485,324,126,198
22613,populism,4.400843956132392e-06,1.2250267090330355e-05,10,2,8
22614,populist,1.6974683830796368e-05,2.087721574549256e-05,23,9,14
22615,populou,8.592123914353715e-06,3.6233184351681345e-06,8,5,3
22616,pork,8.592123914353715e-06,1.742643628342769e-05,16,5,11
22617,porn,9.870464301611217e-05,8.644202552472544e-05,112,56,56
22618,pornographic,8.592123914353715e-06,7.074097897233022e-06,9,5,4
22619,pornography,4.840928351745632e-05,4.50326719799468e-05,55,24,31
22620,porpoise,6.496483935243052e-06,1.7253897310324457e-07,3,3,0
22621,port,2.326160376812834e-05,6.401195902130366e-05,53,13,40
22622,portal,2.3052039770217305e-06,5.348708166200577e-06,5,2,3
22623,portend,2.3052039770217305e-06,1.8979287041356905e-06,3,1,2
22624,portfolio,6.496483935243052e-06,1.2250267090330355e-05,11,4,7
22625,portion,2.326160376812834e-05,2.087721574549256e-05,25,13,12
22626,portrait,1.278340387257504e-05,1.2250267090330355e-05,13,6,7
22627,portray,1.0687763893464371e-05,5.348708166200577e-06,9,5,4
22628,portrayed,2.095639979110664e-07,1.052487735929791e-05,6,0,6
22629,portraying,2.095639979110664e-07,5.348708166200577e-06,3,0,3
22630,pose,7.355696326678427e-05,6.228656929027126e-05,76,37,39
22631,posed,2.116596378901769e-05,2.087721574549256e-05,24,11,13
22632,posh,4.400843956132392e-06,3.6233184351681345e-06,4,2,2
22633,posing,2.116596378901769e-05,2.2602605476525032e-05,26,13,13
22634,position,0.00014271308257743603,0.00015373222503499084,181,76,105
22635,positioned,6.496483935243052e-06,5.348708166200577e-06,6,3,3
22636,positive,7.774824322500554e-05,8.644202552472544e-05,100,38,62
22637,positively,4.400843956132392e-06,7.074097897233022e-06,8,3,5
22638,positivity,2.3052039770217305e-06,3.6233184351681345e-06,3,1,2
22639,posse,1.48790438516857e-05,1.052487735929791e-05,13,7,6
22640,possessed,2.095639979110664e-07,8.79948762826546e-06,5,0,5
22641,possessing,1.278340387257504e-05,5.348708166200577e-06,9,6,3
22642,possession,3.583544364279237e-05,5.883578982820635e-05,61,22,39
22643,possibility,5.888748341300963e-05,6.918812821440096e-05,76,34,42
22644,possible,0.0002684514813240757,0.00026415716782106726,315,146,169
22645,possibly,7.774824322500554e-05,6.573734875233614e-05,85,41,44
22646,post,0.00018462588215964923,0.0001520068353039585,192,93,99
22647,post2015,6.496483935243052e-06,1.7253897310324457e-07,3,3,0
22648,post911,6.496483935243052e-06,5.348708166200577e-06,7,3,4
22649,postal,2.3052039770217305e-06,7.074097897233022e-06,5,1,4
22650,postcard,2.3052039770217305e-06,5.348708166200577e-06,4,1,3
22651,posted,6.72700433294523e-05,4.8483451442011706e-05,66,36,30
22652,postelection,4.400843956132392e-06,1.3975656821362803e-05,11,2,9
22653,poster,2.5357243747239038e-05,2.9504164400654783e-05,35,14,21
22654,posting,3.3739803663681634e-05,2.777877466962238e-05,33,16,17
22655,postpone,4.400843956132392e-06,3.6233184351681345e-06,5,3,2
22656,postponed,1.48790438516857e-05,1.570104655239525e-05,18,7,11
22657,posttraumatic,2.3052039770217305e-06,5.348708166200577e-06,4,1,3
22658,posturing,2.095639979110664e-07,3.6233184351681345e-06,3,0,3
22659,postwar,6.496483935243052e-06,8.79948762826546e-06,8,3,5
22660,pot,4.4218003559234974e-05,3.8131113055817005e-05,53,25,28
22661,potato,1.0687763893464371e-05,1.052487735929791e-05,13,7,6
22662,potent,4.400843956132392e-06,7.074097897233022e-06,6,2,4
22663,potential,0.00020767792192986646,0.00016235917369015308,211,109,102
22664,potentially,7.146132328767358e-05,7.608968713853079e-05,87,37,50
22665,poultry,1.48790438516857e-05,1.052487735929791e-05,13,7,6
22666,pounce,2.3052039770217305e-06,5.348708166200577e-06,4,1,3
22667,pound,8.613080314144832e-05,6.401195902130366e-05,83,45,38
22668,pounded,4.400843956132392e-06,1.8979287041356905e-06,4,2,2
22669,pour,1.278340387257504e-05,1.9151826014460126e-05,18,6,12
22670,poured,1.0687763893464371e-05,1.2250267090330355e-05,15,7,8
22671,pouring,3.3739803663681634e-05,1.2250267090330355e-05,24,16,8
22672,poverty,0.00010708720293255492,0.00011749904068330962,136,61,75
22673,povertystricken,2.3052039770217305e-06,3.6233184351681345e-06,3,1,2
22674,powder,1.278340387257504e-05,1.3975656821362803e-05,14,6,8
22675,powdered,4.400843956132392e-06,1.8979287041356905e-06,3,2,1
22676,power,0.0007169184368537574,0.0007041315492343404,830,364,466
22677,powered,1.9070323809907035e-05,1.3975656821362803e-05,19,9,10
22678,powerful,0.0001741476822640959,0.00014683066611086105,191,96,95
22679,powerfully,2.095639979110664e-07,3.6233184351681345e-06,3,0,3
22680,powerhouse,8.592123914353715e-06,1.8979287041356905e-06,6,5,1
22681,powerles,8.592123914353715e-06,1.2250267090330355e-05,14,6,8
22682,powersharing,4.400843956132392e-06,1.8979287041356905e-06,3,2,1
22683,practical,1.0687763893464371e-05,1.9151826014460126e-05,17,5,12
22684,practically,6.496483935243052e-06,7.074097897233022e-06,7,3,4
22685,practice,0.00018043460220142793,0.00014510527637982858,195,99,96
22686,practiced,4.400843956132392e-06,3.6233184351681345e-06,5,2,3
22687,practicing,1.48790438516857e-05,1.2250267090330355e-05,14,7,7
22688,practise,2.3052039770217305e-06,3.6233184351681345e-06,3,1,2
22689,practitioner,2.3052039770217305e-06,5.348708166200577e-06,4,1,3
22690,pragmatic,2.3052039770217305e-06,5.348708166200577e-06,4,1,3
22691,praise,5.888748341300963e-05,4.330728224891437e-05,59,32,27
22692,praised,3.1644163684570994e-05,3.468033359375216e-05,41,18,23
22693,praising,6.496483935243052e-06,1.052487735929791e-05,11,3,8
22694,prank,4.400843956132392e-06,1.3975656821362803e-05,11,2,9
22695,prawn,2.3052039770217305e-06,1.8979287041356905e-06,3,1,2
22696,pray,2.116596378901769e-05,1.742643628342769e-05,20,10,10
22697,prayed,4.400843956132392e-06,5.348708166200577e-06,5,2,3
22698,prayer,4.6313643538345614e-05,5.3659620635109e-05,59,23,36
22699,praying,1.0687763893464371e-05,1.570104655239525e-05,16,6,10
22700,preach,1.0687763893464371e-05,3.6233184351681345e-06,9,5,4
22701,preached,2.3052039770217305e-06,1.8979287041356905e-06,3,1,2
22702,preacher,1.6974683830796368e-05,2.9504164400654783e-05,26,8,18
22703,preaching,2.095639979110664e-07,5.348708166200577e-06,5,2,3
22704,precariou,6.496483935243052e-06,1.8979287041356905e-06,4,3,1
22705,precaution,1.0687763893464371e-05,3.6233184351681345e-06,8,6,2
22706,precautionary,4.400843956132392e-06,1.8979287041356905e-06,3,2,1
22707,preceded,4.400843956132392e-06,5.348708166200577e-06,5,2,3
22708,precedent,2.326160376812834e-05,2.777877466962238e-05,29,11,18
22709,precinct,2.3052039770217305e-06,1.8979287041356905e-06,3,1,2
22710,preciou,1.48790438516857e-05,2.4327995207557487e-05,23,8,15
22711,precise,4.400843956132392e-06,3.6233184351681345e-06,4,2,2
22712,precisely,1.48790438516857e-05,1.052487735929791e-05,14,7,7
22713,precision,8.592123914353715e-06,8.79948762826546e-06,10,4,6
22714,precursor,2.3052039770217305e-06,3.6233184351681345e-06,3,1,2
22715,predate,4.400843956132392e-06,1.8979287041356905e-06,3,2,1
22716,predator,2.5357243747239038e-05,1.052487735929791e-05,18,12,6
22717,predatory,2.095639979110664e-07,8.79948762826546e-06,5,0,5
22718,predecessor,2.116596378901769e-05,1.742643628342769e-05,20,10,10
22719,predicament,8.592123914353715e-06,3.6233184351681345e-06,6,4,2
22720,predict,5.260056347567764e-05,3.985650278684949e-05,53,28,25
22721,predictable,8.592123914353715e-06,1.742643628342769e-05,14,4,10
22722,predicted,2.954852370546031e-05,2.4327995207557487e-05,30,16,14
22723,predicting,8.592123914353715e-06,5.348708166200577e-06,8,4,4
22724,prediction,1.9070323809907035e-05,1.742643628342769e-05,19,9,10
22725,predictive,2.3052039770217305e-06,3.6233184351681345e-06,3,1,2
22726,predominantly,8.592123914353715e-06,7.074097897233022e-06,8,4,4
22727,preelection,4.400843956132392e-06,3.6233184351681345e-06,4,2,2
22728,preeminent,6.496483935243052e-06,1.7253897310324457e-07,3,3,0
22729,preempt,2.095639979110664e-07,3.6233184351681345e-06,3,1,2
22730,preemptive,8.592123914353715e-06,2.087721574549256e-05,16,4,12
22731,preexisting,6.496483935243052e-06,1.2250267090330355e-05,11,3,8
22732,prefer,3.1644163684570994e-05,3.122955413168725e-05,37,18,19
22733,preferably,2.095639979110664e-07,5.348708166200577e-06,3,0,3
22734,preference,8.592123914353715e-06,1.052487735929791e-05,12,5,7
22735,preferential,4.400843956132392e-06,7.074097897233022e-06,7,2,5
22736,preferred,4.400843956132392e-06,5.348708166200577e-06,6,2,4
22737,pregnancy,2.954852370546031e-05,3.985650278684949e-05,42,15,27
22738,pregnant,6.517440335034157e-05,6.056117955923882e-05,76,35,41
22739,prehistoric,1.0687763893464371e-05,8.79948762826546e-06,10,5,5
22740,prejudice,1.0687763893464371e-05,1.9151826014460126e-05,16,5,11
22741,prejudiced,6.496483935243052e-06,1.8979287041356905e-06,4,3,1
22742,preliminary,1.6974683830796368e-05,1.570104655239525e-05,17,8,9
22743,premature,6.496483935243052e-06,1.052487735929791e-05,10,4,6
22744,prematurely,8.592123914353715e-06,3.6233184351681345e-06,7,4,3
22745,premeditated,4.400843956132392e-06,1.8979287041356905e-06,3,2,1
22746,premier,6.496483935243052e-06,2.4327995207557487e-05,22,4,18
22747,premiere,2.3052039770217305e-06,1.8979287041356905e-06,3,1,2
22748,premise,8.592123914353715e-06,1.2250267090330355e-05,15,5,10
22749,premium,1.6974683830796368e-05,2.777877466962238e-05,27,9,18
22750,prepaid,1.0687763893464371e-05,1.2250267090330355e-05,13,5,8
22751,preparation,2.116596378901769e-05,2.4327995207557487e-05,25,10,15
22752,prepare,9.03220830996695e-05,9.851975364195259e-05,116,50,66
22753,prepared,6.517440335034157e-05,8.644202552472544e-05,94,34,60
22754,preparednes,4.400843956132392e-06,3.6233184351681345e-06,4,2,2
22755,preparing,9.451336305789087e-05,8.816741525575797e-05,108,52,56
22756,pres,0.00020139100199253443,0.00020376852723493182,246,108,138
22757,preschool,8.592123914353715e-06,7.074097897233022e-06,12,6,6
22758,prescient,4.400843956132392e-06,1.8979287041356905e-06,3,2,1
22759,prescribe,2.095639979110664e-07,8.79948762826546e-06,6,1,5
22760,prescribed,2.3052039770217305e-06,3.6233184351681345e-06,3,1,2
22761,prescribing,4.400843956132392e-06,1.052487735929791e-05,9,2,7
22762,prescription,2.5357243747239038e-05,1.9151826014460126e-05,23,12,11
22763,presence,6.936568330856297e-05,4.50326719799468e-05,66,36,30
22764,present,8.403516316233764e-05,8.644202552472544e-05,107,45,62
22765,presentation,8.592123914353715e-06,1.2250267090330355e-05,12,5,7
22766,presentday,2.095639979110664e-07,3.6233184351681345e-06,3,0,3
22767,presented,2.954852370546031e-05,4.50326719799468e-05,45,15,30
22768,presenter,4.400843956132392e-06,5.348708166200577e-06,6,3,3
22769,presenting,1.0687763893464371e-05,1.8979287041356905e-06,6,5,1
22770,preservation,2.095639979110664e-07,5.348708166200577e-06,4,1,3
22771,preserve,4.002672360101368e-05,2.6053384938589907e-05,35,19,16
22772,preserved,1.48790438516857e-05,1.052487735929791e-05,14,8,6
22773,preserving,8.592123914353715e-06,7.074097897233022e-06,9,5,4
22774,presidency,0.0001154697628489974,0.0001295767688005365,148,60,88
22775,president,0.0016348087477042281,0.0018635934484881429,2062,865,1197
22776,presidentelect,8.822644312055891e-05,8.816741525575797e-05,107,47,60
22777,presidential,0.0005094500789218018,0.0004487738690415387,565,279,286
22778,presiding,4.400843956132392e-06,3.6233184351681345e-06,5,2,3
22779,pressed,1.0687763893464371e-05,8.79948762826546e-06,11,5,6
22780,pressing,2.5357243747239038e-05,2.087721574549256e-05,25,13,12
22781,pressure,0.00016366948236854273,0.0001554576147660233,191,83,108
22782,pressured,1.9070323809907035e-05,1.3975656821362803e-05,19,9,10
22783,pressuring,6.496483935243052e-06,1.3975656821362803e-05,13,3,10
22784,prestige,4.400843956132392e-06,7.074097897233022e-06,6,2,4
22785,prestigiou,1.0687763893464371e-05,5.348708166200577e-06,10,6,4
22786,presumably,8.592123914353715e-06,1.7253897310324457e-07,4,4,0
22787,presume,2.3052039770217305e-06,1.7253897310324457e-07,3,2,1
22788,presumed,2.3052039770217305e-06,7.074097897233022e-06,6,1,5
22789,presumptive,4.002672360101368e-05,2.6053384938589907e-05,39,19,20
22790,pretend,1.6974683830796368e-05,7.074097897233022e-06,14,9,5
22791,pretended,6.496483935243052e-06,5.348708166200577e-06,7,3,4
22792,pretending,1.278340387257504e-05,2.2602605476525032e-05,20,7,13
22793,pretense,2.3052039770217305e-06,3.6233184351681345e-06,4,1,3
22794,pretext,1.278340387257504e-05,5.348708166200577e-06,10,6,4
22795,pretrial,2.3052039770217305e-06,7.074097897233022e-06,6,1,5
22796,pretty,0.00012175668278632962,0.00012440059960743937,142,66,76
22797,prevail,6.496483935243052e-06,8.79948762826546e-06,10,4,6
22798,prevailing,2.3052039770217305e-06,3.6233184351681345e-06,4,1,3
22799,prevalence,2.3052039770217305e-06,5.348708166200577e-06,4,1,3
22800,prevalent,6.496483935243052e-06,7.074097897233022e-06,7,3,4
22801,prevent,0.00019510408205520246,0.00020031774777286686,225,98,127
22802,preventable,8.592123914353715e-06,1.2250267090330355e-05,13,5,8
22803,prevented,4.6313643538345614e-05,3.2954943862719716e-05,46,25,21
22804,preventing,4.002672360101368e-05,5.3659620635109e-05,56,21,35
22805,prevention,1.278340387257504e-05,2.087721574549256e-05,22,9,13
22806,preventive,6.496483935243052e-06,5.348708166200577e-06,6,3,3
22807,preview,4.400843956132392e-06,5.348708166200577e-06,6,2,4
22808,previou,8.403516316233764e-05,7.436429740749831e-05,98,45,53
22809,previously,0.0001385218026192147,0.00013130215853156914,158,72,86
22810,prey,8.592123914353715e-06,7.074097897233022e-06,9,4,5
22811,price,0.00036694656034227697,0.00039528678737953317,439,187,252
22812,pricefixing,4.400843956132392e-06,1.8979287041356905e-06,3,2,1
22813,pricegouging,4.400843956132392e-06,1.8979287041356905e-06,3,2,1
22814,priceles,8.592123914353715e-06,1.052487735929791e-05,11,4,7
22815,pricing,1.278340387257504e-05,1.7253897310324457e-07,8,7,1
22816,pride,4.002672360101368e-05,3.2954943862719716e-05,44,22,22
22817,priest,0.00011966104280721883,8.299124606266055e-05,121,64,57
22818,primarily,1.0687763893464371e-05,5.348708166200577e-06,9,5,4
22819,primary,0.00018462588215964923,0.00020031774777286686,233,100,133
22820,primate,4.400843956132392e-06,1.3975656821362803e-05,10,2,8
22821,prime,0.00015738256243121094,0.00014337988664879628,176,84,92
22822,primer,4.400843956132392e-06,1.8979287041356905e-06,3,2,1
22823,primetime,2.3052039770217305e-06,1.8979287041356905e-06,3,1,2
22824,prince,3.3739803663681634e-05,2.6053384938589907e-05,36,17,19
22825,princes,1.9070323809907035e-05,5.348708166200577e-06,13,9,4
22826,principal,1.278340387257504e-05,1.3975656821362803e-05,16,8,8
22827,principle,5.4696203454788295e-05,6.918812821440096e-05,71,28,43
22828,principled,4.400843956132392e-06,5.348708166200577e-06,5,2,3
22829,print,3.1644163684570994e-05,2.087721574549256e-05,30,15,15
22830,printed,1.0687763893464371e-05,1.2250267090330355e-05,14,5,9
22831,printer,4.400843956132392e-06,1.2250267090330355e-05,12,4,8
22832,printing,2.116596378901769e-05,8.79948762826546e-06,16,10,6
22833,prior,2.7452883726349685e-05,3.468033359375216e-05,36,13,23
22834,prioritize,6.496483935243052e-06,1.052487735929791e-05,11,5,6
22835,prioritized,6.496483935243052e-06,1.8979287041356905e-06,4,3,1
22836,prioritizing,2.095639979110664e-07,1.052487735929791e-05,6,0,6
22837,priority,5.888748341300963e-05,5.883578982820635e-05,73,31,42
22838,prison,0.00047172855929781003,0.00042634380253811694,526,245,281
22839,prisoner,0.0001531912824729893,0.00014337988664879628,174,80,94
22840,pristine,6.496483935243052e-06,1.2250267090330355e-05,10,3,7
22841,privacy,0.0001259479627445509,0.00011232287149021227,134,63,71
22842,private,0.00022863432172097337,0.0002313747629314509,272,121,151
22843,privately,6.496483935243052e-06,1.570104655239525e-05,14,4,10
22844,privatisation,4.400843956132392e-06,3.6233184351681345e-06,5,3,2
22845,privatise,4.400843956132392e-06,1.8979287041356905e-06,3,2,1
22846,privatization,1.278340387257504e-05,7.074097897233022e-06,11,6,5
22847,privatize,2.095639979110664e-07,5.348708166200577e-06,3,0,3
22848,privatized,6.496483935243052e-06,5.348708166200577e-06,6,3,3
22849,privilege,2.5357243747239038e-05,5.1934230904076595e-05,47,14,33
22850,privileged,8.592123914353715e-06,7.074097897233022e-06,10,5,5
22851,prize,5.4696203454788295e-05,6.401195902130366e-05,71,29,42
22852,prized,4.400843956132392e-06,7.074097897233022e-06,6,2,4
22853,pro,1.278340387257504e-05,2.2602605476525032e-05,21,7,14
22854,proGaddafi,2.3052039770217305e-06,3.6233184351681345e-06,3,1,2
22855,proIsrael,2.3052039770217305e-06,7.074097897233022e-06,5,1,4
22856,proKremlin,6.496483935243052e-06,1.8979287041356905e-06,5,3,2
22857,proKurdish,4.400843956132392e-06,3.6233184351681345e-06,4,2,2
22858,proMorsi,4.400843956132392e-06,1.8979287041356905e-06,4,3,1
22859,proNazi,4.400843956132392e-06,1.8979287041356905e-06,4,2,2
22860,proPalestinian,6.496483935243052e-06,3.6233184351681345e-06,5,3,2
22861,proRussia,4.400843956132392e-06,3.6233184351681345e-06,6,2,4
22862,proRussian,1.278340387257504e-05,3.2954943862719716e-05,29,7,22
22863,proTrump,8.592123914353715e-06,8.79948762826546e-06,10,4,6
22864,proabortion,2.3052039770217305e-06,3.6233184351681345e-06,3,1,2
22865,proactive,4.400843956132392e-06,5.348708166200577e-06,5,2,3
22866,proactively,4.400843956132392e-06,5.348708166200577e-06,6,3,3
22867,probability,4.400843956132392e-06,5.348708166200577e-06,6,2,4
22868,probable,1.278340387257504e-05,1.8979287041356905e-06,8,6,2
22869,probably,0.00016366948236854273,0.00018824001965563945,205,83,122
22870,probation,2.3052039770217305e-06,7.074097897233022e-06,6,2,4
22871,probe,0.0001762433222432067,0.00020549391696596386,224,95,129
22872,probed,6.496483935243052e-06,1.7253897310324457e-07,3,3,0
22873,probing,8.592123914353715e-06,7.074097897233022e-06,8,4,4
22874,problem,0.0004423895995902609,0.0003901106181864356,491,234,257
22875,problematic,1.0687763893464371e-05,5.348708166200577e-06,10,7,3
22876,procedural,1.6974683830796368e-05,7.074097897233022e-06,14,8,6
22877,procedure,2.5357243747239038e-05,3.122955413168725e-05,36,14,22
22878,proceed,2.116596378901769e-05,2.2602605476525032e-05,25,11,14
22879,proceeding,1.9070323809907035e-05,2.2602605476525032e-05,24,10,14
22880,proces,0.00023911252161652657,0.00022274781427628854,266,123,143
22881,processed,8.592123914353715e-06,1.8979287041356905e-06,6,4,2
22882,processing,6.496483935243052e-06,1.3975656821362803e-05,11,3,8
22883,processor,4.400843956132392e-06,5.348708166200577e-06,5,2,3
22884,proclaim,1.0687763893464371e-05,3.6233184351681345e-06,8,5,3
22885,proclaimed,2.3052039770217305e-06,7.074097897233022e-06,8,4,4
22886,procrastination,2.3052039770217305e-06,3.6233184351681345e-06,3,1,2
22887,procurement,2.3052039770217305e-06,3.6233184351681345e-06,3,1,2
22888,prod,2.3052039770217305e-06,1.8979287041356905e-06,3,2,1
22889,prodemocracy,3.1644163684570994e-05,2.9504164400654783e-05,35,16,19
22890,prodigy,2.095639979110664e-07,3.6233184351681345e-06,3,0,3
22891,produce,8.822644312055891e-05,8.126585633162811e-05,100,45,55
22892,produced,4.6313643538345614e-05,3.640572332478458e-05,48,24,24
22893,producer,4.840928351745632e-05,4.50326719799468e-05,54,24,30
22894,producing,1.9070323809907035e-05,2.087721574549256e-05,26,10,16
22895,product,0.00015738256243121094,0.0001589083942280881,189,83,106
22896,production,6.72700433294523e-05,9.334358444885519e-05,97,39,58
22897,productive,1.48790438516857e-05,2.087721574549256e-05,24,9,15
22898,productivity,1.9070323809907035e-05,2.9504164400654783e-05,28,9,19
22899,prof,3.583544364279237e-05,2.9504164400654783e-05,37,17,20
22900,professed,6.496483935243052e-06,1.8979287041356905e-06,4,3,1
22901,profession,4.400843956132392e-06,1.570104655239525e-05,13,3,10
22902,professional,7.146132328767358e-05,8.4716635793693e-05,92,40,52
22903,professionally,4.400843956132392e-06,3.6233184351681345e-06,4,2,2
22904,professor,5.888748341300963e-05,5.1934230904076595e-05,64,32,32
22905,proficiency,6.496483935243052e-06,1.7253897310324457e-07,3,3,0
22906,profile,3.583544364279237e-05,2.9504164400654783e-05,36,18,18
22907,profiling,6.496483935243052e-06,1.052487735929791e-05,9,3,6
22908,profit,0.00010289592297433347,9.851975364195259e-05,122,57,65
22909,profitability,2.3052039770217305e-06,3.6233184351681345e-06,3,1,2
22910,profitable,8.592123914353715e-06,2.4327995207557487e-05,18,4,14
22911,profited,2.3052039770217305e-06,7.074097897233022e-06,6,1,5
22912,profiteering,6.496483935243052e-06,1.7253897310324457e-07,4,3,1
22913,profiting,2.3052039770217305e-06,1.2250267090330355e-05,9,1,8
22914,profound,2.954852370546031e-05,2.2602605476525032e-05,31,15,16
22915,profoundly,1.0687763893464371e-05,1.742643628342769e-05,16,5,11
22916,progovernment,6.496483935243052e-06,3.6233184351681345e-06,5,3,2
22917,program,0.0003522770804885024,0.00035042665437268953,412,182,230
22918,programme,6.936568330856297e-05,4.330728224891437e-05,64,39,25
22919,programming,2.3052039770217305e-06,3.6233184351681345e-06,5,2,3
22920,progres,7.774824322500554e-05,7.608968713853079e-05,91,43,48
22921,progressive,0.00010080028299522283,0.00011749904068330962,130,55,75
22922,progun,6.496483935243052e-06,3.6233184351681345e-06,5,3,2
22923,prohibit,2.5357243747239038e-05,2.2602605476525032e-05,27,14,13
22924,prohibited,8.592123914353715e-06,7.074097897233022e-06,9,5,4
22925,prohibiting,1.278340387257504e-05,3.6233184351681345e-06,10,6,4
22926,prohibition,1.9070323809907035e-05,1.9151826014460126e-05,22,9,13
22927,prohibitionist,4.400843956132392e-06,1.8979287041356905e-06,3,2,1
22928,project,0.00019300844207609195,0.0001589083942280881,210,104,106
22929,projected,2.116596378901769e-05,1.742643628342769e-05,20,10,10
22930,projectile,4.400843956132392e-06,5.348708166200577e-06,7,3,4
22931,projecting,6.496483935243052e-06,1.8979287041356905e-06,4,3,1
22932,projection,2.116596378901769e-05,1.052487735929791e-05,16,10,6
22933,prolife,4.400843956132392e-06,3.6233184351681345e-06,4,2,2
22934,proliferation,6.496483935243052e-06,3.6233184351681345e-06,5,3,2
22935,prolonged,6.496483935243052e-06,1.570104655239525e-05,15,5,10
22936,prominent,6.517440335034157e-05,3.2954943862719716e-05,63,37,26
22937,promise,0.00014900000251476814,0.00017961307100047735,190,75,115
22938,promised,6.936568330856297e-05,9.506897417988779e-05,91,34,57
22939,promising,2.116596378901769e-05,2.9504164400654783e-05,28,10,18
22940,promo,2.095639979110664e-07,5.348708166200577e-06,3,0,3
22941,promote,6.517440335034157e-05,6.918812821440096e-05,76,32,44
22942,promoted,1.9070323809907035e-05,2.2602605476525032e-05,25,11,14
22943,promoting,3.3739803663681634e-05,4.6758061710979285e-05,48,18,30
22944,promotion,1.48790438516857e-05,1.052487735929791e-05,13,7,6
22945,prompt,1.9070323809907035e-05,3.2954943862719716e-05,29,9,20
22946,prompted,1.6974683830796368e-05,2.2602605476525032e-05,26,9,17
22947,prompting,2.5357243747239038e-05,3.2954943862719716e-05,36,14,22
22948,promptly,2.095639979110664e-07,8.79948762826546e-06,5,0,5
22949,prone,2.3052039770217305e-06,5.348708166200577e-06,5,1,4
22950,pronoun,2.095639979110664e-07,5.348708166200577e-06,3,0,3
22951,pronounce,2.095639979110664e-07,3.6233184351681345e-06,3,0,3
22952,pronounced,2.3052039770217305e-06,8.79948762826546e-06,7,1,6
22953,proof,4.212236358012434e-05,6.573734875233614e-05,62,21,41
22954,prop,1.48790438516857e-05,5.348708166200577e-06,10,7,3
22955,propaganda,7.774824322500554e-05,9.851975364195259e-05,111,45,66
22956,propagandist,4.400843956132392e-06,3.6233184351681345e-06,4,2,2
22957,propel,2.095639979110664e-07,7.074097897233022e-06,5,1,4
22958,propelled,2.3052039770217305e-06,5.348708166200577e-06,4,1,3
22959,proper,2.5357243747239038e-05,2.777877466962238e-05,30,12,18
22960,properly,3.1644163684570994e-05,2.6053384938589907e-05,31,15,16
22961,property,9.870464301611217e-05,0.00010024514337298497,117,55,62
22962,prophet,1.6974683830796368e-05,8.79948762826546e-06,14,8,6
22963,proponent,1.278340387257504e-05,7.074097897233022e-06,12,7,5
22964,proportion,2.954852370546031e-05,1.2250267090330355e-05,24,16,8
22965,proposal,0.00016786076232676425,0.00018306385046254245,206,88,118
22966,propose,7.774824322500554e-05,5.883578982820635e-05,82,41,41
22967,proposed,0.00015947820241032126,0.00014165449691776373,175,82,93
22968,proposing,2.116596378901769e-05,1.3975656821362803e-05,20,10,10
22969,proposition,6.496483935243052e-06,1.8979287041356905e-06,4,3,1
22970,propping,2.3052039770217305e-06,3.6233184351681345e-06,3,1,2
22971,prosecute,3.3739803663681634e-05,3.122955413168725e-05,36,16,20
22972,prosecuted,1.6974683830796368e-05,2.087721574549256e-05,21,8,13
22973,prosecuting,4.400843956132392e-06,1.052487735929791e-05,8,2,6
22974,prosecution,6.936568330856297e-05,4.6758061710979285e-05,67,37,30
22975,prosecutor,0.0001552869224521,0.0001382037174556987,174,84,90
22976,prospect,4.4218003559234974e-05,5.5385010366141504e-05,55,22,33
22977,prospective,1.278340387257504e-05,5.348708166200577e-06,13,8,5
22978,prosperity,1.0687763893464371e-05,1.570104655239525e-05,16,5,11
22979,prosperou,2.3052039770217305e-06,8.79948762826546e-06,6,1,5
22980,prostate,4.400843956132392e-06,1.7253897310324457e-07,4,2,2
22981,prosthetic,4.400843956132392e-06,1.8979287041356905e-06,3,2,1
22982,prostitute,5.6791843433898893e-05,3.2954943862719716e-05,51,30,21
22983,prostitution,3.3739803663681634e-05,2.9504164400654783e-05,43,20,23
22984,protect,0.0003271294007391747,0.00029176340351758643,355,169,186
22985,protected,4.6313643538345614e-05,8.816741525575797e-05,82,27,55
22986,protecting,5.4696203454788295e-05,6.918812821440096e-05,72,29,43
22987,protection,0.0001741476822640959,0.00015028144557292604,183,88,95
22988,protective,8.592123914353715e-06,1.570104655239525e-05,13,4,9
22989,protector,8.592123914353715e-06,1.7253897310324457e-07,4,4,0
22990,protectorate,4.400843956132392e-06,1.8979287041356905e-06,3,2,1
22991,protein,4.400843956132392e-06,1.2250267090330355e-05,10,2,8
22992,protest,0.0009139085948901598,0.000830084999599709,1047,491,556
22993,protested,2.7452883726349685e-05,1.3975656821362803e-05,22,13,9
22994,protester,0.0004759198392560313,0.0004574008176967009,547,240,307
22995,protesting,6.307876337123095e-05,7.608968713853079e-05,83,32,51
22996,protestor,4.4218003559234974e-05,3.8131113055817005e-05,52,26,26
22997,protocol,1.278340387257504e-05,1.3975656821362803e-05,17,7,10
22998,prototype,2.3052039770217305e-06,8.79948762826546e-06,6,1,5
22999,protracted,2.3052039770217305e-06,1.8979287041356905e-06,3,1,2
23000,proud,4.002672360101368e-05,5.711040009717395e-05,60,23,37
23001,proudly,1.48790438516857e-05,1.052487735929791e-05,13,7,6
23002,prove,5.4696203454788295e-05,7.781507686956326e-05,82,27,55
23003,proved,1.278340387257504e-05,2.2602605476525032e-05,21,7,14
23004,proven,2.7452883726349685e-05,3.2954943862719716e-05,39,16,23
23005,provide,0.0002055822819507562,0.0002106700861590614,250,110,140
23006,provided,5.260056347567764e-05,5.711040009717395e-05,65,27,38
23007,provider,7.984388320411623e-05,5.3659620635109e-05,81,42,39
23008,providing,5.260056347567764e-05,6.401195902130366e-05,73,31,42
23009,province,5.260056347567764e-05,7.091351794543343e-05,73,29,44
23010,provincial,1.48790438516857e-05,1.052487735929791e-05,14,7,7
23011,proving,2.116596378901769e-05,1.742643628342769e-05,22,10,12
23012,provision,4.4218003559234974e-05,5.020884117304414e-05,59,25,34
23013,provisional,2.3052039770217305e-06,3.6233184351681345e-06,3,1,2
23014,provocation,1.9070323809907035e-05,1.2250267090330355e-05,16,9,7
23015,provocative,1.6974683830796368e-05,1.3975656821362803e-05,17,8,9
23016,provoke,1.48790438516857e-05,1.052487735929791e-05,13,7,6
23017,provoked,6.496483935243052e-06,1.570104655239525e-05,12,3,9
23018,provoking,1.278340387257504e-05,7.074097897233022e-06,11,7,4
23019,prowes,4.400843956132392e-06,1.8979287041356905e-06,3,2,1
23020,prowl,2.3052039770217305e-06,3.6233184351681345e-06,3,1,2
23021,proximity,6.496483935243052e-06,1.7253897310324457e-07,4,3,1
23022,proxy,1.48790438516857e-05,1.570104655239525e-05,17,8,9
23023,pseudoscience,4.400843956132392e-06,1.8979287041356905e-06,3,2,1
23024,psyche,2.3052039770217305e-06,1.8979287041356905e-06,3,2,1
23025,psychedelic,8.592123914353715e-06,1.8979287041356905e-06,5,4,1
23026,psychiatric,8.592123914353715e-06,1.2250267090330355e-05,12,5,7
23027,psychiatrist,8.592123914353715e-06,1.8979287041356905e-06,7,5,2
23028,psychiatry,2.3052039770217305e-06,5.348708166200577e-06,4,1,3
23029,psychic,2.3052039770217305e-06,1.8979287041356905e-06,3,1,2
23030,psychological,1.48790438516857e-05,1.742643628342769e-05,19,8,11
23031,psychologically,2.3052039770217305e-06,3.6233184351681345e-06,3,1,2
23032,psychologist,1.278340387257504e-05,8.79948762826546e-06,14,7,7
23033,psychology,8.592123914353715e-06,3.6233184351681345e-06,8,4,4
23034,pub,8.592123914353715e-06,5.348708166200577e-06,7,4,3
23035,puberty,2.095639979110664e-07,3.6233184351681345e-06,3,0,3
23036,public,0.0008175091558510694,0.0007748725282066706,946,437,509
23037,publication,4.212236358012434e-05,3.640572332478458e-05,43,20,23
23038,publicity,1.278340387257504e-05,7.074097897233022e-06,11,7,4
23039,publicize,2.095639979110664e-07,1.8979287041356905e-06,3,1,2
23040,publicized,2.3052039770217305e-06,3.6233184351681345e-06,3,1,2
23041,publicly,8.613080314144832e-05,6.401195902130366e-05,87,45,42
23042,publish,5.260056347567764e-05,7.436429740749831e-05,76,26,50
23043,published,0.00014900000251476814,0.00014165449691776373,168,76,92
23044,publisher,2.116596378901769e-05,2.9504164400654783e-05,29,11,18
23045,publishing,4.002672360101368e-05,2.777877466962238e-05,37,19,18
23046,puddle,4.400843956132392e-06,1.8979287041356905e-06,3,2,1
23047,puff,2.3052039770217305e-06,3.6233184351681345e-06,3,1,2
23048,pull,8.822644312055891e-05,8.644202552472544e-05,98,45,53
23049,pulled,5.6791843433898893e-05,5.5385010366141504e-05,60,28,32
23050,pulling,1.278340387257504e-05,2.087721574549256e-05,19,7,12
23051,pullout,2.3052039770217305e-06,5.348708166200577e-06,5,1,4
23052,pulpit,2.3052039770217305e-06,1.8979287041356905e-06,3,1,2
23053,pulse,4.400843956132392e-06,1.8979287041356905e-06,3,2,1
23054,pump,1.9070323809907035e-05,2.6053384938589907e-05,25,10,15
23055,pumped,1.48790438516857e-05,3.6233184351681345e-06,11,7,4
23056,pumping,4.400843956132392e-06,7.074097897233022e-06,7,3,4
23057,pumpkin,2.095639979110664e-07,1.052487735929791e-05,7,0,7
23058,pun,2.095639979110664e-07,3.6233184351681345e-06,3,0,3
23059,punch,1.6974683830796368e-05,1.742643628342769e-05,20,8,12
23060,punched,1.278340387257504e-05,8.79948762826546e-06,12,6,6
23061,punching,6.496483935243052e-06,3.6233184351681345e-06,6,3,3
23062,pundit,2.326160376812834e-05,2.4327995207557487e-05,26,11,15
23063,punish,5.888748341300963e-05,4.50326719799468e-05,57,30,27
23064,punishable,1.278340387257504e-05,1.2250267090330355e-05,15,7,8
23065,punished,3.3739803663681634e-05,3.2954943862719716e-05,40,17,23
23066,punishing,1.278340387257504e-05,1.570104655239525e-05,16,6,10
23067,punishment,5.888748341300963e-05,8.126585633162811e-05,82,33,49
23068,punitive,8.592123914353715e-06,3.6233184351681345e-06,7,4,3
23069,punk,1.9070323809907035e-05,1.742643628342769e-05,19,9,10
23070,pup,1.48790438516857e-05,1.052487735929791e-05,15,8,7
23071,pupil,4.002672360101368e-05,2.6053384938589907e-05,36,19,17
23072,puppet,8.592123914353715e-06,7.074097897233022e-06,10,5,5
23073,puppy,8.592123914353715e-06,1.570104655239525e-05,14,5,9
23074,purchase,8.193952318322689e-05,5.3659620635109e-05,84,43,41
23075,purchased,1.278340387257504e-05,1.3975656821362803e-05,16,7,9
23076,purchasing,4.400843956132392e-06,1.742643628342769e-05,14,2,12
23077,pure,1.9070323809907035e-05,2.087721574549256e-05,22,9,13
23078,purely,6.496483935243052e-06,7.074097897233022e-06,8,4,4
23079,purge,1.0687763893464371e-05,1.052487735929791e-05,13,5,8
23080,purged,8.592123914353715e-06,5.348708166200577e-06,7,4,3
23081,purification,2.3052039770217305e-06,3.6233184351681345e-06,4,2,2
23082,purity,8.592123914353715e-06,1.2250267090330355e-05,11,4,7
23083,purported,2.3052039770217305e-06,7.074097897233022e-06,5,1,4
23084,purportedly,2.3052039770217305e-06,7.074097897233022e-06,6,1,5
23085,purporting,2.3052039770217305e-06,3.6233184351681345e-06,3,1,2
23086,purpose,6.936568330856297e-05,6.056117955923882e-05,81,39,42
23087,purposefully,2.095639979110664e-07,5.348708166200577e-06,4,0,4
23088,purse,4.400843956132392e-06,1.052487735929791e-05,12,6,6
23089,pursue,4.4218003559234974e-05,3.468033359375216e-05,44,24,20
23090,pursued,1.278340387257504e-05,5.348708166200577e-06,10,6,4
23091,pursuing,2.116596378901769e-05,2.087721574549256e-05,25,11,14
23092,pursuit,2.5357243747239038e-05,1.3975656821362803e-05,22,13,9
23093,purview,2.3052039770217305e-06,3.6233184351681345e-06,3,1,2
23094,push,0.00015947820241032126,0.00017098612234531542,205,90,115
23095,pushback,6.496483935243052e-06,1.7253897310324457e-07,4,3,1
23096,pushed,8.403516316233764e-05,5.5385010366141504e-05,83,43,40
23097,pushing,7.984388320411623e-05,8.644202552472544e-05,92,41,51
23098,put,0.0004486765195275927,0.0004228930230760523,514,236,278
23099,putrid,2.095639979110664e-07,5.348708166200577e-06,3,0,3
23100,putting,7.984388320411623e-05,9.161819471782287e-05,101,42,59
23101,puzzle,6.496483935243052e-06,3.6233184351681345e-06,7,5,2
23102,puzzled,4.400843956132392e-06,1.2250267090330355e-05,10,3,7
23103,puzzling,8.592123914353715e-06,1.8979287041356905e-06,5,4,1
23104,py,4.400843956132392e-06,1.8979287041356905e-06,3,2,1
23105,pygmy,2.3052039770217305e-06,3.6233184351681345e-06,3,1,2
23106,pyramid,1.9070323809907035e-05,1.9151826014460126e-05,23,11,12
23107,python,4.400843956132392e-06,3.6233184351681345e-06,4,2,2
23108,quadrillion,4.400843956132392e-06,1.8979287041356905e-06,3,2,1
23109,quadriplegic,2.095639979110664e-07,3.6233184351681345e-06,3,0,3
23110,quadruple,8.592123914353715e-06,7.074097897233022e-06,9,4,5
23111,quadrupled,4.400843956132392e-06,1.8979287041356905e-06,3,2,1
23112,quake,6.936568330856297e-05,7.091351794543343e-05,91,42,49
23113,quakehit,2.095639979110664e-07,3.6233184351681345e-06,3,0,3
23114,qualification,1.48790438516857e-05,5.348708166200577e-06,10,7,3
23115,qualified,4.6313643538345614e-05,1.570104655239525e-05,33,24,9
23116,qualify,2.116596378901769e-05,8.79948762826546e-06,17,10,7
23117,qualifying,2.3052039770217305e-06,3.6233184351681345e-06,4,1,3
23118,quality,7.146132328767358e-05,6.401195902130366e-05,80,38,42
23119,quandary,2.3052039770217305e-06,3.6233184351681345e-06,3,1,2
23120,quantity,1.48790438516857e-05,7.074097897233022e-06,12,8,4
23121,quantum,2.3052039770217305e-06,1.3975656821362803e-05,10,2,8
23122,quarantine,4.400843956132392e-06,3.6233184351681345e-06,4,2,2
23123,quarantined,6.496483935243052e-06,5.348708166200577e-06,7,3,4
23124,quarrel,4.400843956132392e-06,1.8979287041356905e-06,3,2,1
23125,quarter,5.050492349656699e-05,6.573734875233614e-05,72,31,41
23126,quarterback,4.400843956132392e-06,3.6233184351681345e-06,4,2,2
23127,quarterly,2.095639979110664e-07,3.6233184351681345e-06,3,1,2
23128,quash,4.400843956132392e-06,5.348708166200577e-06,5,2,3
23129,quashed,8.592123914353715e-06,1.7253897310324457e-07,5,4,1
23130,queen,1.48790438516857e-05,1.570104655239525e-05,18,8,10
23131,queer,2.095639979110664e-07,8.79948762826546e-06,6,0,6
23132,quell,1.0687763893464371e-05,5.348708166200577e-06,9,5,4
23133,quelled,4.400843956132392e-06,1.8979287041356905e-06,3,2,1
23134,query,4.400843956132392e-06,1.7253897310324457e-07,3,2,1
23135,quest,1.48790438516857e-05,3.122955413168725e-05,29,10,19
23136,question,0.00046753727933958864,0.0003987375668415979,506,244,262
23137,questionable,1.48790438516857e-05,1.742643628342769e-05,19,8,11
23138,questioned,3.583544364279237e-05,3.985650278684949e-05,46,20,26
23139,questioning,2.954852370546031e-05,2.777877466962238e-05,32,15,17
23140,queue,2.3052039770217305e-06,8.79948762826546e-06,6,1,5
23141,quick,2.7452883726349685e-05,4.8483451442011706e-05,44,14,30
23142,quicker,2.3052039770217305e-06,1.8979287041356905e-06,4,1,3
23143,quickly,8.403516316233764e-05,8.299124606266055e-05,97,43,54
23144,quid,2.3052039770217305e-06,3.6233184351681345e-06,3,1,2
23145,quiet,2.954852370546031e-05,3.2954943862719716e-05,38,16,22
23146,quietly,4.6313643538345614e-05,4.1581892517881935e-05,51,24,27
23147,quirk,2.3052039770217305e-06,1.8979287041356905e-06,4,2,2
23148,quirky,4.400843956132392e-06,1.8979287041356905e-06,3,2,1
23149,quit,0.00010499156295344414,9.679436391092026e-05,113,54,59
23150,quite,7.355696326678427e-05,8.989280498679035e-05,97,40,57
23151,quitting,6.496483935243052e-06,5.348708166200577e-06,7,4,3
23152,quiz,8.592123914353715e-06,1.8979287041356905e-06,6,5,1
23153,quizzed,2.3052039770217305e-06,3.6233184351681345e-06,4,1,3
23154,quo,1.6974683830796368e-05,1.742643628342769e-05,21,8,13
23155,quota,1.6974683830796368e-05,1.052487735929791e-05,16,8,8
23156,quote,2.7452883726349685e-05,2.777877466962238e-05,35,15,20
23157,quoted,1.6974683830796368e-05,3.122955413168725e-05,31,9,22
23158,quoting,6.496483935243052e-06,3.6233184351681345e-06,6,3,3
23159,rCanada,2.3052039770217305e-06,1.8979287041356905e-06,3,1,2
23160,rLegalNew,2.3052039770217305e-06,7.074097897233022e-06,5,1,4
23161,rNorthKoreaNew,6.496483935243052e-06,3.6233184351681345e-06,5,3,2
23162,rabbi,1.48790438516857e-05,1.9151826014460126e-05,22,8,14
23163,rabbit,4.400843956132392e-06,8.79948762826546e-06,7,2,5
23164,rabid,2.3052039770217305e-06,1.8979287041356905e-06,4,2,2
23165,rabies,2.3052039770217305e-06,7.074097897233022e-06,5,1,4
23166,race,0.00024749508153296894,0.0002313747629314509,286,130,156
23167,racebased,2.095639979110664e-07,5.348708166200577e-06,3,0,3
23168,raced,4.400843956132392e-06,1.7253897310324457e-07,3,2,1
23169,racetrack,2.3052039770217305e-06,5.348708166200577e-06,4,1,3
23170,racial,6.307876337123095e-05,6.573734875233614e-05,78,33,45
23171,racially,2.116596378901769e-05,1.9151826014460126e-05,22,11,11
23172,racing,2.095639979110664e-07,1.742643628342769e-05,13,1,12
23173,racism,9.03220830996695e-05,7.954046660059569e-05,99,45,54
23174,racist,0.00011756540282810809,0.00010714670229711469,124,59,65
23175,rack,4.400843956132392e-06,1.8979287041356905e-06,3,2,1
23176,racked,4.400843956132392e-06,3.6233184351681345e-06,4,2,2
23177,racket,8.592123914353715e-06,7.074097897233022e-06,11,6,5
23178,racketeering,4.400843956132392e-06,5.348708166200577e-06,5,2,3
23179,radar,1.6974683830796368e-05,2.087721574549256e-05,23,9,14
23180,radiation,8.193952318322689e-05,6.228656929027126e-05,88,46,42
23181,radical,7.355696326678427e-05,9.851975364195259e-05,103,40,63
23182,radicalisation,6.496483935243052e-06,1.7253897310324457e-07,4,4,0
23183,radicalism,4.400843956132392e-06,7.074097897233022e-06,6,2,4
23184,radicalization,2.3052039770217305e-06,5.348708166200577e-06,6,2,4
23185,radicalized,4.400843956132392e-06,1.8979287041356905e-06,4,2,2
23186,radically,2.3052039770217305e-06,7.074097897233022e-06,7,1,6
23187,radio,8.613080314144832e-05,7.608968713853079e-05,96,45,51
23188,radioactive,5.260056347567764e-05,4.330728224891437e-05,65,31,34
23189,radioactivity,6.496483935243052e-06,3.6233184351681345e-06,6,3,3
23190,raft,6.496483935243052e-06,1.8979287041356905e-06,6,3,3
23191,rage,4.4218003559234974e-05,3.985650278684949e-05,49,23,26
23192,raged,2.3052039770217305e-06,5.348708166200577e-06,4,1,3
23193,raging,4.400843956132392e-06,8.79948762826546e-06,8,2,6
23194,ragstorich,2.3052039770217305e-06,3.6233184351681345e-06,3,1,2
23195,raid,0.00020139100199253443,0.00018824001965563945,240,112,128
23196,raided,3.583544364279237e-05,2.6053384938589907e-05,36,19,17
23197,raider,2.3052039770217305e-06,3.6233184351681345e-06,5,2,3
23198,raiding,4.400843956132392e-06,3.6233184351681345e-06,4,2,2
23199,rail,2.5357243747239038e-05,3.2954943862719716e-05,37,14,23
23200,railed,6.496483935243052e-06,5.348708166200577e-06,7,3,4
23201,railroad,4.400843956132392e-06,3.6233184351681345e-06,4,2,2
23202,railway,2.116596378901769e-05,2.2602605476525032e-05,25,12,13
23203,rain,4.6313643538345614e-05,5.711040009717395e-05,60,25,35
23204,rainbow,2.095639979110664e-07,8.79948762826546e-06,6,1,5
23205,rained,4.400843956132392e-06,3.6233184351681345e-06,4,2,2
23206,rainfall,2.3052039770217305e-06,5.348708166200577e-06,6,2,4
23207,rainforest,3.583544364279237e-05,3.8131113055817005e-05,43,18,25
23208,raining,2.3052039770217305e-06,3.6233184351681345e-06,3,1,2
23209,rainwater,2.3052039770217305e-06,3.6233184351681345e-06,3,1,2
23210,rainy,2.3052039770217305e-06,5.348708166200577e-06,4,1,3
23211,raise,0.0002160604818463093,0.00026933333701416437,282,116,166
23212,raised,0.0001259479627445509,0.0001019705331040174,138,69,69
23213,raising,8.193952318322689e-05,7.263890767646595e-05,89,42,47
23214,rake,4.400843956132392e-06,5.348708166200577e-06,5,2,3
23215,rallied,1.6974683830796368e-05,1.2250267090330355e-05,16,9,7
23216,rally,0.00018881716211787043,0.00015373222503499084,199,95,104
23217,rallying,2.116596378901769e-05,8.79948762826546e-06,16,11,5
23218,ram,4.400843956132392e-06,1.8979287041356905e-06,3,2,1
23219,ramification,8.592123914353715e-06,7.074097897233022e-06,8,4,4
23220,rammed,2.3052039770217305e-06,8.79948762826546e-06,7,2,5
23221,ramp,1.48790438516857e-05,1.2250267090330355e-05,14,7,7
23222,rampage,1.48790438516857e-05,1.2250267090330355e-05,17,10,7
23223,rampant,2.7452883726349685e-05,1.570104655239525e-05,23,13,10
23224,ramping,4.400843956132392e-06,5.348708166200577e-06,6,2,4
23225,ran,5.4696203454788295e-05,5.883578982820635e-05,69,31,38
23226,rancher,2.3052039770217305e-06,3.6233184351681345e-06,3,1,2
23227,rancor,4.400843956132392e-06,1.8979287041356905e-06,3,2,1
23228,random,1.0687763893464371e-05,1.742643628342769e-05,15,5,10
23229,randomly,2.3052039770217305e-06,7.074097897233022e-06,7,1,6
23230,rang,2.3052039770217305e-06,1.052487735929791e-05,7,1,6
23231,range,6.936568330856297e-05,5.020884117304414e-05,68,36,32
23232,ranger,1.48790438516857e-05,5.348708166200577e-06,12,8,4
23233,ranging,1.0687763893464371e-05,1.570104655239525e-05,15,5,10
23234,rank,3.3739803663681634e-05,3.2954943862719716e-05,45,18,27
23235,rankandfile,2.3052039770217305e-06,1.8979287041356905e-06,3,1,2
23236,ranked,2.116596378901769e-05,1.052487735929791e-05,20,10,10
23237,ranking,1.278340387257504e-05,2.4327995207557487e-05,24,7,17
23238,ransom,2.5357243747239038e-05,1.742643628342769e-05,23,13,10
23239,ransomware,8.592123914353715e-06,5.348708166200577e-06,7,4,3
23240,rant,4.400843956132392e-06,1.052487735929791e-05,8,2,6
23241,ranted,4.400843956132392e-06,1.8979287041356905e-06,4,2,2
23242,ranting,4.400843956132392e-06,1.8979287041356905e-06,3,2,1
23243,rap,8.592123914353715e-06,1.052487735929791e-05,11,4,7
23244,rape,0.00025797328142852257,0.00026415716782106726,302,134,168
23245,raped,0.00015109564249387862,0.00012440059960743937,153,77,76
23246,rapid,1.9070323809907035e-05,2.4327995207557487e-05,27,11,16
23247,rapidly,3.3739803663681634e-05,3.122955413168725e-05,40,20,20
23248,raping,4.212236358012434e-05,2.9504164400654783e-05,38,20,18
23249,rapist,5.050492349656699e-05,5.5385010366141504e-05,61,25,36
23250,rapper,1.6974683830796368e-05,2.087721574549256e-05,21,8,13
23251,rapporteur,2.3052039770217305e-06,3.6233184351681345e-06,4,1,3
23252,rare,0.00012175668278632962,0.00011404826122124471,136,61,75
23253,rarely,2.7452883726349685e-05,2.2602605476525032e-05,30,14,16
23254,rarest,8.592123914353715e-06,1.052487735929791e-05,10,4,6
23255,rash,2.095639979110664e-07,5.348708166200577e-06,3,0,3
23256,rat,1.48790438516857e-05,2.9504164400654783e-05,26,7,19
23257,ratchet,4.400843956132392e-06,1.7253897310324457e-07,3,2,1
23258,rate,0.00028731224113607147,0.000333172757062365,370,154,216
23259,rated,4.400843956132392e-06,1.2250267090330355e-05,11,3,8
23260,rather,0.00012804360272366158,0.00016235917369015308,174,68,106
23261,ratification,4.400843956132392e-06,1.7253897310324457e-07,3,2,1
23262,ratified,2.3052039770217305e-06,7.074097897233022e-06,8,2,6
23263,ratify,1.0687763893464371e-05,7.074097897233022e-06,10,5,5
23264,rating,8.193952318322689e-05,9.334358444885519e-05,103,42,61
23265,ratio,6.496483935243052e-06,8.79948762826546e-06,10,4,6
23266,ration,1.0687763893464371e-05,1.2250267090330355e-05,12,5,7
23267,rational,6.496483935243052e-06,5.348708166200577e-06,8,3,5
23268,rationale,6.496483935243052e-06,8.79948762826546e-06,9,4,5
23269,rationing,4.400843956132392e-06,3.6233184351681345e-06,4,2,2
23270,raucou,2.095639979110664e-07,5.348708166200577e-06,4,1,3
23271,ravage,1.0687763893464371e-05,1.7253897310324457e-07,5,5,0
23272,ravaged,8.592123914353715e-06,8.79948762826546e-06,10,5,5
23273,ravaging,4.400843956132392e-06,1.8979287041356905e-06,3,2,1
23274,ravine,4.400843956132392e-06,5.348708166200577e-06,5,2,3
23275,raving,2.3052039770217305e-06,3.6233184351681345e-06,3,1,2
23276,raw,2.7452883726349685e-05,1.052487735929791e-05,19,13,6
23277,ray,6.496483935243052e-06,3.6233184351681345e-06,6,3,3
23278,raze,4.400843956132392e-06,1.8979287041356905e-06,3,2,1
23279,razed,1.0687763893464371e-05,8.79948762826546e-06,11,6,5
23280,razing,2.3052039770217305e-06,1.8979287041356905e-06,4,3,1
23281,razorthin,2.3052039770217305e-06,1.8979287041356905e-06,3,1,2
23282,rcanada,2.095639979110664e-07,3.6233184351681345e-06,3,0,3
23283,re,0.0002684514813240757,0.0002175716450831913,276,139,137
23284,reach,0.0001783389622223174,0.00016063378395912072,198,96,102
23285,reached,0.00010289592297433347,0.0001036959228350498,118,51,67
23286,reaching,2.326160376812834e-05,4.1581892517881935e-05,41,14,27
23287,react,2.326160376812834e-05,3.2954943862719716e-05,33,13,20
23288,reacted,6.496483935243052e-06,7.074097897233022e-06,10,4,6
23289,reacting,4.400843956132392e-06,7.074097897233022e-06,6,2,4
23290,reaction,3.583544364279237e-05,5.5385010366141504e-05,56,22,34
23291,reactionary,4.400843956132392e-06,3.6233184351681345e-06,4,2,2
23292,reactor,0.00013013924270277222,9.851975364195259e-05,128,65,63
23293,read,0.00021396484186719832,0.0002520794397038401,272,113,159
23294,reader,4.002672360101368e-05,3.468033359375216e-05,40,19,21
23295,readily,2.3052039770217305e-06,3.6233184351681345e-06,3,1,2
23296,readines,2.3052039770217305e-06,1.3975656821362803e-05,9,1,8
23297,reading,5.888748341300963e-05,5.5385010366141504e-05,66,29,37
23298,ready,0.00021396484186719832,0.0002400017115866128,269,112,157
23299,readying,2.095639979110664e-07,5.348708166200577e-06,4,1,3
23300,reaffirm,2.095639979110664e-07,8.79948762826546e-06,6,1,5
23301,reaffirmed,4.400843956132392e-06,5.348708166200577e-06,6,3,3
23302,real,0.00033132068069739577,0.0002831364548624239,364,174,190
23303,realising,6.496483935243052e-06,1.7253897310324457e-07,3,3,0
23304,realism,2.095639979110664e-07,5.348708166200577e-06,3,0,3
23305,realistic,6.496483935243052e-06,1.3975656821362803e-05,13,4,9
23306,reality,0.00011756540282810809,0.00016580995315221804,172,64,108
23307,realize,5.260056347567764e-05,7.954046660059569e-05,78,29,49
23308,realized,1.6974683830796368e-05,3.468033359375216e-05,32,9,23
23309,realizing,4.400843956132392e-06,1.3975656821362803e-05,14,6,8
23310,reallife,2.095639979110664e-07,7.074097897233022e-06,5,1,4
23311,really,0.0003899986001124942,0.0004228930230760523,482,205,277
23312,realm,6.496483935243052e-06,1.8979287041356905e-06,5,4,1
23313,realtime,4.400843956132392e-06,1.8979287041356905e-06,4,3,1
23314,realworld,6.496483935243052e-06,3.6233184351681345e-06,5,3,2
23315,reap,4.400843956132392e-06,7.074097897233022e-06,7,2,5
23316,rear,2.095639979110664e-07,1.8979287041356905e-06,3,1,2
23317,rearview,2.095639979110664e-07,5.348708166200577e-06,3,0,3
23318,reason,0.0002244430417627521,0.0002831364548624239,300,117,183
23319,reasonable,2.116596378901769e-05,2.2602605476525032e-05,28,12,16
23320,reasonably,4.400843956132392e-06,3.6233184351681345e-06,5,2,3
23321,reasoning,6.496483935243052e-06,1.8979287041356905e-06,4,3,1
23322,reassure,6.496483935243052e-06,7.074097897233022e-06,7,3,4
23323,reauthorized,6.496483935243052e-06,1.8979287041356905e-06,4,3,1
23324,rebate,2.3052039770217305e-06,5.348708166200577e-06,4,1,3
23325,rebel,0.00025797328142852257,0.00033662353652443006,353,135,218
23326,rebelheld,4.400843956132392e-06,1.052487735929791e-05,8,2,6
23327,rebellion,2.116596378901769e-05,1.052487735929791e-05,19,12,7
23328,rebirth,2.3052039770217305e-06,1.8979287041356905e-06,3,1,2
23329,reboot,4.400843956132392e-06,3.6233184351681345e-06,4,2,2
23330,rebound,1.0687763893464371e-05,1.8979287041356905e-06,6,5,1
23331,rebrand,6.496483935243052e-06,5.348708166200577e-06,6,3,3
23332,rebuff,2.3052039770217305e-06,1.8979287041356905e-06,3,1,2
23333,rebuild,2.954852370546031e-05,1.052487735929791e-05,22,14,8
23334,rebuilding,1.0687763893464371e-05,8.79948762826546e-06,10,5,5
23335,rebuilt,2.3052039770217305e-06,7.074097897233022e-06,5,1,4
23336,rebuke,2.116596378901769e-05,1.742643628342769e-05,26,11,15
23337,rebuked,1.0687763893464371e-05,1.052487735929791e-05,11,5,6
23338,recall,5.050492349656699e-05,5.020884117304414e-05,58,24,34
23339,recalled,2.5357243747239038e-05,3.6233184351681345e-06,16,13,3
23340,recapture,8.592123914353715e-06,8.79948762826546e-06,9,4,5
23341,recaptured,2.095639979110664e-07,5.348708166200577e-06,3,0,3
23342,receipt,8.592123914353715e-06,5.348708166200577e-06,9,4,5
23343,receive,0.00011756540282810809,0.0001295767688005365,148,64,84
23344,received,0.00014900000251476814,0.00014510527637982858,174,81,93
23345,receiving,4.6313643538345614e-05,5.1934230904076595e-05,61,25,36
23346,recent,0.0003271294007391747,0.0003607789927588843,414,171,243
23347,recently,0.00017205204228498542,0.00017788768126944505,208,89,119
23348,reception,4.400843956132392e-06,5.348708166200577e-06,7,3,4
23349,receptive,2.3052039770217305e-06,3.6233184351681345e-06,3,1,2
23350,reces,8.592123914353715e-06,5.348708166200577e-06,7,4,3
23351,recession,9.660900303700153e-05,6.573734875233614e-05,95,49,46
23352,recidivism,2.3052039770217305e-06,3.6233184351681345e-06,3,1,2
23353,recipe,2.326160376812834e-05,5.348708166200577e-06,15,11,4
23354,recipient,1.9070323809907035e-05,1.742643628342769e-05,20,10,10
23355,recite,6.496483935243052e-06,3.6233184351681345e-06,5,3,2
23356,reckles,2.326160376812834e-05,1.052487735929791e-05,21,13,8
23357,recklessly,2.3052039770217305e-06,5.348708166200577e-06,4,1,3
23358,reckon,2.3052039770217305e-06,1.8979287041356905e-06,3,2,1
23359,reckoning,6.496483935243052e-06,5.348708166200577e-06,6,3,3
23360,reclaim,1.0687763893464371e-05,7.074097897233022e-06,10,6,4
23361,recognise,1.6974683830796368e-05,3.2954943862719716e-05,27,8,19
23362,recognised,6.496483935243052e-06,1.9151826014460126e-05,14,3,11
23363,recognising,2.3052039770217305e-06,5.348708166200577e-06,4,1,3
23364,recognition,4.6313643538345614e-05,5.1934230904076595e-05,59,24,35
23365,recognizable,4.400843956132392e-06,1.8979287041356905e-06,5,2,3
23366,recognize,0.00011966104280721883,9.679436391092026e-05,127,63,64
23367,recognized,2.116596378901769e-05,2.6053384938589907e-05,29,14,15
23368,recognizing,1.6974683830796368e-05,1.742643628342769e-05,18,8,10
23369,recommend,2.326160376812834e-05,2.9504164400654783e-05,33,13,20
23370,recommendation,1.0687763893464371e-05,1.9151826014460126e-05,19,8,11
23371,recommended,2.116596378901769e-05,1.9151826014460126e-05,23,11,12
23372,recommending,4.400843956132392e-06,1.2250267090330355e-05,9,2,7
23373,reconcile,2.3052039770217305e-06,3.6233184351681345e-06,4,1,3
23374,reconciliation,8.592123914353715e-06,8.79948762826546e-06,10,5,5
23375,reconnaissance,4.400843956132392e-06,1.8979287041356905e-06,6,3,3
23376,reconnect,6.496483935243052e-06,1.8979287041356905e-06,4,3,1
23377,reconsider,2.116596378901769e-05,8.79948762826546e-06,18,11,7
23378,reconstruction,2.116596378901769e-05,1.052487735929791e-05,18,11,7
23379,record,0.00038161604019605166,0.00042806919226914944,472,199,273
23380,recordbreaking,1.0687763893464371e-05,3.6233184351681345e-06,8,6,2
23381,recorded,6.72700433294523e-05,6.573734875233614e-05,84,40,44
23382,recorder,2.3052039770217305e-06,1.2250267090330355e-05,8,1,7
23383,recording,4.4218003559234974e-05,3.468033359375216e-05,51,25,26
23384,recordsetting,2.3052039770217305e-06,3.6233184351681345e-06,3,1,2
23385,recount,6.496483935243052e-06,1.3975656821362803e-05,15,4,11
23386,recounted,2.095639979110664e-07,5.348708166200577e-06,3,0,3
23387,recover,1.48790438516857e-05,3.468033359375216e-05,29,7,22
23388,recovered,1.9070323809907035e-05,2.777877466962238e-05,29,12,17
23389,recovering,6.496483935243052e-06,1.742643628342769e-05,15,4,11
23390,recovery,4.6313643538345614e-05,6.573734875233614e-05,66,22,44
23391,recreate,8.592123914353715e-06,7.074097897233022e-06,8,4,4
23392,recreational,1.0687763893464371e-05,2.087721574549256e-05,17,5,12
23393,recruit,3.7931083621902995e-05,3.2954943862719716e-05,43,18,25
23394,recruited,4.400843956132392e-06,1.052487735929791e-05,9,3,6
23395,recruiter,1.0687763893464371e-05,8.79948762826546e-06,11,5,6
23396,recruiting,2.326160376812834e-05,1.570104655239525e-05,21,11,10
23397,recruitment,6.496483935243052e-06,1.742643628342769e-05,16,5,11
23398,recurring,4.400843956132392e-06,7.074097897233022e-06,7,3,4
23399,recuse,4.400843956132392e-06,3.6233184351681345e-06,5,2,3
23400,recycle,6.496483935243052e-06,3.6233184351681345e-06,7,3,4
23401,recycling,8.592123914353715e-06,8.79948762826546e-06,10,4,6
23402,red,8.403516316233764e-05,7.263890767646595e-05,87,43,44
23403,redacted,4.400843956132392e-06,3.6233184351681345e-06,4,2,2
23404,redacting,4.400843956132392e-06,1.8979287041356905e-06,3,2,1
23405,reddit,1.48790438516857e-05,2.6053384938589907e-05,22,7,15
23406,redditor,8.592123914353715e-06,5.348708166200577e-06,8,4,4
23407,redefine,8.592123914353715e-06,1.7253897310324457e-07,5,5,0
23408,redemption,2.3052039770217305e-06,3.6233184351681345e-06,4,2,2
23409,redesign,2.3052039770217305e-06,5.348708166200577e-06,4,1,3
23410,redirect,2.3052039770217305e-06,7.074097897233022e-06,5,1,4
23411,redirecting,2.3052039770217305e-06,3.6233184351681345e-06,3,1,2
23412,rediscovered,2.3052039770217305e-06,3.6233184351681345e-06,5,3,2
23413,redistribute,2.3052039770217305e-06,5.348708166200577e-06,5,1,4
23414,redistribution,2.3052039770217305e-06,1.8979287041356905e-06,3,2,1
23415,redistricting,1.0687763893464371e-05,5.348708166200577e-06,9,6,3
23416,redraw,6.496483935243052e-06,7.074097897233022e-06,8,3,5
23417,redrawing,2.3052039770217305e-06,3.6233184351681345e-06,3,1,2
23418,redres,4.400843956132392e-06,3.6233184351681345e-06,4,2,2
23419,reduce,6.72700433294523e-05,0.0001347529379936339,126,40,86
23420,reduced,2.5357243747239038e-05,2.9504164400654783e-05,33,12,21
23421,reducing,2.326160376812834e-05,2.087721574549256e-05,24,11,13
23422,reduction,2.954852370546031e-05,2.6053384938589907e-05,30,14,16
23423,redwood,2.3052039770217305e-06,3.6233184351681345e-06,3,1,2
23424,reeducation,6.496483935243052e-06,3.6233184351681345e-06,7,4,3
23425,reef,4.002672360101368e-05,3.8131113055817005e-05,46,20,26
23426,reelected,6.496483935243052e-06,1.9151826014460126e-05,15,3,12
23427,reelection,3.7931083621902995e-05,4.50326719799468e-05,58,21,37
23428,reeling,2.3052039770217305e-06,7.074097897233022e-06,5,1,4
23429,reenter,8.592123914353715e-06,1.8979287041356905e-06,5,4,1
23430,reentry,2.3052039770217305e-06,3.6233184351681345e-06,3,1,2
23431,reevaluate,4.400843956132392e-06,3.6233184351681345e-06,4,2,2
23432,reexamine,6.496483935243052e-06,1.7253897310324457e-07,3,3,0
23433,refer,1.9070323809907035e-05,1.2250267090330355e-05,17,9,8
23434,referee,6.496483935243052e-06,3.6233184351681345e-06,6,4,2
23435,reference,4.002672360101368e-05,3.122955413168725e-05,40,21,19
23436,referencing,4.400843956132392e-06,5.348708166200577e-06,5,2,3
23437,referendum,9.660900303700153e-05,7.091351794543343e-05,95,47,48
23438,referral,4.400843956132392e-06,1.052487735929791e-05,8,2,6
23439,referred,2.116596378901769e-05,3.468033359375216e-05,32,12,20
23440,referring,1.0687763893464371e-05,1.570104655239525e-05,16,6,10
23441,refinance,8.592123914353715e-06,1.7253897310324457e-07,6,5,1
23442,refined,4.400843956132392e-06,1.8979287041356905e-06,3,2,1
23443,refinery,1.6974683830796368e-05,1.2250267090330355e-05,16,9,7
23444,refining,6.496483935243052e-06,1.8979287041356905e-06,4,3,1
23445,reflect,5.6791843433898893e-05,6.228656929027126e-05,72,29,43
23446,reflected,6.496483935243052e-06,8.79948762826546e-06,10,3,7
23447,reflecting,8.592123914353715e-06,3.6233184351681345e-06,7,4,3
23448,reflection,4.400843956132392e-06,1.9151826014460126e-05,14,2,12
23449,reflective,6.496483935243052e-06,5.348708166200577e-06,6,3,3
23450,reflexively,2.3052039770217305e-06,1.8979287041356905e-06,3,1,2
23451,refocu,2.3052039770217305e-06,3.6233184351681345e-06,3,1,2
23452,reform,0.0002181561218254202,0.00022619859373835345,265,115,150
23453,reformed,6.496483935243052e-06,1.7253897310324457e-07,3,3,0
23454,reformer,1.278340387257504e-05,3.6233184351681345e-06,9,7,2
23455,reforming,4.400843956132392e-06,5.348708166200577e-06,5,2,3
23456,reformist,6.496483935243052e-06,7.074097897233022e-06,7,3,4
23457,refrain,8.592123914353715e-06,7.074097897233022e-06,9,5,4
23458,refrained,6.496483935243052e-06,1.8979287041356905e-06,5,4,1
23459,refreshing,2.3052039770217305e-06,3.6233184351681345e-06,3,1,2
23460,refuel,2.3052039770217305e-06,3.6233184351681345e-06,3,1,2
23461,refuge,3.1644163684570994e-05,1.742643628342769e-05,25,15,10
23462,refugee,0.00030617300094806777,0.0003228204186761705,358,152,206
23463,refund,3.3739803663681634e-05,1.3975656821362803e-05,29,18,11
23464,refusal,3.3739803663681634e-05,3.2954943862719716e-05,38,17,21
23465,refuse,0.00017205204228498542,0.00019341618884873702,216,92,124
23466,refused,0.00013223488268188294,0.00012612598933847184,153,67,86
23467,refusing,8.822644312055891e-05,9.161819471782287e-05,102,44,58
23468,refute,8.592123914353715e-06,5.348708166200577e-06,7,4,3
23469,regain,1.0687763893464371e-05,8.79948762826546e-06,12,7,5
23470,regard,1.278340387257504e-05,2.6053384938589907e-05,21,6,15
23471,regarded,1.6974683830796368e-05,8.79948762826546e-06,13,8,5
23472,regarding,5.050492349656699e-05,5.020884117304414e-05,58,27,31
23473,regardles,1.48790438516857e-05,1.3975656821362803e-05,16,7,9
23474,regime,0.00018672152213876006,0.00020376852723493182,227,99,128
23475,region,0.00020139100199253443,0.00020721930669699654,241,106,135
23476,regional,3.3739803663681634e-05,3.468033359375216e-05,41,19,22
23477,register,3.583544364279237e-05,3.2954943862719716e-05,43,23,20
23478,registered,4.212236358012434e-05,3.2954943862719716e-05,42,22,20
23479,registering,8.592123914353715e-06,5.348708166200577e-06,7,4,3
23480,registration,1.6974683830796368e-05,2.6053384938589907e-05,26,10,16
23481,registry,6.496483935243052e-06,1.8979287041356905e-06,4,3,1
23482,regressive,6.496483935243052e-06,1.8979287041356905e-06,5,3,2
23483,regret,3.3739803663681634e-05,2.9504164400654783e-05,40,22,18
23484,regrettable,4.400843956132392e-06,3.6233184351681345e-06,4,2,2
23485,regretted,6.496483935243052e-06,1.8979287041356905e-06,4,3,1
23486,regular,4.840928351745632e-05,4.1581892517881935e-05,54,25,29
23487,regularly,3.1644163684570994e-05,3.2954943862719716e-05,39,15,24
23488,regulate,2.116596378901769e-05,2.777877466962238e-05,30,12,18
23489,regulated,6.496483935243052e-06,2.087721574549256e-05,16,3,13
23490,regulating,4.400843956132392e-06,5.348708166200577e-06,5,2,3
23491,regulation,0.00010499156295344414,9.161819471782287e-05,118,53,65
23492,regulator,6.098312339212028e-05,4.6758061710979285e-05,66,32,34
23493,regulatory,1.0687763893464371e-05,1.052487735929791e-05,13,6,7
23494,rehab,1.48790438516857e-05,3.6233184351681345e-06,9,7,2
23495,rehabilitation,8.592123914353715e-06,7.074097897233022e-06,8,4,4
23496,rehearsal,2.3052039770217305e-06,1.8979287041356905e-06,4,2,2
23497,reign,8.592123914353715e-06,1.2250267090330355e-05,12,4,8
23498,reigned,2.3052039770217305e-06,1.8979287041356905e-06,3,1,2
23499,reignite,6.496483935243052e-06,1.8979287041356905e-06,6,5,1
23500,reignited,2.3052039770217305e-06,1.8979287041356905e-06,3,1,2
23501,reimbursement,2.095639979110664e-07,5.348708166200577e-06,3,0,3
23502,rein,8.592123914353715e-06,1.052487735929791e-05,10,4,6
23503,reincarnation,2.095639979110664e-07,3.6233184351681345e-06,3,0,3
23504,reinforce,8.592123914353715e-06,8.79948762826546e-06,11,4,7
23505,reinforced,6.496483935243052e-06,3.6233184351681345e-06,5,3,2
23506,reinforcement,2.095639979110664e-07,8.79948762826546e-06,5,0,5
23507,reinforcing,4.400843956132392e-06,5.348708166200577e-06,5,2,3
23508,reinstate,8.592123914353715e-06,1.052487735929791e-05,12,6,6
23509,reinstated,4.400843956132392e-06,1.7253897310324457e-07,3,2,1
23510,reinstatement,2.095639979110664e-07,7.074097897233022e-06,4,0,4
23511,reinstating,4.400843956132392e-06,1.8979287041356905e-06,3,2,1
23512,reintroduce,2.3052039770217305e-06,5.348708166200577e-06,4,1,3
23513,reintroduced,4.400843956132392e-06,3.6233184351681345e-06,4,2,2
23514,reintroduction,2.095639979110664e-07,3.6233184351681345e-06,3,0,3
23515,reinvent,2.3052039770217305e-06,1.052487735929791e-05,7,1,6
23516,reinvest,2.095639979110664e-07,5.348708166200577e-06,3,0,3
23517,reinvigorate,4.400843956132392e-06,1.8979287041356905e-06,3,2,1
23518,reiterate,2.3052039770217305e-06,5.348708166200577e-06,4,1,3
23519,reiterated,6.496483935243052e-06,3.6233184351681345e-06,6,4,2
23520,reject,0.00014690436253565753,0.00016235917369015308,178,73,105
23521,rejected,7.984388320411623e-05,9.851975364195259e-05,108,43,65
23522,rejecting,2.326160376812834e-05,2.087721574549256e-05,25,12,13
23523,rejection,1.9070323809907035e-05,7.074097897233022e-06,16,9,7
23524,rejoice,8.592123914353715e-06,3.6233184351681345e-06,7,4,3
23525,relate,4.400843956132392e-06,1.3975656821362803e-05,11,2,9
23526,related,6.72700433294523e-05,5.5385010366141504e-05,73,34,39
23527,relating,2.5357243747239038e-05,1.052487735929791e-05,18,12,6
23528,relation,0.00010499156295344414,7.608968713853079e-05,105,52,53
23529,relationship,0.00013223488268188294,0.00011749904068330962,137,64,73
23530,relative,5.260056347567764e-05,4.8483451442011706e-05,57,25,32
23531,relatively,3.1644163684570994e-05,1.742643628342769e-05,30,18,12
23532,relaunch,4.400843956132392e-06,1.7253897310324457e-07,3,3,0
23533,relax,4.400843956132392e-06,1.570104655239525e-05,11,2,9
23534,relaxation,4.400843956132392e-06,1.8979287041356905e-06,3,2,1
23535,relaxed,2.3052039770217305e-06,3.6233184351681345e-06,4,1,3
23536,relay,2.3052039770217305e-06,3.6233184351681345e-06,3,1,2
23537,release,0.0002537820014703013,0.00027450950620726186,301,126,175
23538,released,0.0002935991610734039,0.0002520794397038401,311,149,162
23539,releasing,3.1644163684570994e-05,3.122955413168725e-05,36,15,21
23540,relentles,8.592123914353715e-06,1.570104655239525e-05,14,4,10
23541,relentlessly,4.400843956132392e-06,3.6233184351681345e-06,5,2,3
23542,relevance,4.400843956132392e-06,5.348708166200577e-06,5,2,3
23543,relevant,1.6974683830796368e-05,2.2602605476525032e-05,25,9,16
23544,reliable,1.48790438516857e-05,8.79948762826546e-06,13,8,5
23545,reliably,4.400843956132392e-06,8.79948762826546e-06,7,2,5
23546,reliance,2.3052039770217305e-06,5.348708166200577e-06,5,1,4
23547,relic,4.400843956132392e-06,1.2250267090330355e-05,11,2,9
23548,relied,4.400843956132392e-06,1.2250267090330355e-05,12,5,7
23549,relief,6.72700433294523e-05,6.573734875233614e-05,75,35,40
23550,relieve,8.592123914353715e-06,5.348708166200577e-06,8,5,3
23551,relieved,1.278340387257504e-05,3.6233184351681345e-06,9,7,2
23552,religion,0.00011966104280721883,9.679436391092026e-05,127,61,66
23553,religiou,0.0002642602013658546,0.00021239547589009395,281,139,142
23554,religiously,1.278340387257504e-05,3.6233184351681345e-06,9,7,2
23555,relinquish,2.095639979110664e-07,7.074097897233022e-06,4,0,4
23556,relinquishing,6.496483935243052e-06,1.7253897310324457e-07,3,3,0
23557,relocate,1.9070323809907035e-05,1.052487735929791e-05,15,9,6
23558,relocated,2.3052039770217305e-06,7.074097897233022e-06,5,1,4
23559,relocating,6.496483935243052e-06,1.8979287041356905e-06,4,3,1
23560,relocation,8.592123914353715e-06,1.052487735929791e-05,10,4,6
23561,reluctance,1.48790438516857e-05,3.6233184351681345e-06,9,7,2
23562,reluctant,2.5357243747239038e-05,8.79948762826546e-06,21,12,9
23563,rely,3.1644163684570994e-05,5.020884117304414e-05,48,17,31
23564,relying,1.48790438516857e-05,8.79948762826546e-06,14,8,6
23565,remain,0.00025587764144941177,0.00032109502894513814,336,131,205
23566,remainder,2.3052039770217305e-06,3.6233184351681345e-06,3,1,2
23567,remained,1.9070323809907035e-05,3.8131113055817005e-05,31,9,22
23568,remaining,4.6313643538345614e-05,3.2954943862719716e-05,50,26,24
23569,remark,6.307876337123095e-05,7.608968713853079e-05,86,36,50
23570,remarkable,2.326160376812834e-05,3.468033359375216e-05,35,11,24
23571,remarkably,6.496483935243052e-06,7.074097897233022e-06,9,3,6
23572,remarked,8.592123914353715e-06,1.7253897310324457e-07,4,4,0
23573,remarry,2.3052039770217305e-06,3.6233184351681345e-06,3,1,2
23574,rematch,2.3052039770217305e-06,1.7253897310324457e-07,3,1,2
23575,remedy,1.6974683830796368e-05,3.6233184351681345e-06,11,9,2
23576,remember,6.72700433294523e-05,0.00010542131256608228,100,37,63
23577,remembered,8.592123914353715e-06,3.6233184351681345e-06,6,4,2
23578,remembering,4.400843956132392e-06,8.79948762826546e-06,8,3,5
23579,remind,1.6974683830796368e-05,2.777877466962238e-05,28,10,18
23580,reminded,2.7452883726349685e-05,2.777877466962238e-05,30,13,17
23581,reminder,3.1644163684570994e-05,3.122955413168725e-05,37,17,20
23582,reminding,6.496483935243052e-06,5.348708166200577e-06,6,3,3
23583,reminiscent,2.3052039770217305e-06,7.074097897233022e-06,6,1,5
23584,remnant,6.496483935243052e-06,1.8979287041356905e-06,4,3,1
23585,remorse,8.592123914353715e-06,1.7253897310324457e-07,5,4,1
23586,remote,3.1644163684570994e-05,6.401195902130366e-05,54,16,38
23587,remotely,1.48790438516857e-05,7.074097897233022e-06,14,8,6
23588,remotest,4.400843956132392e-06,1.7253897310324457e-07,3,2,1
23589,removal,3.3739803663681634e-05,3.122955413168725e-05,37,17,20
23590,remove,0.00015738256243121094,0.0001295767688005365,163,76,87
23591,removed,0.0001154697628489974,8.4716635793693e-05,113,60,53
23592,removing,3.3739803663681634e-05,3.8131113055817005e-05,43,18,25
23593,rename,4.400843956132392e-06,1.7253897310324457e-07,3,3,0
23594,renamed,2.3052039770217305e-06,1.7253897310324457e-07,3,3,0
23595,render,4.400843956132392e-06,8.79948762826546e-06,7,2,5
23596,rendered,4.400843956132392e-06,1.052487735929791e-05,8,2,6
23597,rendition,2.7452883726349685e-05,1.9151826014460126e-05,31,14,17
23598,renegade,4.400843956132392e-06,3.6233184351681345e-06,4,2,2
23599,reneging,2.095639979110664e-07,7.074097897233022e-06,4,0,4
23600,renew,1.278340387257504e-05,1.570104655239525e-05,18,6,12
23601,renewable,9.24177230787802e-05,0.00010714670229711469,113,46,67
23602,renewal,2.3052039770217305e-06,7.074097897233022e-06,6,2,4
23603,renewed,1.9070323809907035e-05,2.087721574549256e-05,23,9,14
23604,renewing,2.3052039770217305e-06,5.348708166200577e-06,5,1,4
23605,renminbi,2.3052039770217305e-06,3.6233184351681345e-06,3,1,2
23606,renounce,6.496483935243052e-06,5.348708166200577e-06,6,3,3
23607,renovation,2.3052039770217305e-06,1.8979287041356905e-06,3,1,2
23608,renowned,2.095639979110664e-07,1.3975656821362803e-05,9,0,9
23609,rent,2.7452883726349685e-05,2.4327995207557487e-05,29,14,15
23610,rental,1.278340387257504e-05,1.742643628342769e-05,18,7,11
23611,rented,6.496483935243052e-06,1.8979287041356905e-06,5,3,2
23612,renter,2.095639979110664e-07,3.6233184351681345e-06,4,1,3
23613,renting,1.0687763893464371e-05,7.074097897233022e-06,10,6,4
23614,reopen,2.116596378901769e-05,3.8131113055817005e-05,36,11,25
23615,reopened,2.3052039770217305e-06,1.052487735929791e-05,7,1,6
23616,reopening,2.3052039770217305e-06,1.742643628342769e-05,13,3,10
23617,reorganize,2.3052039770217305e-06,1.8979287041356905e-06,3,2,1
23618,rep,4.400843956132392e-06,8.79948762826546e-06,7,2,5
23619,repaid,4.400843956132392e-06,7.074097897233022e-06,6,2,4
23620,repair,3.3739803663681634e-05,2.087721574549256e-05,30,16,14
23621,repaired,2.3052039770217305e-06,5.348708166200577e-06,4,1,3
23622,reparation,1.9070323809907035e-05,8.79948762826546e-06,15,10,5
23623,repatriated,4.400843956132392e-06,1.8979287041356905e-06,3,2,1
23624,repatriation,2.095639979110664e-07,5.348708166200577e-06,3,0,3
23625,repay,1.278340387257504e-05,1.2250267090330355e-05,15,7,8
23626,repaying,2.3052039770217305e-06,3.6233184351681345e-06,3,1,2
23627,repayment,8.592123914353715e-06,1.052487735929791e-05,10,4,6
23628,repeal,6.307876337123095e-05,8.299124606266055e-05,87,34,53
23629,repealed,6.496483935243052e-06,1.052487735929791e-05,10,3,7
23630,repealing,4.400843956132392e-06,1.570104655239525e-05,13,4,9
23631,repeat,2.5357243747239038e-05,1.9151826014460126e-05,27,14,13
23632,repeated,2.326160376812834e-05,2.9504164400654783e-05,31,11,20
23633,repeatedly,5.4696203454788295e-05,6.918812821440096e-05,77,33,44
23634,repeating,1.278340387257504e-05,5.348708166200577e-06,12,6,6
23635,repel,8.592123914353715e-06,1.2250267090330355e-05,12,4,8
23636,repent,4.400843956132392e-06,7.074097897233022e-06,6,2,4
23637,repercussion,8.592123914353715e-06,1.052487735929791e-05,11,4,7
23638,repetition,2.3052039770217305e-06,3.6233184351681345e-06,3,1,2
23639,replace,6.72700433294523e-05,9.506897417988779e-05,94,37,57
23640,replaced,3.7931083621902995e-05,3.2954943862719716e-05,39,18,21
23641,replacement,2.954852370546031e-05,2.777877466962238e-05,31,14,17
23642,replacing,1.6974683830796368e-05,2.087721574549256e-05,20,8,12
23643,replay,4.400843956132392e-06,3.6233184351681345e-06,4,2,2
23644,replenish,4.400843956132392e-06,1.8979287041356905e-06,3,2,1
23645,replica,4.400843956132392e-06,1.8979287041356905e-06,4,2,2
23646,replicate,6.496483935243052e-06,1.7253897310324457e-07,3,3,0
23647,replied,6.496483935243052e-06,5.348708166200577e-06,7,3,4
23648,reply,8.592123914353715e-06,1.2250267090330355e-05,12,4,8
23649,report,0.0010165949538665823,0.0009767431267374668,1162,532,630
23650,reported,0.0002747384012614078,0.0002900380137865542,329,143,186
23651,reportedly,0.0002349212416583052,0.00026243177809003493,284,119,165
23652,reporter,0.00020139100199253443,0.00015373222503499084,197,99,98
23653,reporting,0.00010080028299522283,7.781507686956326e-05,110,56,54
23654,reprehensible,4.400843956132392e-06,7.074097897233022e-06,6,2,4
23655,represent,7.774824322500554e-05,7.091351794543343e-05,89,42,47
23656,representation,4.400843956132392e-06,1.742643628342769e-05,16,4,12
23657,representative,4.6313643538345614e-05,5.711040009717395e-05,66,30,36
23658,represented,2.5357243747239038e-05,1.570104655239525e-05,24,14,10
23659,representing,2.5357243747239038e-05,2.2602605476525032e-05,27,13,14
23660,repression,2.954852370546031e-05,1.570104655239525e-05,25,14,11
23661,repressive,1.278340387257504e-05,8.79948762826546e-06,12,6,6
23662,reprieve,4.400843956132392e-06,7.074097897233022e-06,6,2,4
23663,reprimanded,2.3052039770217305e-06,5.348708166200577e-06,4,1,3
23664,reprinted,4.400843956132392e-06,1.8979287041356905e-06,3,2,1
23665,reprisal,6.496483935243052e-06,1.8979287041356905e-06,4,3,1
23666,reproduced,2.095639979110664e-07,7.074097897233022e-06,4,0,4
23667,reproductive,2.326160376812834e-05,2.087721574549256e-05,29,14,15
23668,reptile,1.278340387257504e-05,1.8979287041356905e-06,9,7,2
23669,republic,4.002672360101368e-05,1.052487735929791e-05,27,20,7
23670,republican,4.400843956132392e-06,3.6233184351681345e-06,5,2,3
23671,reputation,4.6313643538345614e-05,3.8131113055817005e-05,55,30,25
23672,request,0.00011337412286988677,0.0001571830044970555,167,67,100
23673,requested,1.278340387257504e-05,1.742643628342769e-05,18,7,11
23674,requesting,8.592123914353715e-06,7.074097897233022e-06,10,5,5
23675,require,0.0001259479627445509,0.00013130215853156914,152,65,87
23676,required,7.146132328767358e-05,5.5385010366141504e-05,73,40,33
23677,requirement,3.3739803663681634e-05,2.087721574549256e-05,35,19,16
23678,requiring,4.002672360101368e-05,3.122955413168725e-05,44,22,22
23679,rerun,4.400843956132392e-06,3.6233184351681345e-06,4,2,2
23680,resale,2.095639979110664e-07,5.348708166200577e-06,3,0,3
23681,rescind,2.3052039770217305e-06,1.3975656821362803e-05,10,2,8
23682,rescue,8.613080314144832e-05,7.781507686956326e-05,98,46,52
23683,rescued,5.6791843433898893e-05,5.883578982820635e-05,65,28,37
23684,rescuer,8.592123914353715e-06,8.79948762826546e-06,9,4,5
23685,rescuing,4.400843956132392e-06,5.348708166200577e-06,6,3,3
23686,research,0.00023701688163741595,0.00022792398346938586,269,122,147
23687,researcher,0.0001259479627445509,0.00011059748175917965,133,64,69
23688,resemblance,2.095639979110664e-07,5.348708166200577e-06,3,0,3
23689,resemble,6.496483935243052e-06,1.052487735929791e-05,9,3,6
23690,resembling,6.496483935243052e-06,3.6233184351681345e-06,6,3,3
23691,resent,2.095639979110664e-07,7.074097897233022e-06,4,0,4
23692,resentment,1.278340387257504e-05,8.79948762826546e-06,12,7,5
23693,reservation,8.592123914353715e-06,8.79948762826546e-06,11,4,7
23694,reserve,7.984388320411623e-05,8.126585633162811e-05,97,44,53
23695,reserved,1.278340387257504e-05,3.6233184351681345e-06,9,7,2
23696,reservist,4.400843956132392e-06,1.8979287041356905e-06,3,2,1
23697,reservoir,2.3052039770217305e-06,8.79948762826546e-06,6,1,5
23698,reset,4.400843956132392e-06,1.7253897310324457e-07,3,2,1
23699,resettle,2.095639979110664e-07,7.074097897233022e-06,4,0,4
23700,resettled,2.3052039770217305e-06,3.6233184351681345e-06,3,1,2
23701,resettlement,2.3052039770217305e-06,1.2250267090330355e-05,8,1,7
23702,resettling,2.095639979110664e-07,3.6233184351681345e-06,3,1,2
23703,reshape,2.3052039770217305e-06,5.348708166200577e-06,6,2,4
23704,reshaping,2.095639979110664e-07,5.348708166200577e-06,3,0,3
23705,reshuffle,2.3052039770217305e-06,1.7253897310324457e-07,3,2,1
23706,reside,6.496483935243052e-06,1.052487735929791e-05,9,3,6
23707,residence,3.1644163684570994e-05,1.2250267090330355e-05,25,17,8
23708,residency,2.116596378901769e-05,1.3975656821362803e-05,19,11,8
23709,resident,0.00015109564249387862,0.0001847892401935746,201,81,120
23710,residential,1.6974683830796368e-05,1.052487735929791e-05,18,10,8
23711,resign,0.0001385218026192147,0.0001485560558418934,161,71,90
23712,resignation,7.146132328767358e-05,5.5385010366141504e-05,72,37,35
23713,resigned,4.4218003559234974e-05,5.1934230904076595e-05,56,22,34
23714,resigning,1.0687763893464371e-05,1.052487735929791e-05,13,7,6
23715,resilience,4.400843956132392e-06,8.79948762826546e-06,7,2,5
23716,resilient,4.400843956132392e-06,3.6233184351681345e-06,5,2,3
23717,resist,1.6974683830796368e-05,1.2250267090330355e-05,19,9,10
23718,resistance,6.098312339212028e-05,5.5385010366141504e-05,65,31,34
23719,resistant,8.592123914353715e-06,1.3975656821362803e-05,15,5,10
23720,resisted,8.592123914353715e-06,1.052487735929791e-05,13,7,6
23721,resisting,1.48790438516857e-05,8.79948762826546e-06,13,8,5
23722,resolution,6.72700433294523e-05,0.00010542131256608228,106,34,72
23723,resolve,2.954852370546031e-05,3.122955413168725e-05,33,14,19
23724,resolved,1.278340387257504e-05,1.7253897310324457e-07,7,7,0
23725,resolving,6.496483935243052e-06,7.074097897233022e-06,8,3,5
23726,resonate,1.0687763893464371e-05,5.348708166200577e-06,11,5,6
23727,resort,5.6791843433898893e-05,5.3659620635109e-05,62,28,34
23728,resorted,4.400843956132392e-06,1.7253897310324457e-07,4,3,1
23729,resorting,4.400843956132392e-06,1.8979287041356905e-06,3,2,1
23730,resource,0.00011756540282810809,0.0001019705331040174,134,61,73
23731,respect,8.613080314144832e-05,9.506897417988779e-05,102,43,59
23732,respected,1.278340387257504e-05,1.3975656821362803e-05,16,6,10
23733,respectful,2.3052039770217305e-06,7.074097897233022e-06,5,1,4
23734,respecting,6.496483935243052e-06,1.8979287041356905e-06,4,3,1
23735,respective,4.400843956132392e-06,1.052487735929791e-05,9,3,6
23736,respectively,4.400843956132392e-06,8.79948762826546e-06,8,2,6
23737,respiratory,6.496483935243052e-06,3.6233184351681345e-06,5,3,2
23738,respond,7.355696326678427e-05,7.608968713853079e-05,90,41,49
23739,responded,4.840928351745632e-05,2.9504164400654783e-05,44,25,19
23740,respondent,1.0687763893464371e-05,1.742643628342769e-05,16,5,11
23741,responder,4.400843956132392e-06,8.79948762826546e-06,7,2,5
23742,responding,1.9070323809907035e-05,1.9151826014460126e-05,22,10,12
23743,response,0.00023701688163741595,0.00025725560889693777,286,124,162
23744,responsibility,9.660900303700153e-05,0.0001019705331040174,114,50,64
23745,responsible,0.00011127848289077625,9.851975364195259e-05,127,62,65
23746,responsive,2.3052039770217305e-06,7.074097897233022e-06,5,1,4
23747,rest,0.00013642616264010403,0.0001295767688005365,160,72,88
23748,restart,1.9070323809907035e-05,1.9151826014460126e-05,20,9,11
23749,restarted,4.400843956132392e-06,5.348708166200577e-06,6,2,4
23750,restarting,2.095639979110664e-07,3.6233184351681345e-06,3,1,2
23751,restaurant,8.403516316233764e-05,6.401195902130366e-05,91,46,45
23752,rested,6.496483935243052e-06,1.8979287041356905e-06,4,3,1
23753,resting,2.3052039770217305e-06,3.6233184351681345e-06,3,1,2
23754,restive,6.496483935243052e-06,1.7253897310324457e-07,3,3,0
23755,restock,2.095639979110664e-07,3.6233184351681345e-06,3,1,2
23756,restoration,6.496483935243052e-06,7.074097897233022e-06,7,3,4
23757,restore,4.840928351745632e-05,4.1581892517881935e-05,57,26,31
23758,restored,2.116596378901769e-05,8.79948762826546e-06,17,10,7
23759,restoring,1.0687763893464371e-05,1.3975656821362803e-05,15,5,10
23760,restrain,4.400843956132392e-06,5.348708166200577e-06,5,2,3
23761,restraining,2.3052039770217305e-06,1.2250267090330355e-05,9,1,8
23762,restraint,1.278340387257504e-05,1.052487735929791e-05,14,8,6
23763,restrict,1.6974683830796368e-05,4.330728224891437e-05,37,10,27
23764,restricted,2.326160376812834e-05,1.3975656821362803e-05,21,12,9
23765,restricting,1.48790438516857e-05,1.2250267090330355e-05,14,7,7
23766,restriction,9.24177230787802e-05,5.883578982820635e-05,87,48,39
23767,restrictive,6.496483935243052e-06,7.074097897233022e-06,9,5,4
23768,restroom,6.496483935243052e-06,7.074097897233022e-06,8,3,5
23769,restructure,2.3052039770217305e-06,5.348708166200577e-06,4,1,3
23770,restructuring,4.400843956132392e-06,7.074097897233022e-06,7,3,4
23771,result,0.00033341632067650624,0.00028141106513139157,359,173,186
23772,resulted,8.592123914353715e-06,2.777877466962238e-05,22,6,16
23773,resulting,1.9070323809907035e-05,1.3975656821362803e-05,20,10,10
23774,resume,3.7931083621902995e-05,2.2602605476525032e-05,33,19,14
23775,resumed,4.400843956132392e-06,3.6233184351681345e-06,5,2,3
23776,resuming,4.400843956132392e-06,3.6233184351681345e-06,4,2,2
23777,resumption,2.095639979110664e-07,3.6233184351681345e-06,3,0,3
23778,resurface,2.3052039770217305e-06,1.8979287041356905e-06,3,1,2
23779,resurfaced,2.3052039770217305e-06,3.6233184351681345e-06,3,1,2
23780,resurgence,2.3052039770217305e-06,5.348708166200577e-06,4,1,3
23781,resurgent,4.400843956132392e-06,1.8979287041356905e-06,3,2,1
23782,retail,2.116596378901769e-05,3.122955413168725e-05,33,14,19
23783,retailer,5.260056347567764e-05,4.8483451442011706e-05,61,28,33
23784,retain,1.48790438516857e-05,1.3975656821362803e-05,18,9,9
23785,retained,2.095639979110664e-07,7.074097897233022e-06,4,0,4
23786,retaining,2.095639979110664e-07,5.348708166200577e-06,4,0,4
23787,retake,1.9070323809907035e-05,1.742643628342769e-05,20,9,11
23788,retaken,4.400843956132392e-06,1.8979287041356905e-06,3,2,1
23789,retaliate,1.9070323809907035e-05,8.79948762826546e-06,15,9,6
23790,retaliating,6.496483935243052e-06,1.7253897310324457e-07,4,3,1
23791,retaliation,3.7931083621902995e-05,2.4327995207557487e-05,36,20,16
23792,retaliatory,2.3052039770217305e-06,8.79948762826546e-06,6,1,5
23793,retarded,2.3052039770217305e-06,5.348708166200577e-06,5,1,4
23794,retention,2.116596378901769e-05,5.348708166200577e-06,15,10,5
23795,rethink,2.5357243747239038e-05,1.3975656821362803e-05,24,14,10
23796,rethinking,2.3052039770217305e-06,3.6233184351681345e-06,4,1,3
23797,retina,2.3052039770217305e-06,5.348708166200577e-06,4,1,3
23798,retire,2.954852370546031e-05,1.052487735929791e-05,21,15,6
23799,retired,2.7452883726349685e-05,4.50326719799468e-05,45,17,28
23800,retiree,1.0687763893464371e-05,1.2250267090330355e-05,14,7,7
23801,retirement,7.984388320411623e-05,7.608968713853079e-05,91,43,48
23802,retiring,6.496483935243052e-06,1.052487735929791e-05,10,3,7
23803,retort,6.496483935243052e-06,3.6233184351681345e-06,5,3,2
23804,retract,6.496483935243052e-06,3.6233184351681345e-06,5,3,2
23805,retracted,8.592123914353715e-06,3.6233184351681345e-06,6,4,2
23806,retreat,2.954852370546031e-05,1.9151826014460126e-05,26,14,12
23807,retreated,6.496483935243052e-06,1.7253897310324457e-07,3,3,0
23808,retreating,1.0687763893464371e-05,5.348708166200577e-06,8,5,3
23809,retrial,2.095639979110664e-07,5.348708166200577e-06,5,0,5
23810,retribution,4.400843956132392e-06,8.79948762826546e-06,8,2,6
23811,retrieve,2.3052039770217305e-06,5.348708166200577e-06,4,1,3
23812,retroactive,2.095639979110664e-07,5.348708166200577e-06,3,0,3
23813,return,0.0003271294007391747,0.0003038411316348131,371,167,204
23814,returned,6.517440335034157e-05,5.020884117304414e-05,65,34,31
23815,returnee,2.3052039770217305e-06,5.348708166200577e-06,4,1,3
23816,returning,3.7931083621902995e-05,5.020884117304414e-05,53,20,33
23817,retweet,4.400843956132392e-06,7.074097897233022e-06,6,2,4
23818,retweeting,6.496483935243052e-06,1.8979287041356905e-06,4,3,1
23819,reunification,1.6974683830796368e-05,8.79948762826546e-06,14,8,6
23820,reunion,4.400843956132392e-06,7.074097897233022e-06,6,2,4
23821,reunite,2.3052039770217305e-06,3.6233184351681345e-06,3,1,2
23822,reunited,8.592123914353715e-06,1.052487735929791e-05,12,4,8
23823,reusable,4.400843956132392e-06,3.6233184351681345e-06,4,2,2
23824,revamp,2.3052039770217305e-06,5.348708166200577e-06,4,1,3
23825,reveal,0.00033132068069739577,0.0003090173008279106,382,178,204
23826,revealed,0.0001783389622223174,0.0001589083942280881,190,91,99
23827,revealing,3.7931083621902995e-05,3.2954943862719716e-05,42,21,21
23828,revelation,6.936568330856297e-05,7.263890767646595e-05,86,36,50
23829,revenge,2.326160376812834e-05,2.9504164400654783e-05,31,12,19
23830,revenue,4.4218003559234974e-05,4.1581892517881935e-05,51,23,28
23831,reversal,6.496483935243052e-06,2.2602605476525032e-05,17,3,14
23832,reverse,2.954852370546031e-05,5.1934230904076595e-05,47,17,30
23833,reversed,8.592123914353715e-06,1.052487735929791e-05,11,4,7
23834,reversing,1.0687763893464371e-05,5.348708166200577e-06,8,5,3
23835,review,9.03220830996695e-05,0.00010542131256608228,113,47,66
23836,reviewed,8.592123914353715e-06,8.79948762826546e-06,10,5,5
23837,reviewing,1.278340387257504e-05,1.570104655239525e-05,15,6,9
23838,reviled,6.496483935243052e-06,1.7253897310324457e-07,3,3,0
23839,revise,8.592123914353715e-06,7.074097897233022e-06,8,4,4
23840,revised,1.6974683830796368e-05,1.3975656821362803e-05,17,8,9
23841,revision,2.3052039770217305e-06,3.6233184351681345e-06,3,1,2
23842,revitalization,6.496483935243052e-06,1.7253897310324457e-07,3,3,0
23843,revival,1.0687763893464371e-05,8.79948762826546e-06,12,6,6
23844,revive,2.5357243747239038e-05,2.6053384938589907e-05,32,14,18
23845,revived,2.095639979110664e-07,1.742643628342769e-05,12,2,10
23846,reviving,2.095639979110664e-07,7.074097897233022e-06,6,1,5
23847,revoke,1.6974683830796368e-05,1.9151826014460126e-05,19,8,11
23848,revoked,1.48790438516857e-05,7.074097897233022e-06,14,7,7
23849,revoking,2.3052039770217305e-06,7.074097897233022e-06,5,1,4
23850,revolf,2.3052039770217305e-06,3.6233184351681345e-06,3,1,2
23851,revolt,6.72700433294523e-05,3.122955413168725e-05,52,32,20
23852,revolting,4.400843956132392e-06,3.6233184351681345e-06,5,3,2
23853,revolution,9.660900303700153e-05,0.00011404826122124471,124,52,72
23854,revolutionary,1.9070323809907035e-05,1.9151826014460126e-05,25,10,15
23855,revolutionize,1.0687763893464371e-05,3.6233184351681345e-06,7,5,2
23856,revolving,6.496483935243052e-06,3.6233184351681345e-06,5,3,2
23857,revulsion,4.400843956132392e-06,1.8979287041356905e-06,4,3,1
23858,reward,4.6313643538345614e-05,3.468033359375216e-05,45,23,22
23859,rewarded,8.592123914353715e-06,8.79948762826546e-06,9,4,5
23860,rewarding,8.592123914353715e-06,1.052487735929791e-05,11,4,7
23861,rewrite,1.278340387257504e-05,2.9504164400654783e-05,24,6,18
23862,rewriting,8.592123914353715e-06,8.79948762826546e-06,10,4,6
23863,rewritten,6.496483935243052e-06,1.7253897310324457e-07,3,3,0
23864,rglobalhealth,4.400843956132392e-06,5.348708166200577e-06,6,2,4
23865,rhetoric,8.613080314144832e-05,4.8483451442011706e-05,73,42,31
23866,rhetorical,2.3052039770217305e-06,8.79948762826546e-06,6,1,5
23867,rhino,7.146132328767358e-05,5.1934230904076595e-05,73,36,37
23868,rhinocero,4.400843956132392e-06,1.8979287041356905e-06,3,2,1
23869,rhythm,2.095639979110664e-07,7.074097897233022e-06,6,1,5
23870,rice,1.9070323809907035e-05,1.742643628342769e-05,21,9,12
23871,rich,0.0001343305226609934,0.00014510527637982858,179,80,99
23872,richer,1.9070323809907035e-05,8.79948762826546e-06,14,9,5
23873,richest,7.146132328767358e-05,7.781507686956326e-05,84,36,48
23874,rid,3.7931083621902995e-05,2.6053384938589907e-05,41,20,21
23875,ridding,6.496483935243052e-06,1.7253897310324457e-07,4,3,1
23876,riddle,4.400843956132392e-06,1.8979287041356905e-06,3,2,1
23877,riddled,2.3052039770217305e-06,1.8979287041356905e-06,3,2,1
23878,ride,5.050492349656699e-05,4.330728224891437e-05,55,27,28
23879,ridehailing,6.496483935243052e-06,8.79948762826546e-06,9,3,6
23880,rider,1.0687763893464371e-05,1.052487735929791e-05,15,8,7
23881,ridesharing,4.400843956132392e-06,3.6233184351681345e-06,4,2,2
23882,ridicule,1.48790438516857e-05,1.2250267090330355e-05,14,7,7
23883,ridiculed,2.3052039770217305e-06,7.074097897233022e-06,6,1,5
23884,ridiculou,2.116596378901769e-05,2.087721574549256e-05,26,12,14
23885,riding,4.400843956132392e-06,1.3975656821362803e-05,11,3,8
23886,rife,1.278340387257504e-05,3.6233184351681345e-06,11,7,4
23887,rifle,3.7931083621902995e-05,3.640572332478458e-05,42,19,23
23888,rift,1.6974683830796368e-05,2.087721574549256e-05,21,9,12
23889,rig,1.9070323809907035e-05,2.087721574549256e-05,25,12,13
23890,rigged,2.7452883726349685e-05,2.777877466962238e-05,31,15,16
23891,rigging,2.116596378901769e-05,8.79948762826546e-06,19,11,8
23892,right,0.001494400869103814,0.0015064377741644272,1793,803,990
23893,rightful,2.3052039770217305e-06,5.348708166200577e-06,4,1,3
23894,rightfully,2.3052039770217305e-06,3.6233184351681345e-06,5,2,3
23895,rightly,4.400843956132392e-06,3.6233184351681345e-06,4,2,2
23896,rights,6.496483935243052e-06,1.8979287041356905e-06,5,3,2
23897,righttodie,4.400843956132392e-06,3.6233184351681345e-06,5,3,2
23898,righttowork,2.095639979110664e-07,5.348708166200577e-06,3,0,3
23899,rightwing,4.6313643538345614e-05,7.436429740749831e-05,72,23,49
23900,rightwinger,2.095639979110664e-07,8.79948762826546e-06,5,0,5
23901,rigorou,4.400843956132392e-06,5.348708166200577e-06,6,2,4
23902,rile,4.400843956132392e-06,1.8979287041356905e-06,3,2,1
23903,ring,7.565260324589493e-05,6.918812821440096e-05,86,40,46
23904,ringing,8.592123914353715e-06,3.6233184351681345e-06,6,4,2
23905,ringleader,1.278340387257504e-05,1.8979287041356905e-06,8,6,2
23906,riot,0.00018672152213876006,0.00017616229153841266,207,92,115
23907,rioter,3.583544364279237e-05,1.9151826014460126e-05,37,21,16
23908,rioting,1.278340387257504e-05,1.3975656821362803e-05,15,7,8
23909,rip,2.954852370546031e-05,1.052487735929791e-05,23,15,8
23910,ripe,6.496483935243052e-06,3.6233184351681345e-06,5,3,2
23911,ripoff,4.400843956132392e-06,1.8979287041356905e-06,5,3,2
23912,ripped,2.5357243747239038e-05,1.9151826014460126e-05,25,13,12
23913,ripping,1.0687763893464371e-05,7.074097897233022e-06,9,5,4
23914,ripple,4.400843956132392e-06,7.074097897233022e-06,7,2,5
23915,rise,0.0002160604818463093,0.00027796028566932717,300,119,181
23916,risen,2.5357243747239038e-05,2.4327995207557487e-05,28,13,15
23917,rising,0.00011127848289077625,0.00013302754826260141,140,61,79
23918,risk,0.00031036428090628937,0.0003055665213658457,357,159,198
23919,risked,2.3052039770217305e-06,7.074097897233022e-06,5,1,4
23920,riskier,2.095639979110664e-07,5.348708166200577e-06,3,0,3
23921,risking,8.592123914353715e-06,1.3975656821362803e-05,13,5,8
23922,risky,1.48790438516857e-05,1.3975656821362803e-05,16,7,9
23923,rite,6.496483935243052e-06,5.348708166200577e-06,6,3,3
23924,ritual,1.0687763893464371e-05,2.777877466962238e-05,24,6,18
23925,rival,0.00010289592297433347,9.334358444885519e-05,118,55,63
23926,rivalry,4.400843956132392e-06,1.8979287041356905e-06,3,2,1
23927,riven,2.3052039770217305e-06,1.8979287041356905e-06,3,1,2
23928,river,6.307876337123095e-05,5.883578982820635e-05,73,32,41
23929,rn,8.592123914353715e-06,3.6233184351681345e-06,7,4,3
23930,rnand,2.3052039770217305e-06,3.6233184351681345e-06,4,1,3
23931,rnha,6.496483935243052e-06,1.8979287041356905e-06,5,3,2
23932,rnof,2.3052039770217305e-06,1.8979287041356905e-06,3,1,2
23933,rnthe,6.496483935243052e-06,3.6233184351681345e-06,5,3,2
23934,road,0.00012385232276544028,0.0001382037174556987,158,66,92
23935,roadblock,6.496483935243052e-06,1.052487735929791e-05,10,4,6
23936,roadmap,2.3052039770217305e-06,3.6233184351681345e-06,3,1,2
23937,roadside,8.592123914353715e-06,1.2250267090330355e-05,11,4,7
23938,roam,2.3052039770217305e-06,7.074097897233022e-06,5,1,4
23939,roamed,2.3052039770217305e-06,3.6233184351681345e-06,3,1,2
23940,roaming,1.48790438516857e-05,1.2250267090330355e-05,14,7,7
23941,roar,2.3052039770217305e-06,3.6233184351681345e-06,3,1,2
23942,roared,4.400843956132392e-06,3.6233184351681345e-06,4,2,2
23943,roasted,6.496483935243052e-06,1.8979287041356905e-06,5,4,1
23944,roasting,2.3052039770217305e-06,1.8979287041356905e-06,3,1,2
23945,rob,4.400843956132392e-06,7.074097897233022e-06,6,2,4
23946,robbed,8.592123914353715e-06,1.570104655239525e-05,15,4,11
23947,robber,1.9070323809907035e-05,1.2250267090330355e-05,17,9,8
23948,robbery,1.278340387257504e-05,1.570104655239525e-05,16,6,10
23949,robbing,8.592123914353715e-06,3.6233184351681345e-06,6,4,2
23950,robe,2.3052039770217305e-06,3.6233184351681345e-06,3,1,2
23951,robot,4.6313643538345614e-05,4.330728224891437e-05,51,24,27
23952,robotic,8.592123914353715e-06,3.6233184351681345e-06,7,5,2
23953,robust,6.496483935243052e-06,1.9151826014460126e-05,14,3,11
23954,rock,0.00011756540282810809,8.4716635793693e-05,114,59,55
23955,rocked,4.400843956132392e-06,1.9151826014460126e-05,15,3,12
23956,rocker,6.496483935243052e-06,1.8979287041356905e-06,4,3,1
23957,rocket,0.00015109564249387862,0.00016063378395912072,183,78,105
23958,rocketed,6.496483935243052e-06,1.7253897310324457e-07,3,3,0
23959,rocketpropelled,8.592123914353715e-06,1.7253897310324457e-07,4,4,0
23960,rocky,8.592123914353715e-06,1.2250267090330355e-05,11,4,7
23961,rod,1.0687763893464371e-05,1.742643628342769e-05,18,6,12
23962,rode,6.496483935243052e-06,3.6233184351681345e-06,6,3,3
23963,rodent,2.3052039770217305e-06,5.348708166200577e-06,4,1,3
23964,rogue,2.116596378901769e-05,1.742643628342769e-05,23,10,13
23965,roiling,2.095639979110664e-07,7.074097897233022e-06,5,1,4
23966,role,0.00028102532119873944,0.00026415716782106726,312,148,164
23967,roll,6.517440335034157e-05,4.50326719799468e-05,65,34,31
23968,rollback,2.3052039770217305e-06,3.6233184351681345e-06,3,1,2
23969,rolled,1.6974683830796368e-05,1.9151826014460126e-05,20,9,11
23970,roller,2.095639979110664e-07,7.074097897233022e-06,4,0,4
23971,rolling,2.954852370546031e-05,1.742643628342769e-05,27,15,12
23972,rollout,6.496483935243052e-06,1.052487735929791e-05,9,3,6
23973,romance,4.400843956132392e-06,1.8979287041356905e-06,4,2,2
23974,romantic,6.496483935243052e-06,1.8979287041356905e-06,4,3,1
23975,roof,3.1644163684570994e-05,1.742643628342769e-05,26,15,11
23976,rooftop,4.400843956132392e-06,1.3975656821362803e-05,10,2,8
23977,room,0.00010289592297433347,0.00011749904068330962,134,59,75
23978,root,4.840928351745632e-05,3.2954943862719716e-05,48,28,20
23979,rooted,1.278340387257504e-05,1.2250267090330355e-05,14,6,8
23980,rooting,2.095639979110664e-07,5.348708166200577e-06,4,1,3
23981,rope,1.0687763893464371e-05,7.074097897233022e-06,9,5,4
23982,rose,2.954852370546031e-05,3.640572332478458e-05,37,14,23
23983,rot,6.496483935243052e-06,5.348708166200577e-06,8,5,3
23984,rotation,6.496483935243052e-06,3.6233184351681345e-06,5,3,2
23985,rotten,1.278340387257504e-05,5.348708166200577e-06,11,7,4
23986,rotting,6.496483935243052e-06,5.348708166200577e-06,7,4,3
23987,rouble,8.592123914353715e-06,3.6233184351681345e-06,6,4,2
23988,rough,1.48790438516857e-05,1.2250267090330355e-05,16,8,8
23989,roughed,2.095639979110664e-07,1.8979287041356905e-06,3,1,2
23990,roughly,4.002672360101368e-05,4.50326719799468e-05,51,23,28
23991,round,7.774824322500554e-05,7.436429740749831e-05,83,38,45
23992,rounded,1.0687763893464371e-05,8.79948762826546e-06,10,5,5
23993,roundup,4.400843956132392e-06,3.6233184351681345e-06,5,3,2
23994,rout,4.400843956132392e-06,3.6233184351681345e-06,4,2,2
23995,route,6.307876337123095e-05,5.020884117304414e-05,63,31,32
23996,routed,2.3052039770217305e-06,3.6233184351681345e-06,3,1,2
23997,router,6.496483935243052e-06,1.052487735929791e-05,10,3,7
23998,routine,1.9070323809907035e-05,2.9504164400654783e-05,29,11,18
23999,routinely,2.326160376812834e-05,2.6053384938589907e-05,27,11,16
24000,rover,1.6974683830796368e-05,1.9151826014460126e-05,21,10,11
24001,row,0.00012385232276544028,0.00012267520987640663,145,69,76
24002,rowdy,2.3052039770217305e-06,3.6233184351681345e-06,3,1,2
24003,royal,4.6313643538345614e-05,5.020884117304414e-05,59,24,35
24004,royalty,6.496483935243052e-06,8.79948762826546e-06,10,4,6
24005,rubber,1.6974683830796368e-05,2.4327995207557487e-05,24,10,14
24006,rubbish,1.278340387257504e-05,1.2250267090330355e-05,13,6,7
24007,rubble,1.48790438516857e-05,1.052487735929791e-05,15,9,6
24008,ruble,8.592123914353715e-06,2.087721574549256e-05,18,6,12
24009,rude,8.592123914353715e-06,1.052487735929791e-05,10,4,6
24010,rug,2.3052039770217305e-06,3.6233184351681345e-06,3,1,2
24011,rugby,2.095639979110664e-07,5.348708166200577e-06,3,0,3
24012,rugged,2.3052039770217305e-06,3.6233184351681345e-06,3,1,2
24013,ruin,6.307876337123095e-05,3.2954943862719716e-05,53,31,22
24014,ruined,8.592123914353715e-06,8.79948762826546e-06,12,6,6
24015,ruining,2.3052039770217305e-06,1.2250267090330355e-05,8,1,7
24016,ruinou,4.400843956132392e-06,1.8979287041356905e-06,3,2,1
24017,rule,0.0004884936791306954,0.0005177894582828364,589,251,338
24018,ruled,0.00014061744259832545,0.0001589083942280881,175,70,105
24019,ruler,2.7452883726349685e-05,3.2954943862719716e-05,35,14,21
24020,ruling,0.00023282560167919462,0.0002296493732004186,276,122,154
24021,rumble,2.3052039770217305e-06,8.79948762826546e-06,6,1,5
24022,rumbling,2.3052039770217305e-06,3.6233184351681345e-06,3,1,2
24023,rumor,1.48790438516857e-05,2.4327995207557487e-05,22,8,14
24024,rumored,2.3052039770217305e-06,5.348708166200577e-06,4,1,3
24025,rumour,6.496483935243052e-06,1.742643628342769e-05,14,3,11
24026,run,0.0004277201197364861,0.0003245458084072032,433,219,214
24027,runaround,2.3052039770217305e-06,1.8979287041356905e-06,3,1,2
24028,runaway,6.496483935243052e-06,8.79948762826546e-06,9,3,6
24029,rundown,2.3052039770217305e-06,3.6233184351681345e-06,3,1,2
24030,runner,6.496483935243052e-06,1.2250267090330355e-05,13,5,8
24031,running,0.00023072996170008382,0.00024172710131764556,279,117,162
24032,runoff,1.6974683830796368e-05,1.3975656821362803e-05,17,9,8
24033,runup,1.278340387257504e-05,1.2250267090330355e-05,14,6,8
24034,runway,4.400843956132392e-06,1.7253897310324457e-07,5,3,2
24035,rupee,2.3052039770217305e-06,7.074097897233022e-06,5,1,4
24036,ruptured,4.400843956132392e-06,1.8979287041356905e-06,3,2,1
24037,rural,5.050492349656699e-05,7.091351794543343e-05,74,26,48
24038,ruse,4.400843956132392e-06,5.348708166200577e-06,7,2,5
24039,rush,3.583544364279237e-05,3.2954943862719716e-05,40,18,22
24040,rushed,1.48790438516857e-05,1.3975656821362803e-05,15,7,8
24041,rushing,1.48790438516857e-05,1.3975656821362803e-05,16,7,9
24042,russia,4.400843956132392e-06,5.348708166200577e-06,5,2,3
24043,russian,2.3052039770217305e-06,5.348708166200577e-06,4,1,3
24044,rusty,2.3052039770217305e-06,3.6233184351681345e-06,5,2,3
24045,ruthles,6.496483935243052e-06,1.2250267090330355e-05,12,3,9
24046,ruthlessly,2.3052039770217305e-06,1.8979287041356905e-06,3,1,2
24047,rworldnew,8.592123914353715e-06,8.79948762826546e-06,10,4,6
24048,sable,2.095639979110664e-07,1.8979287041356905e-06,3,1,2
24049,sabotage,1.6974683830796368e-05,2.4327995207557487e-05,23,9,14
24050,sabotaged,6.496483935243052e-06,3.6233184351681345e-06,7,3,4
24051,sabotaging,8.592123914353715e-06,7.074097897233022e-06,8,4,4
24052,sack,8.592123914353715e-06,1.9151826014460126e-05,16,4,12
24053,sacked,2.326160376812834e-05,2.4327995207557487e-05,30,11,19
24054,sacking,6.496483935243052e-06,1.8979287041356905e-06,4,3,1
24055,sacred,2.5357243747239038e-05,1.742643628342769e-05,23,12,11
24056,sacrifice,2.7452883726349685e-05,4.6758061710979285e-05,46,16,30
24057,sacrificed,2.116596378901769e-05,8.79948762826546e-06,17,11,6
24058,sacrificial,2.3052039770217305e-06,5.348708166200577e-06,4,1,3
24059,sacrosanct,6.496483935243052e-06,1.8979287041356905e-06,4,3,1
24060,sad,2.5357243747239038e-05,3.8131113055817005e-05,34,12,22
24061,saddened,4.400843956132392e-06,3.6233184351681345e-06,4,2,2
24062,saddest,6.496483935243052e-06,1.8979287041356905e-06,5,3,2
24063,sadistic,6.496483935243052e-06,1.7253897310324457e-07,4,3,1
24064,sadly,2.095639979110664e-07,1.052487735929791e-05,7,1,6
24065,sadnes,2.095639979110664e-07,5.348708166200577e-06,3,0,3
24066,safari,1.0687763893464371e-05,3.6233184351681345e-06,7,5,2
24067,safe,0.00016576512234765329,0.00011059748175917965,167,89,78
24068,safeguard,1.48790438516857e-05,1.9151826014460126e-05,19,7,12
24069,safeguarding,6.496483935243052e-06,3.6233184351681345e-06,5,3,2
24070,safely,6.496483935243052e-06,7.074097897233022e-06,9,4,5
24071,safer,4.6313643538345614e-05,2.9504164400654783e-05,44,24,20
24072,safest,1.278340387257504e-05,7.074097897233022e-06,11,6,5
24073,safety,0.00016786076232676425,0.00015373222503499084,183,90,93
24074,saga,6.496483935243052e-06,1.052487735929791e-05,10,3,7
24075,said,0.002787410736215091,0.00292815891253516,3379,1485,1894
24076,sail,2.326160376812834e-05,1.052487735929791e-05,20,12,8
24077,sailed,2.3052039770217305e-06,3.6233184351681345e-06,3,1,2
24078,sailing,1.0687763893464371e-05,5.348708166200577e-06,8,5,3
24079,sailor,3.1644163684570994e-05,2.087721574549256e-05,29,15,14
24080,saint,2.095639979110664e-07,7.074097897233022e-06,4,0,4
24081,sake,6.496483935243052e-06,1.2250267090330355e-05,14,4,10
24082,salad,4.400843956132392e-06,1.3975656821362803e-05,10,2,8
24083,salamander,4.400843956132392e-06,1.7253897310324457e-07,3,2,1
24084,salary,6.72700433294523e-05,6.228656929027126e-05,73,34,39
24085,sale,0.00018462588215964923,0.0002175716450831913,234,102,132
24086,salesman,6.496483935243052e-06,3.6233184351681345e-06,6,4,2
24087,salesperson,4.400843956132392e-06,1.052487735929791e-05,8,2,6
24088,salmon,1.0687763893464371e-05,1.3975656821362803e-05,13,5,8
24089,salon,2.3052039770217305e-06,3.6233184351681345e-06,3,1,2
24090,salt,1.6974683830796368e-05,1.052487735929791e-05,14,8,6
24091,salty,6.496483935243052e-06,1.8979287041356905e-06,4,3,1
24092,salute,1.9070323809907035e-05,2.087721574549256e-05,22,9,13
24093,salvation,4.400843956132392e-06,1.8979287041356905e-06,3,2,1
24094,sameday,2.095639979110664e-07,7.074097897233022e-06,4,0,4
24095,samesex,8.822644312055891e-05,6.918812821440096e-05,91,45,46
24096,sample,2.5357243747239038e-05,3.2954943862719716e-05,32,13,19
24097,samurai,2.3052039770217305e-06,3.6233184351681345e-06,4,1,3
24098,sanction,0.00022234740178364096,0.00016408456342118544,224,123,101
24099,sanctioned,4.400843956132392e-06,7.074097897233022e-06,6,2,4
24100,sanctioning,4.400843956132392e-06,5.348708166200577e-06,5,2,3
24101,sanctuary,3.3739803663681634e-05,3.122955413168725e-05,36,17,19
24102,sand,3.1644163684570994e-05,5.883578982820635e-05,51,16,35
24103,sandstone,4.400843956132392e-06,1.7253897310324457e-07,3,2,1
24104,sandwich,2.095639979110664e-07,8.79948762826546e-06,8,1,7
24105,sane,4.400843956132392e-06,3.6233184351681345e-06,6,2,4
24106,saner,4.400843956132392e-06,1.8979287041356905e-06,3,2,1
24107,sang,4.400843956132392e-06,3.6233184351681345e-06,4,2,2
24108,sanitary,4.400843956132392e-06,8.79948762826546e-06,7,2,5
24109,sanitation,4.400843956132392e-06,1.052487735929791e-05,8,2,6
24110,sanity,2.3052039770217305e-06,3.6233184351681345e-06,3,1,2
24111,sank,1.9070323809907035e-05,1.570104655239525e-05,19,10,9
24112,sarcasm,4.400843956132392e-06,1.8979287041356905e-06,3,2,1
24113,sarcastic,2.3052039770217305e-06,3.6233184351681345e-06,3,1,2
24114,sarcophagu,6.496483935243052e-06,1.7253897310324457e-07,4,3,1
24115,sardine,4.400843956132392e-06,7.074097897233022e-06,6,2,4
24116,sarin,4.400843956132392e-06,7.074097897233022e-06,7,3,4
24117,sat,3.1644163684570994e-05,1.052487735929791e-05,22,15,7
24118,satellite,0.00011756540282810809,9.334358444885519e-05,119,59,60
24119,satire,1.278340387257504e-05,1.8979287041356905e-06,7,6,1
24120,satirical,1.6974683830796368e-05,1.3975656821362803e-05,17,9,8
24121,satirist,2.3052039770217305e-06,7.074097897233022e-06,5,1,4
24122,satisfaction,6.496483935243052e-06,5.348708166200577e-06,6,3,3
24123,satisfied,6.496483935243052e-06,1.2250267090330355e-05,13,4,9
24124,satisfy,6.496483935243052e-06,3.6233184351681345e-06,5,3,2
24125,sauce,2.3052039770217305e-06,5.348708166200577e-06,4,1,3
24126,savage,1.278340387257504e-05,1.052487735929791e-05,12,6,6
24127,savagely,4.400843956132392e-06,1.8979287041356905e-06,4,3,1
24128,save,0.0002097735619089774,0.00022102242454525643,261,116,145
24129,saved,7.146132328767358e-05,6.918812821440096e-05,83,36,47
24130,saver,4.400843956132392e-06,8.79948762826546e-06,7,2,5
24131,saving,0.00014900000251476814,0.0001019705331040174,140,75,65
24132,savior,4.400843956132392e-06,3.6233184351681345e-06,4,2,2
24133,savor,2.3052039770217305e-06,1.8979287041356905e-06,3,1,2
24134,savvy,2.3052039770217305e-06,5.348708166200577e-06,5,1,4
24135,saw,9.870464301611217e-05,0.00011749904068330962,133,54,79
24136,say,0.004092994443201033,0.003947864243575336,4662,2125,2537
24137,saying,0.00031874684082273133,0.0003193696392141053,372,167,205
24138,scale,7.355696326678427e-05,8.299124606266055e-05,94,39,55
24139,scaled,2.095639979110664e-07,3.6233184351681345e-06,3,0,3
24140,scam,4.212236358012434e-05,2.2602605476525032e-05,43,26,17
24141,scammed,6.496483935243052e-06,5.348708166200577e-06,7,3,4
24142,scammer,8.592123914353715e-06,3.6233184351681345e-06,7,4,3
24143,scan,8.592123914353715e-06,1.2250267090330355e-05,11,4,7
24144,scandal,0.00024120816159563723,0.00020549391696596386,252,119,133
24145,scandalplagued,4.400843956132392e-06,1.8979287041356905e-06,3,2,1
24146,scanned,4.400843956132392e-06,5.348708166200577e-06,5,2,3
24147,scanner,1.9070323809907035e-05,3.122955413168725e-05,29,9,20
24148,scanning,8.592123914353715e-06,5.348708166200577e-06,7,4,3
24149,scapegoat,4.400843956132392e-06,1.2250267090330355e-05,9,2,7
24150,scar,4.400843956132392e-06,8.79948762826546e-06,8,2,6
24151,scarce,8.592123914353715e-06,3.6233184351681345e-06,7,4,3
24152,scarcity,2.095639979110664e-07,1.052487735929791e-05,7,0,7
24153,scare,2.5357243747239038e-05,2.087721574549256e-05,30,13,17
24154,scared,3.583544364279237e-05,3.2954943862719716e-05,37,18,19
24155,scarier,2.3052039770217305e-06,1.8979287041356905e-06,3,1,2
24156,scarlet,2.095639979110664e-07,5.348708166200577e-06,3,0,3
24157,scarred,2.095639979110664e-07,3.6233184351681345e-06,3,0,3
24158,scary,1.6974683830796368e-05,2.777877466962238e-05,26,9,17
24159,scathing,1.0687763893464371e-05,1.3975656821362803e-05,15,6,9
24160,scattered,8.592123914353715e-06,3.6233184351681345e-06,6,4,2
24161,scenario,1.48790438516857e-05,2.2602605476525032e-05,24,8,16
24162,scene,5.6791843433898893e-05,5.883578982820635e-05,74,34,40
24163,scenic,2.3052039770217305e-06,3.6233184351681345e-06,3,1,2
24164,scent,4.400843956132392e-06,1.8979287041356905e-06,3,2,1
24165,sceptic,1.278340387257504e-05,8.79948762826546e-06,12,6,6
24166,schedule,1.6974683830796368e-05,3.2954943862719716e-05,32,11,21
24167,scheduled,5.6791843433898893e-05,5.5385010366141504e-05,64,28,36
24168,scheme,5.888748341300963e-05,7.091351794543343e-05,76,32,44
24169,schism,6.496483935243052e-06,1.8979287041356905e-06,5,4,1
24170,schizophrenia,4.400843956132392e-06,3.6233184351681345e-06,4,2,2
24171,schizophrenic,2.095639979110664e-07,7.074097897233022e-06,4,0,4
24172,scholar,4.4218003559234974e-05,3.122955413168725e-05,42,22,20
24173,scholarly,2.3052039770217305e-06,3.6233184351681345e-06,3,1,2
24174,scholarship,2.095639979110664e-07,5.348708166200577e-06,3,0,3
24175,school,0.0006435710375848848,0.000628214401068913,753,339,414
24176,schoolboy,8.592123914353715e-06,5.348708166200577e-06,10,4,6
24177,schoolchildren,8.592123914353715e-06,7.074097897233022e-06,11,5,6
24178,schooler,4.400843956132392e-06,5.348708166200577e-06,5,2,3
24179,schoolgirl,4.002672360101368e-05,2.9504164400654783e-05,38,19,19
24180,schooling,8.592123914353715e-06,1.052487735929791e-05,10,4,6
24181,schooltoprison,2.095639979110664e-07,5.348708166200577e-06,5,1,4
24182,science,0.00011756540282810809,0.00014337988664879628,157,66,91
24183,scientific,6.517440335034157e-05,6.746273848336857e-05,77,34,43
24184,scientifically,2.095639979110664e-07,7.074097897233022e-06,5,0,5
24185,scientist,0.00033132068069739577,0.0003141934700210085,375,170,205
24186,scifi,4.400843956132392e-06,3.6233184351681345e-06,4,2,2
24187,scissors,4.400843956132392e-06,1.8979287041356905e-06,3,2,1
24188,sclerosi,4.400843956132392e-06,1.8979287041356905e-06,4,2,2
24189,scoff,4.400843956132392e-06,7.074097897233022e-06,6,2,4
24190,scold,2.3052039770217305e-06,3.6233184351681345e-06,3,1,2
24191,scoop,1.0687763893464371e-05,3.6233184351681345e-06,9,7,2
24192,scooter,6.496483935243052e-06,1.7253897310324457e-07,6,4,2
24193,scope,1.9070323809907035e-05,1.3975656821362803e-05,19,9,10
24194,score,7.565260324589493e-05,0.00010024514337298497,101,39,62
24195,scored,1.0687763893464371e-05,7.074097897233022e-06,9,5,4
24196,scoring,4.400843956132392e-06,3.6233184351681345e-06,4,2,2
24197,scorn,2.3052039770217305e-06,3.6233184351681345e-06,5,2,3
24198,scorned,6.496483935243052e-06,7.074097897233022e-06,7,3,4
24199,scorpion,2.3052039770217305e-06,5.348708166200577e-06,4,1,3
24200,scourge,6.496483935243052e-06,1.8979287041356905e-06,4,3,1
24201,scouring,4.400843956132392e-06,8.79948762826546e-06,7,2,5
24202,scout,2.3052039770217305e-06,7.074097897233022e-06,5,1,4
24203,scramble,2.326160376812834e-05,2.087721574549256e-05,23,11,12
24204,scrambled,8.592123914353715e-06,1.052487735929791e-05,12,4,8
24205,scrambling,1.48790438516857e-05,1.2250267090330355e-05,16,8,8
24206,scrap,1.9070323809907035e-05,5.3659620635109e-05,43,11,32
24207,scrapped,1.6974683830796368e-05,1.3975656821362803e-05,19,8,11
24208,scrapping,8.592123914353715e-06,1.052487735929791e-05,11,4,7
24209,scratch,6.496483935243052e-06,1.052487735929791e-05,11,5,6
24210,scratched,2.3052039770217305e-06,3.6233184351681345e-06,3,1,2
24211,scrawled,6.496483935243052e-06,1.7253897310324457e-07,4,4,0
24212,scream,8.592123914353715e-06,1.9151826014460126e-05,16,4,12
24213,screaming,8.592123914353715e-06,8.79948762826546e-06,10,5,5
24214,screen,2.326160376812834e-05,4.50326719799468e-05,40,13,27
24215,screened,4.400843956132392e-06,7.074097897233022e-06,6,2,4
24216,screening,1.48790438516857e-05,1.570104655239525e-05,17,7,10
24217,screw,4.400843956132392e-06,1.2250267090330355e-05,9,2,7
24218,screwed,1.48790438516857e-05,2.087721574549256e-05,20,7,13
24219,screwing,2.3052039770217305e-06,3.6233184351681345e-06,3,1,2
24220,script,1.278340387257504e-05,1.742643628342769e-05,17,7,10
24221,scroll,4.400843956132392e-06,8.79948762826546e-06,8,3,5
24222,scrub,2.3052039770217305e-06,3.6233184351681345e-06,3,1,2
24223,scrubbed,2.3052039770217305e-06,1.8979287041356905e-06,3,2,1
24224,scrutinized,4.400843956132392e-06,5.348708166200577e-06,6,3,3
24225,scrutiny,3.7931083621902995e-05,3.8131113055817005e-05,46,20,26
24226,scuba,4.400843956132392e-06,5.348708166200577e-06,7,2,5
24227,scuffle,4.400843956132392e-06,3.6233184351681345e-06,4,2,2
24228,sculpture,6.496483935243052e-06,7.074097897233022e-06,8,3,5
24229,scum,4.400843956132392e-06,3.6233184351681345e-06,5,3,2
24230,sea,0.0002097735619089774,0.00014683066611086105,206,108,98
24231,seabed,4.400843956132392e-06,5.348708166200577e-06,7,2,5
24232,seabird,2.3052039770217305e-06,1.8979287041356905e-06,4,3,1
24233,seafloor,2.095639979110664e-07,8.79948762826546e-06,5,0,5
24234,seafood,1.0687763893464371e-05,5.348708166200577e-06,9,6,3
24235,seal,4.002672360101368e-05,4.330728224891437e-05,46,19,27
24236,sealed,1.278340387257504e-05,2.087721574549256e-05,18,6,12
24237,sealing,4.400843956132392e-06,1.8979287041356905e-06,3,2,1
24238,seam,2.3052039770217305e-06,3.6233184351681345e-06,3,1,2
24239,search,0.00018881716211787043,0.00013302754826260141,187,101,86
24240,searched,1.9070323809907035e-05,1.3975656821362803e-05,17,9,8
24241,searching,2.7452883726349685e-05,2.4327995207557487e-05,29,13,16
24242,season,9.03220830996695e-05,0.0001036959228350498,112,48,64
24243,seasonal,6.496483935243052e-06,8.79948762826546e-06,8,3,5
24244,seasoned,6.496483935243052e-06,1.7253897310324457e-07,3,3,0
24245,seat,0.00011337412286988677,0.0001382037174556987,155,61,94
24246,seated,2.3052039770217305e-06,3.6233184351681345e-06,3,1,2
24247,seawater,8.592123914353715e-06,5.348708166200577e-06,8,5,3
24248,sec,8.592123914353715e-06,1.7253897310324457e-07,4,4,0
24249,secede,8.592123914353715e-06,5.348708166200577e-06,7,4,3
24250,secession,2.3052039770217305e-06,1.2250267090330355e-05,9,2,7
24251,second,0.00029779044103162505,0.0002900380137865542,349,157,192
24252,secondary,4.400843956132392e-06,1.052487735929791e-05,8,2,6
24253,secondbiggest,2.3052039770217305e-06,3.6233184351681345e-06,3,1,2
24254,secondclas,2.3052039770217305e-06,3.6233184351681345e-06,4,1,3
24255,seconddegree,2.3052039770217305e-06,3.6233184351681345e-06,3,1,2
24256,secondhighest,4.400843956132392e-06,1.8979287041356905e-06,3,2,1
24257,secondlargest,4.400843956132392e-06,8.79948762826546e-06,10,4,6
24258,secrecy,3.1644163684570994e-05,2.4327995207557487e-05,32,16,16
24259,secret,0.0003837116801751621,0.0004021883463036628,458,195,263
24260,secretary,0.00022863432172097337,0.0002141208656211263,256,117,139
24261,secretarygeneral,4.400843956132392e-06,1.7253897310324457e-07,3,3,0
24262,secretive,3.1644163684570994e-05,1.742643628342769e-05,27,16,11
24263,secretly,6.517440335034157e-05,6.228656929027126e-05,76,33,43
24264,sect,1.6974683830796368e-05,1.8979287041356905e-06,10,8,2
24265,sectarian,1.48790438516857e-05,1.2250267090330355e-05,15,7,8
24266,section,3.1644163684570994e-05,3.468033359375216e-05,36,15,21
24267,sector,5.6791843433898893e-05,7.954046660059569e-05,83,32,51
24268,secular,2.7452883726349685e-05,2.9504164400654783e-05,32,13,19
24269,secularism,4.400843956132392e-06,3.6233184351681345e-06,4,2,2
24270,secularist,4.400843956132392e-06,3.6233184351681345e-06,5,3,2
24271,secure,7.565260324589493e-05,6.918812821440096e-05,80,36,44
24272,secured,1.0687763893464371e-05,5.348708166200577e-06,9,6,3
24273,securing,8.592123914353715e-06,5.348708166200577e-06,10,7,3
24274,security,0.0005848931181697859,0.0005350433555931611,656,303,353
24275,sedan,2.095639979110664e-07,5.348708166200577e-06,3,0,3
24276,sediment,2.095639979110664e-07,5.348708166200577e-06,3,0,3
24277,sedition,2.3052039770217305e-06,1.8979287041356905e-06,3,1,2
24278,see,0.0005534585184831261,0.0006109605037585886,684,299,385
24279,seed,2.7452883726349685e-05,3.640572332478458e-05,37,13,24
24280,seeding,4.400843956132392e-06,1.8979287041356905e-06,3,2,1
24281,seeing,4.840928351745632e-05,6.056117955923882e-05,69,28,41
24282,seek,0.00024539944155385846,0.00022619859373835345,272,127,145
24283,seeker,4.6313643538345614e-05,5.1934230904076595e-05,60,28,32
24284,seeking,0.00012175668278632962,0.00011404826122124471,135,64,71
24285,seem,0.0003355119606556169,0.0003003903521727485,376,178,198
24286,seemed,4.002672360101368e-05,5.3659620635109e-05,55,22,33
24287,seemingly,1.9070323809907035e-05,2.9504164400654783e-05,28,9,19
24288,seen,0.00028521660115696105,0.00033834892625546234,374,155,219
24289,seeping,8.592123914353715e-06,3.6233184351681345e-06,6,4,2
24290,segment,1.6974683830796368e-05,1.3975656821362803e-05,19,9,10
24291,segregated,6.496483935243052e-06,5.348708166200577e-06,6,3,3
24292,segregation,6.496483935243052e-06,1.9151826014460126e-05,15,3,12
24293,seismic,8.592123914353715e-06,3.6233184351681345e-06,7,5,2
24294,seismologist,4.400843956132392e-06,3.6233184351681345e-06,4,2,2
24295,seize,0.00010499156295344414,0.00014165449691776373,143,54,89
24296,seized,0.00010918284291166549,8.299124606266055e-05,117,56,61
24297,seizing,4.400843956132392e-06,1.742643628342769e-05,13,3,10
24298,seizure,3.1644163684570994e-05,1.9151826014460126e-05,28,17,11
24299,seldom,4.400843956132392e-06,7.074097897233022e-06,6,2,4
24300,select,1.6974683830796368e-05,8.79948762826546e-06,14,8,6
24301,selected,8.592123914353715e-06,8.79948762826546e-06,11,5,6
24302,selecting,4.400843956132392e-06,3.6233184351681345e-06,5,2,3
24303,selection,8.592123914353715e-06,1.3975656821362803e-05,14,5,9
24304,selective,4.400843956132392e-06,1.8979287041356905e-06,3,2,1
24305,self,3.1644163684570994e-05,2.777877466962238e-05,35,15,20
24306,selfaggrandizing,4.400843956132392e-06,1.8979287041356905e-06,3,2,1
24307,selfaware,2.3052039770217305e-06,3.6233184351681345e-06,3,1,2
24308,selfawarenes,2.095639979110664e-07,7.074097897233022e-06,4,0,4
24309,selfcensorship,2.3052039770217305e-06,5.348708166200577e-06,5,2,3
24310,selfcontrol,2.095639979110664e-07,3.6233184351681345e-06,3,0,3
24311,selfdefence,2.095639979110664e-07,7.074097897233022e-06,4,0,4
24312,selfdefense,8.592123914353715e-06,1.2250267090330355e-05,13,4,9
24313,selfdeportation,4.400843956132392e-06,1.8979287041356905e-06,3,2,1
24314,selfdescribed,6.496483935243052e-06,7.074097897233022e-06,9,4,5
24315,selfdetermination,4.400843956132392e-06,1.8979287041356905e-06,3,2,1
24316,selfdriving,8.592123914353715e-06,1.3975656821362803e-05,13,5,8
24317,selfemployed,4.400843956132392e-06,3.6233184351681345e-06,4,2,2
24318,selfevident,4.400843956132392e-06,3.6233184351681345e-06,4,2,2
24319,selfhelp,2.095639979110664e-07,3.6233184351681345e-06,3,0,3
24320,selfie,1.0687763893464371e-05,5.348708166200577e-06,8,5,3
24321,selfimmolation,4.400843956132392e-06,1.570104655239525e-05,12,2,10
24322,selfimposed,4.400843956132392e-06,1.8979287041356905e-06,3,2,1
24323,selfinterest,6.496483935243052e-06,3.6233184351681345e-06,5,3,2
24324,selfish,2.095639979110664e-07,7.074097897233022e-06,5,0,5
24325,selfles,4.400843956132392e-06,3.6233184351681345e-06,4,2,2
24326,selfproclaimed,6.496483935243052e-06,8.79948762826546e-06,10,4,6
24327,selfrespect,6.496483935243052e-06,1.7253897310324457e-07,3,3,0
24328,selfrule,2.3052039770217305e-06,5.348708166200577e-06,4,1,3
24329,selfserving,2.095639979110664e-07,3.6233184351681345e-06,3,0,3
24330,selfstyled,2.3052039770217305e-06,3.6233184351681345e-06,4,1,3
24331,selfsufficient,2.3052039770217305e-06,3.6233184351681345e-06,3,1,2
24332,selfy,6.496483935243052e-06,1.8979287041356905e-06,5,4,1
24333,sell,0.00013642616264010403,0.00013130215853156914,161,78,83
24334,seller,1.0687763893464371e-05,5.348708166200577e-06,11,5,6
24335,selling,0.00012804360272366158,0.00010542131256608228,129,63,66
24336,selloff,4.400843956132392e-06,1.8979287041356905e-06,3,2,1
24337,seman,8.592123914353715e-06,5.348708166200577e-06,7,4,3
24338,semiautomatic,2.3052039770217305e-06,5.348708166200577e-06,5,1,4
24339,seminar,2.3052039770217305e-06,5.348708166200577e-06,5,1,4
24340,sen,2.3052039770217305e-06,1.052487735929791e-05,8,2,6
24341,senate,2.3052039770217305e-06,2.087721574549256e-05,15,2,13
24342,senator,0.0003208424808018424,0.00036595516195198134,416,175,241
24343,senatorelect,2.095639979110664e-07,5.348708166200577e-06,3,0,3
24344,send,0.0002537820014703013,0.00022274781427628854,287,136,151
24345,sending,0.00010289592297433347,9.679436391092026e-05,130,63,67
24346,senior,0.0001825302421805385,0.0001951415785797695,218,98,120
24347,sensation,2.3052039770217305e-06,7.074097897233022e-06,6,2,4
24348,sensational,2.3052039770217305e-06,1.8979287041356905e-06,3,1,2
24349,sense,0.00013642616264010403,0.00011922443041434203,150,76,74
24350,senseles,4.400843956132392e-06,3.6233184351681345e-06,6,3,3
24351,sensible,1.48790438516857e-05,3.6233184351681345e-06,11,8,3
24352,sensitive,3.7931083621902995e-05,2.2602605476525032e-05,35,18,17
24353,sensor,6.496483935243052e-06,8.79948762826546e-06,8,3,5
24354,sensory,2.3052039770217305e-06,5.348708166200577e-06,4,1,3
24355,sent,0.00019929536201342395,0.00019341618884873702,228,104,124
24356,sentence,0.00019510408205520246,0.00017443690180738014,229,109,120
24357,sentenced,0.00023072996170008382,0.0002141208656211263,262,118,144
24358,sentencing,1.6974683830796368e-05,2.087721574549256e-05,21,8,13
24359,sentiment,3.583544364279237e-05,2.777877466962238e-05,34,17,17
24360,separate,4.6313643538345614e-05,4.6758061710979285e-05,55,22,33
24361,separated,4.400843956132392e-06,1.052487735929791e-05,8,2,6
24362,separately,6.496483935243052e-06,5.348708166200577e-06,6,3,3
24363,separation,2.7452883726349685e-05,1.052487735929791e-05,21,14,7
24364,separatism,4.400843956132392e-06,1.8979287041356905e-06,3,2,1
24365,separatist,2.326160376812834e-05,5.883578982820635e-05,55,17,38
24366,sequel,2.3052039770217305e-06,3.6233184351681345e-06,3,1,2
24367,sequenced,4.400843956132392e-06,3.6233184351681345e-06,4,2,2
24368,serf,2.7452883726349685e-05,2.777877466962238e-05,31,14,17
24369,sergeant,6.496483935243052e-06,7.074097897233022e-06,8,3,5
24370,serial,2.5357243747239038e-05,1.3975656821362803e-05,20,12,8
24371,series,0.00011756540282810809,0.00012612598933847184,146,65,81
24372,seriou,0.00020348664197164515,0.0001968669683108019,233,110,123
24373,serious,2.095639979110664e-07,5.348708166200577e-06,3,0,3
24374,seriously,6.72700433294523e-05,6.746273848336857e-05,79,33,46
24375,seriousnes,2.095639979110664e-07,5.348708166200577e-06,5,1,4
24376,sermon,2.095639979110664e-07,7.074097897233022e-06,4,0,4
24377,servant,4.002672360101368e-05,2.4327995207557487e-05,34,19,15
24378,serve,0.00010499156295344414,0.00010024514337298497,119,54,65
24379,served,5.6791843433898893e-05,7.436429740749831e-05,77,33,44
24380,server,4.840928351745632e-05,4.50326719799468e-05,52,26,26
24381,service,0.0004004768000080476,0.0004643023766208308,505,211,294
24382,serviceman,8.592123914353715e-06,7.074097897233022e-06,9,4,5
24383,servicer,4.400843956132392e-06,3.6233184351681345e-06,4,2,2
24384,servicing,2.3052039770217305e-06,3.6233184351681345e-06,3,1,2
24385,serving,6.307876337123095e-05,5.5385010366141504e-05,68,33,35
24386,servitude,6.496483935243052e-06,3.6233184351681345e-06,6,3,3
24387,session,4.212236358012434e-05,3.468033359375216e-05,47,22,25
24388,set,0.0005827974781906751,0.0005954319961792964,695,306,389
24389,setback,1.6974683830796368e-05,2.6053384938589907e-05,25,10,15
24390,setting,7.774824322500554e-05,6.401195902130366e-05,82,40,42
24391,settle,3.583544364279237e-05,3.985650278684949e-05,44,17,27
24392,settled,6.496483935243052e-06,1.9151826014460126e-05,17,4,13
24393,settlement,0.00020139100199253443,0.0002020431375038992,242,109,133
24394,settler,8.822644312055891e-05,0.00010887209202814718,118,48,70
24395,settling,6.496483935243052e-06,8.79948762826546e-06,9,3,6
24396,setup,8.592123914353715e-06,5.348708166200577e-06,7,4,3
24397,seven,0.0001385218026192147,0.0001571830044970555,177,76,101
24398,sevenfigure,6.496483935243052e-06,1.7253897310324457e-07,3,3,0
24399,seventh,1.9070323809907035e-05,8.79948762826546e-06,14,9,5
24400,sevenweek,2.3052039770217305e-06,5.348708166200577e-06,4,1,3
24401,sevenyear,1.0687763893464371e-05,7.074097897233022e-06,9,5,4
24402,sevenyearold,2.3052039770217305e-06,5.348708166200577e-06,7,2,5
24403,sever,4.400843956132392e-06,7.074097897233022e-06,6,2,4
24404,several,0.00023072996170008382,0.0002313747629314509,268,123,145
24405,severance,8.592123914353715e-06,3.6233184351681345e-06,6,4,2
24406,severe,6.517440335034157e-05,7.781507686956326e-05,82,34,48
24407,severed,1.0687763893464371e-05,8.79948762826546e-06,10,5,5
24408,severely,4.212236358012434e-05,2.6053384938589907e-05,38,22,16
24409,sew,2.3052039770217305e-06,3.6233184351681345e-06,3,1,2
24410,sewage,1.0687763893464371e-05,1.052487735929791e-05,13,7,6
24411,sewer,4.400843956132392e-06,7.074097897233022e-06,6,2,4
24412,sewn,2.3052039770217305e-06,5.348708166200577e-06,4,1,3
24413,sex,0.0003899986001124942,0.0003090173008279106,407,203,204
24414,sexism,4.400843956132392e-06,1.3975656821362803e-05,14,2,12
24415,sexist,1.48790438516857e-05,1.570104655239525e-05,18,7,11
24416,sexselective,4.400843956132392e-06,1.7253897310324457e-07,3,3,0
24417,sexslave,4.400843956132392e-06,1.8979287041356905e-06,3,2,1
24418,sexual,0.0002663558413449654,0.00026760794728313193,318,143,175
24419,sexuality,6.496483935243052e-06,5.348708166200577e-06,6,3,3
24420,sexually,6.098312339212028e-05,8.989280498679035e-05,88,31,57
24421,sexy,2.3052039770217305e-06,5.348708166200577e-06,4,1,3
24422,shack,4.400843956132392e-06,1.8979287041356905e-06,3,2,1
24423,shackled,2.3052039770217305e-06,3.6233184351681345e-06,4,1,3
24424,shade,2.3052039770217305e-06,5.348708166200577e-06,5,1,4
24425,shadow,2.7452883726349685e-05,3.122955413168725e-05,34,15,19
24426,shadowy,2.3052039770217305e-06,3.6233184351681345e-06,3,1,2
24427,shady,6.496483935243052e-06,7.074097897233022e-06,8,4,4
24428,shaft,2.3052039770217305e-06,7.074097897233022e-06,6,2,4
24429,shake,2.7452883726349685e-05,2.6053384938589907e-05,32,15,17
24430,shaken,6.496483935243052e-06,8.79948762826546e-06,10,4,6
24431,shakeup,4.400843956132392e-06,5.348708166200577e-06,7,3,4
24432,shaking,1.48790438516857e-05,1.742643628342769e-05,17,7,10
24433,shaky,2.3052039770217305e-06,3.6233184351681345e-06,3,1,2
24434,shale,1.0687763893464371e-05,1.3975656821362803e-05,14,6,8
24435,shall,6.496483935243052e-06,1.570104655239525e-05,16,6,10
24436,shallow,2.3052039770217305e-06,3.6233184351681345e-06,3,1,2
24437,sham,8.592123914353715e-06,8.79948762826546e-06,10,4,6
24438,shamble,6.496483935243052e-06,1.8979287041356905e-06,4,3,1
24439,shame,4.4218003559234974e-05,4.50326719799468e-05,51,25,26
24440,shamed,8.592123914353715e-06,5.348708166200577e-06,8,5,3
24441,shameful,1.6974683830796368e-05,1.052487735929791e-05,15,9,6
24442,shamelessly,6.496483935243052e-06,5.348708166200577e-06,6,3,3
24443,shaming,2.095639979110664e-07,8.79948762826546e-06,6,0,6
24444,shape,3.7931083621902995e-05,3.2954943862719716e-05,43,23,20
24445,shaped,6.496483935243052e-06,8.79948762826546e-06,9,4,5
24446,shaping,1.48790438516857e-05,1.570104655239525e-05,18,7,11
24447,shard,2.3052039770217305e-06,3.6233184351681345e-06,3,1,2
24448,share,0.00021396484186719832,0.0001951415785797695,242,117,125
24449,shared,5.6791843433898893e-05,6.918812821440096e-05,78,33,45
24450,shareholder,2.7452883726349685e-05,2.6053384938589907e-05,29,13,16
24451,sharer,2.095639979110664e-07,5.348708166200577e-06,3,0,3
24452,sharia,8.592123914353715e-06,1.2250267090330355e-05,13,5,8
24453,sharing,4.840928351745632e-05,6.746273848336857e-05,72,27,45
24454,shark,5.6791843433898893e-05,5.883578982820635e-05,65,29,36
24455,sharp,2.954852370546031e-05,1.9151826014460126e-05,27,14,13
24456,sharply,3.1644163684570994e-05,3.2954943862719716e-05,38,18,20
24457,shatter,2.3052039770217305e-06,3.6233184351681345e-06,6,2,4
24458,shattered,4.400843956132392e-06,3.6233184351681345e-06,5,2,3
24459,shattering,2.3052039770217305e-06,1.8979287041356905e-06,3,1,2
24460,shave,8.592123914353715e-06,7.074097897233022e-06,8,4,4
24461,shaving,2.095639979110664e-07,8.79948762826546e-06,5,0,5
24462,she,8.592123914353715e-06,2.087721574549256e-05,16,4,12
24463,shed,3.3739803663681634e-05,2.4327995207557487e-05,34,18,16
24464,shedding,2.3052039770217305e-06,1.8979287041356905e-06,3,1,2
24465,sheep,1.48790438516857e-05,1.2250267090330355e-05,16,9,7
24466,sheer,1.0687763893464371e-05,8.79948762826546e-06,11,6,5
24467,sheet,8.592123914353715e-06,1.3975656821362803e-05,12,4,8
24468,sheikh,2.095639979110664e-07,5.348708166200577e-06,3,0,3
24469,shekel,6.496483935243052e-06,1.8979287041356905e-06,4,3,1
24470,shelf,2.326160376812834e-05,1.570104655239525e-05,21,12,9
24471,shell,6.098312339212028e-05,5.020884117304414e-05,71,39,32
24472,shelled,6.496483935243052e-06,1.052487735929791e-05,11,4,7
24473,shelling,2.7452883726349685e-05,1.9151826014460126e-05,28,14,14
24474,shelter,5.888748341300963e-05,4.1581892517881935e-05,56,30,26
24475,sheltered,4.400843956132392e-06,1.8979287041356905e-06,3,2,1
24476,sheltering,2.095639979110664e-07,5.348708166200577e-06,3,0,3
24477,shelve,2.3052039770217305e-06,1.8979287041356905e-06,3,1,2
24478,shelved,6.496483935243052e-06,1.7253897310324457e-07,3,3,0
24479,shepherd,2.095639979110664e-07,7.074097897233022e-06,5,1,4
24480,sheriff,2.954852370546031e-05,1.9151826014460126e-05,31,18,13
24481,shield,5.260056347567764e-05,5.3659620635109e-05,62,29,33
24482,shielding,2.3052039770217305e-06,5.348708166200577e-06,4,1,3
24483,shift,8.613080314144832e-05,0.0001019705331040174,108,44,64
24484,shifted,1.6974683830796368e-05,1.570104655239525e-05,19,9,10
24485,shifting,2.7452883726349685e-05,1.570104655239525e-05,22,13,9
24486,shine,8.592123914353715e-06,7.074097897233022e-06,10,5,5
24487,shining,4.400843956132392e-06,1.052487735929791e-05,9,3,6
24488,shiny,4.400843956132392e-06,1.052487735929791e-05,8,2,6
24489,ship,0.00027892968121962896,0.00029176340351758643,341,146,195
24490,shipment,3.1644163684570994e-05,2.9504164400654783e-05,39,17,22
24491,shipped,6.496483935243052e-06,5.348708166200577e-06,8,5,3
24492,shipping,2.116596378901769e-05,1.570104655239525e-05,21,11,10
24493,shipwreck,1.48790438516857e-05,8.79948762826546e-06,12,7,5
24494,shirt,2.116596378901769e-05,8.79948762826546e-06,15,10,5
24495,shit,1.9070323809907035e-05,2.4327995207557487e-05,25,9,16
24496,shithole,4.400843956132392e-06,1.8979287041356905e-06,4,2,2
24497,shitty,4.400843956132392e-06,1.8979287041356905e-06,3,2,1
24498,shiver,4.400843956132392e-06,7.074097897233022e-06,6,2,4
24499,shoal,6.496483935243052e-06,1.8979287041356905e-06,4,3,1
24500,shock,7.146132328767358e-05,6.573734875233614e-05,80,36,44
24501,shocked,3.7931083621902995e-05,2.9504164400654783e-05,41,21,20
24502,shocking,3.7931083621902995e-05,5.020884117304414e-05,52,20,32
24503,shoddy,2.3052039770217305e-06,7.074097897233022e-06,5,1,4
24504,shoe,4.4218003559234974e-05,4.330728224891437e-05,53,27,26
24505,shoethrower,4.400843956132392e-06,1.7253897310324457e-07,3,3,0
24506,shook,4.400843956132392e-06,1.052487735929791e-05,8,2,6
24507,shoot,9.660900303700153e-05,0.00010887209202814718,118,49,69
24508,shooter,2.326160376812834e-05,2.4327995207557487e-05,29,13,16
24509,shooting,0.00024959072151208,0.0002848618445934566,322,133,189
24510,shootout,1.0687763893464371e-05,5.348708166200577e-06,11,5,6
24511,shoottokill,2.3052039770217305e-06,3.6233184351681345e-06,4,1,3
24512,shop,6.936568330856297e-05,8.299124606266055e-05,90,40,50
24513,shopkeeper,6.496483935243052e-06,7.074097897233022e-06,7,3,4
24514,shoplifting,2.3052039770217305e-06,3.6233184351681345e-06,3,1,2
24515,shopped,2.3052039770217305e-06,3.6233184351681345e-06,3,1,2
24516,shopper,1.0687763893464371e-05,3.122955413168725e-05,29,8,21
24517,shopping,7.146132328767358e-05,6.401195902130366e-05,75,35,40
24518,shore,2.326160376812834e-05,2.2602605476525032e-05,25,12,13
24519,short,0.0002747384012614078,0.0002607063883590024,320,149,171
24520,shortage,6.307876337123095e-05,6.746273848336857e-05,73,33,40
24521,shortcoming,2.3052039770217305e-06,7.074097897233022e-06,5,1,4
24522,shortened,4.400843956132392e-06,1.8979287041356905e-06,3,2,1
24523,shorter,8.592123914353715e-06,5.348708166200577e-06,7,4,3
24524,shortfall,6.496483935243052e-06,7.074097897233022e-06,8,3,5
24525,shortlist,2.095639979110664e-07,5.348708166200577e-06,3,0,3
24526,shortlived,2.3052039770217305e-06,3.6233184351681345e-06,5,2,3
24527,shortly,2.5357243747239038e-05,2.6053384938589907e-05,32,15,17
24528,shortrange,4.400843956132392e-06,8.79948762826546e-06,10,2,8
24529,shortterm,1.48790438516857e-05,1.052487735929791e-05,15,8,7
24530,shot,0.0004696329193186995,0.0003935613976485007,513,250,263
24531,shotgun,4.400843956132392e-06,3.6233184351681345e-06,4,2,2
24532,shoulder,1.278340387257504e-05,1.570104655239525e-05,15,6,9
24533,shouldn,2.5357243747239038e-05,1.2250267090330355e-05,21,13,8
24534,shout,4.400843956132392e-06,1.570104655239525e-05,11,2,9
24535,shouted,1.0687763893464371e-05,8.79948762826546e-06,10,5,5
24536,shouting,1.278340387257504e-05,2.2602605476525032e-05,23,7,16
24537,shoved,4.400843956132392e-06,3.6233184351681345e-06,5,2,3
24538,shovel,8.592123914353715e-06,3.6233184351681345e-06,6,4,2
24539,show,0.0008573263154541722,0.0008456135071790013,1006,448,558
24540,showcase,4.400843956132392e-06,3.6233184351681345e-06,5,3,2
24541,showdown,1.48790438516857e-05,1.2250267090330355e-05,15,7,8
24542,showed,7.984388320411623e-05,8.126585633162811e-05,98,44,54
24543,shower,8.592123914353715e-06,2.4327995207557487e-05,19,5,14
24544,showing,0.00010708720293255492,0.00012612598933847184,138,58,80
24545,shown,4.002672360101368e-05,4.50326719799468e-05,57,26,31
24546,shrank,4.400843956132392e-06,1.8979287041356905e-06,5,3,2
24547,shrapnel,6.496483935243052e-06,1.8979287041356905e-06,5,3,2
24548,shredded,4.400843956132392e-06,3.6233184351681345e-06,4,2,2
24549,shrimp,2.3052039770217305e-06,1.052487735929791e-05,7,1,6
24550,shrine,1.6974683830796368e-05,1.052487735929791e-05,16,8,8
24551,shrink,1.278340387257504e-05,1.052487735929791e-05,14,8,6
24552,shrinking,8.592123914353715e-06,1.9151826014460126e-05,17,5,12
24553,shrouded,4.400843956132392e-06,7.074097897233022e-06,6,2,4
24554,shrug,2.3052039770217305e-06,5.348708166200577e-06,5,1,4
24555,shrugged,2.095639979110664e-07,5.348708166200577e-06,3,0,3
24556,shrunk,4.400843956132392e-06,8.79948762826546e-06,7,2,5
24557,sht,4.400843956132392e-06,1.8979287041356905e-06,3,2,1
24558,shun,4.400843956132392e-06,1.052487735929791e-05,8,2,6
24559,shunned,8.592123914353715e-06,1.8979287041356905e-06,5,4,1
24560,shut,0.0001783389622223174,0.00018651462992460717,213,90,123
24561,shutdown,6.098312339212028e-05,5.711040009717395e-05,70,32,38
24562,shutter,2.3052039770217305e-06,3.6233184351681345e-06,3,1,2
24563,shuttered,2.3052039770217305e-06,5.348708166200577e-06,4,1,3
24564,shutting,1.0687763893464371e-05,1.3975656821362803e-05,15,5,10
24565,shuttle,4.400843956132392e-06,7.074097897233022e-06,6,2,4
24566,shy,4.400843956132392e-06,1.2250267090330355e-05,11,4,7
24567,sibling,1.48790438516857e-05,3.6233184351681345e-06,11,7,4
24568,sick,7.565260324589493e-05,5.883578982820635e-05,76,38,38
24569,sickened,1.278340387257504e-05,5.348708166200577e-06,10,7,3
24570,sickening,4.400843956132392e-06,7.074097897233022e-06,7,3,4
24571,sicknes,1.278340387257504e-05,3.6233184351681345e-06,11,8,3
24572,side,0.0002055822819507562,0.0002313747629314509,255,111,144
24573,sided,2.3052039770217305e-06,1.8979287041356905e-06,3,2,1
24574,sideline,1.6974683830796368e-05,7.074097897233022e-06,13,8,5
24575,sidestep,8.592123914353715e-06,1.7253897310324457e-07,6,4,2
24576,sidewalk,4.400843956132392e-06,1.052487735929791e-05,8,2,6
24577,siding,4.400843956132392e-06,1.3975656821362803e-05,10,2,8
24578,siege,4.002672360101368e-05,2.777877466962238e-05,39,23,16
24579,sigh,4.400843956132392e-06,1.2250267090330355e-05,10,3,7
24580,sight,4.4218003559234974e-05,5.3659620635109e-05,62,24,38
24581,sighted,6.496483935243052e-06,1.7253897310324457e-07,3,3,0
24582,sighting,1.278340387257504e-05,5.348708166200577e-06,10,6,4
24583,sightseeing,2.3052039770217305e-06,5.348708166200577e-06,4,1,3
24584,sign,0.000348085800530281,0.0003159188597520407,390,186,204
24585,signal,7.355696326678427e-05,5.711040009717395e-05,77,38,39
24586,signaled,1.48790438516857e-05,1.052487735929791e-05,15,8,7
24587,signaling,4.400843956132392e-06,5.348708166200577e-06,6,3,3
24588,signalling,4.400843956132392e-06,1.8979287041356905e-06,3,2,1
24589,signatory,2.3052039770217305e-06,5.348708166200577e-06,5,1,4
24590,signature,4.4218003559234974e-05,3.468033359375216e-05,42,22,20
24591,signed,0.00013013924270277222,0.0001347529379936339,157,66,91
24592,signer,2.3052039770217305e-06,3.6233184351681345e-06,3,1,2
24593,significance,4.400843956132392e-06,3.6233184351681345e-06,6,3,3
24594,significant,0.00010080028299522283,9.679436391092026e-05,123,52,71
24595,significantly,2.7452883726349685e-05,3.468033359375216e-05,44,16,28
24596,signing,2.5357243747239038e-05,2.6053384938589907e-05,33,15,18
24597,signoff,2.3052039770217305e-06,3.6233184351681345e-06,3,1,2
24598,signup,6.496483935243052e-06,1.7253897310324457e-07,4,3,1
24599,silence,5.260056347567764e-05,6.573734875233614e-05,69,28,41
24600,silenced,6.496483935243052e-06,1.570104655239525e-05,14,5,9
24601,silencer,2.095639979110664e-07,7.074097897233022e-06,4,0,4
24602,silencing,8.592123914353715e-06,3.6233184351681345e-06,7,4,3
24603,silent,5.260056347567764e-05,3.8131113055817005e-05,52,25,27
24604,silently,2.095639979110664e-07,5.348708166200577e-06,3,0,3
24605,silly,6.496483935243052e-06,1.052487735929791e-05,11,3,8
24606,silo,2.3052039770217305e-06,3.6233184351681345e-06,3,1,2
24607,silver,2.5357243747239038e-05,2.2602605476525032e-05,27,12,15
24608,similar,0.0001343305226609934,8.126585633162811e-05,123,67,56
24609,similarity,4.400843956132392e-06,8.79948762826546e-06,7,2,5
24610,similarly,4.400843956132392e-06,5.348708166200577e-06,5,2,3
24611,simmering,1.0687763893464371e-05,1.8979287041356905e-06,6,5,1
24612,simple,0.00010918284291166549,0.0001019705331040174,121,55,66
24613,simplest,2.3052039770217305e-06,1.8979287041356905e-06,3,2,1
24614,simplicity,2.3052039770217305e-06,3.6233184351681345e-06,3,1,2
24615,simplified,6.496483935243052e-06,3.6233184351681345e-06,5,3,2
24616,simplify,2.3052039770217305e-06,7.074097897233022e-06,5,1,4
24617,simplistic,2.3052039770217305e-06,7.074097897233022e-06,6,1,5
24618,simply,0.00013642616264010403,0.00012094982014537423,151,74,77
24619,simulated,2.095639979110664e-07,7.074097897233022e-06,5,0,5
24620,simulation,4.400843956132392e-06,5.348708166200577e-06,5,2,3
24621,simultaneou,2.3052039770217305e-06,5.348708166200577e-06,4,1,3
24622,simultaneously,1.9070323809907035e-05,2.2602605476525032e-05,23,9,14
24623,sin,1.48790438516857e-05,2.6053384938589907e-05,24,8,16
24624,since,0.0006791969172297656,0.0007179346670825999,812,357,455
24625,sincere,6.496483935243052e-06,1.8979287041356905e-06,5,3,2
24626,sincerely,6.496483935243052e-06,1.7253897310324457e-07,3,3,0
24627,sinful,6.496483935243052e-06,1.7253897310324457e-07,3,3,0
24628,sing,2.3052039770217305e-06,1.9151826014460126e-05,13,1,12
24629,singer,3.3739803663681634e-05,3.640572332478458e-05,43,20,23
24630,singing,1.6974683830796368e-05,1.742643628342769e-05,20,9,11
24631,single,0.0001762433222432067,0.0001847892401935746,208,93,115
24632,singled,8.592123914353715e-06,1.3975656821362803e-05,15,6,9
24633,singlehandedly,2.3052039770217305e-06,3.6233184351681345e-06,3,1,2
24634,singlepayer,4.400843956132392e-06,8.79948762826546e-06,8,2,6
24635,sinister,4.400843956132392e-06,7.074097897233022e-06,6,2,4
24636,sink,3.583544364279237e-05,3.985650278684949e-05,41,17,24
24637,sinking,2.116596378901769e-05,2.6053384938589907e-05,28,10,18
24638,sip,2.3052039770217305e-06,5.348708166200577e-06,4,1,3
24639,siphoned,6.496483935243052e-06,1.7253897310324457e-07,3,3,0
24640,siphoning,4.400843956132392e-06,3.6233184351681345e-06,4,2,2
24641,sir,6.496483935243052e-06,5.348708166200577e-06,6,3,3
24642,siren,6.496483935243052e-06,8.79948762826546e-06,10,3,7
24643,sister,7.355696326678427e-05,3.2954943862719716e-05,59,36,23
24644,sisterinlaw,2.3052039770217305e-06,3.6233184351681345e-06,4,1,3
24645,sit,4.840928351745632e-05,7.608968713853079e-05,74,27,47
24646,sitdown,2.3052039770217305e-06,5.348708166200577e-06,4,1,3
24647,site,0.0003648509203631662,0.00032799658786926807,400,190,210
24648,sitin,1.0687763893464371e-05,8.79948762826546e-06,11,5,6
24649,sitting,4.4218003559234974e-05,4.8483451442011706e-05,56,25,31
24650,situation,0.0001343305226609934,0.00016063378395912072,177,71,106
24651,six,0.00024120816159563723,0.00025725560889693777,291,125,166
24652,sixday,4.400843956132392e-06,3.6233184351681345e-06,4,2,2
24653,sixfigure,2.3052039770217305e-06,7.074097897233022e-06,5,1,4
24654,sixhour,4.400843956132392e-06,5.348708166200577e-06,6,3,3
24655,sixmonth,2.3052039770217305e-06,8.79948762826546e-06,6,1,5
24656,sixth,8.592123914353715e-06,1.742643628342769e-05,18,7,11
24657,sixyear,4.400843956132392e-06,3.6233184351681345e-06,5,3,2
24658,sixyearold,2.3052039770217305e-06,5.348708166200577e-06,4,1,3
24659,sizable,4.400843956132392e-06,3.6233184351681345e-06,5,2,3
24660,size,7.565260324589493e-05,7.954046660059569e-05,93,41,52
24661,sized,2.3052039770217305e-06,3.6233184351681345e-06,3,1,2
24662,skate,2.095639979110664e-07,3.6233184351681345e-06,3,1,2
24663,skeleton,1.278340387257504e-05,1.3975656821362803e-05,16,7,9
24664,skeptic,8.592123914353715e-06,7.074097897233022e-06,8,4,4
24665,skeptical,2.7452883726349685e-05,1.3975656821362803e-05,23,14,9
24666,skepticism,8.592123914353715e-06,1.2250267090330355e-05,14,4,10
24667,sketch,6.496483935243052e-06,5.348708166200577e-06,6,3,3
24668,sketchy,4.400843956132392e-06,1.8979287041356905e-06,3,2,1
24669,skewed,2.3052039770217305e-06,3.6233184351681345e-06,4,2,2
24670,skewered,2.3052039770217305e-06,3.6233184351681345e-06,3,1,2
24671,ski,2.116596378901769e-05,8.79948762826546e-06,16,10,6
24672,skier,2.3052039770217305e-06,1.8979287041356905e-06,3,1,2
24673,skill,4.4218003559234974e-05,6.228656929027126e-05,69,26,43
24674,skilled,8.592123914353715e-06,7.074097897233022e-06,9,4,5
24675,skillful,2.3052039770217305e-06,3.6233184351681345e-06,3,1,2
24676,skim,4.400843956132392e-06,3.6233184351681345e-06,4,2,2
24677,skin,4.6313643538345614e-05,2.9504164400654783e-05,42,24,18
24678,skinhead,4.400843956132392e-06,5.348708166200577e-06,5,2,3
24679,skinned,4.400843956132392e-06,1.8979287041356905e-06,5,2,3
24680,skinny,8.592123914353715e-06,3.6233184351681345e-06,6,4,2
24681,skip,8.592123914353715e-06,7.074097897233022e-06,9,5,4
24682,skipped,6.496483935243052e-06,3.6233184351681345e-06,5,3,2
24683,skipping,1.0687763893464371e-05,3.6233184351681345e-06,7,5,2
24684,skirmish,4.400843956132392e-06,5.348708166200577e-06,5,2,3
24685,skirt,8.592123914353715e-06,7.074097897233022e-06,10,5,5
24686,skull,1.48790438516857e-05,1.570104655239525e-05,18,8,10
24687,sky,4.212236358012434e-05,2.6053384938589907e-05,37,21,16
24688,skyhigh,2.095639979110664e-07,7.074097897233022e-06,4,0,4
24689,skyrocket,4.400843956132392e-06,7.074097897233022e-06,6,2,4
24690,skyrocketed,2.3052039770217305e-06,1.052487735929791e-05,8,2,6
24691,skyscraper,1.278340387257504e-05,1.570104655239525e-05,16,7,9
24692,slack,2.3052039770217305e-06,3.6233184351681345e-06,4,1,3
24693,slacker,4.400843956132392e-06,1.8979287041356905e-06,3,2,1
24694,slain,2.5357243747239038e-05,3.2954943862719716e-05,32,13,19
24695,slam,6.098312339212028e-05,6.056117955923882e-05,68,32,36
24696,slammed,3.1644163684570994e-05,3.468033359375216e-05,40,17,23
24697,slamming,4.400843956132392e-06,7.074097897233022e-06,6,2,4
24698,slander,4.400843956132392e-06,1.7253897310324457e-07,3,2,1
24699,slap,1.0687763893464371e-05,2.777877466962238e-05,21,5,16
24700,slapped,8.592123914353715e-06,2.087721574549256e-05,19,6,13
24701,slapping,4.400843956132392e-06,7.074097897233022e-06,7,3,4
24702,slash,2.326160376812834e-05,3.122955413168725e-05,30,11,19
24703,slashed,8.592123914353715e-06,1.742643628342769e-05,15,4,11
24704,slashing,8.592123914353715e-06,1.052487735929791e-05,13,5,8
24705,slate,1.0687763893464371e-05,1.8979287041356905e-06,7,6,1
24706,slated,1.278340387257504e-05,1.3975656821362803e-05,15,7,8
24707,slaughter,3.7931083621902995e-05,3.122955413168725e-05,42,20,22
24708,slaughtered,1.6974683830796368e-05,2.087721574549256e-05,23,10,13
24709,slaughterhouse,2.3052039770217305e-06,7.074097897233022e-06,7,1,6
24710,slave,6.936568330856297e-05,6.918812821440096e-05,79,34,45
24711,slavelike,2.3052039770217305e-06,1.8979287041356905e-06,5,1,4
24712,slavery,3.583544364279237e-05,5.883578982820635e-05,57,21,36
24713,slaying,2.3052039770217305e-06,8.79948762826546e-06,6,1,5
24714,sledgehammer,4.400843956132392e-06,1.7253897310324457e-07,4,2,2
24715,sleep,5.260056347567764e-05,4.330728224891437e-05,56,27,29
24716,sleeping,3.583544364279237e-05,2.4327995207557487e-05,34,17,17
24717,sleepy,4.400843956132392e-06,1.8979287041356905e-06,3,2,1
24718,slept,2.095639979110664e-07,5.348708166200577e-06,3,0,3
24719,sleuth,2.3052039770217305e-06,1.8979287041356905e-06,3,1,2
24720,slew,8.592123914353715e-06,1.2250267090330355e-05,14,5,9
24721,slice,2.095639979110664e-07,1.570104655239525e-05,11,1,10
24722,sliced,6.496483935243052e-06,3.6233184351681345e-06,5,3,2
24723,slick,8.592123914353715e-06,5.348708166200577e-06,7,4,3
24724,slid,4.400843956132392e-06,3.6233184351681345e-06,4,2,2
24725,slide,2.116596378901769e-05,1.742643628342769e-05,22,12,10
24726,sliding,4.400843956132392e-06,7.074097897233022e-06,6,2,4
24727,slight,6.496483935243052e-06,5.348708166200577e-06,8,3,5
24728,slightly,1.6974683830796368e-05,1.570104655239525e-05,17,8,9
24729,slim,4.400843956132392e-06,1.8979287041356905e-06,4,2,2
24730,slip,2.7452883726349685e-05,1.3975656821362803e-05,25,15,10
24731,slipped,2.3052039770217305e-06,8.79948762826546e-06,7,1,6
24732,slippery,4.400843956132392e-06,1.8979287041356905e-06,3,2,1
24733,slipping,2.095639979110664e-07,7.074097897233022e-06,5,1,4
24734,slit,2.3052039770217305e-06,3.6233184351681345e-06,4,1,3
24735,slogan,1.48790438516857e-05,2.9504164400654783e-05,25,7,18
24736,slope,6.496483935243052e-06,5.348708166200577e-06,6,3,3
24737,slot,1.0687763893464371e-05,5.348708166200577e-06,9,5,4
24738,slow,7.565260324589493e-05,5.020884117304414e-05,70,37,33
24739,slowdown,1.0687763893464371e-05,1.8979287041356905e-06,7,5,2
24740,slowed,6.496483935243052e-06,7.074097897233022e-06,7,3,4
24741,slower,8.592123914353715e-06,7.074097897233022e-06,8,4,4
24742,slowest,2.3052039770217305e-06,3.6233184351681345e-06,3,1,2
24743,slowing,1.278340387257504e-05,1.3975656821362803e-05,15,7,8
24744,slowly,2.116596378901769e-05,3.8131113055817005e-05,37,12,25
24745,sludge,8.592123914353715e-06,1.2250267090330355e-05,13,4,9
24746,slug,2.095639979110664e-07,1.8979287041356905e-06,4,0,4
24747,slum,1.9070323809907035e-05,1.3975656821362803e-05,18,10,8
24748,slumber,2.3052039770217305e-06,1.8979287041356905e-06,3,1,2
24749,slump,2.3052039770217305e-06,2.087721574549256e-05,14,2,12
24750,slur,8.592123914353715e-06,7.074097897233022e-06,8,4,4
24751,slush,4.400843956132392e-06,3.6233184351681345e-06,4,2,2
24752,smack,4.400843956132392e-06,7.074097897233022e-06,6,2,4
24753,small,0.00020139100199253443,0.0002520794397038401,273,108,165
24754,smaller,2.954852370546031e-05,3.2954943862719716e-05,40,18,22
24755,smallest,1.48790438516857e-05,8.79948762826546e-06,13,8,5
24756,smallpox,2.3052039770217305e-06,3.6233184351681345e-06,3,1,2
24757,smallscale,4.400843956132392e-06,3.6233184351681345e-06,4,2,2
24758,smalltown,4.400843956132392e-06,1.8979287041356905e-06,3,2,1
24759,smart,5.050492349656699e-05,5.883578982820635e-05,64,26,38
24760,smarter,4.400843956132392e-06,1.2250267090330355e-05,9,2,7
24761,smartest,2.095639979110664e-07,7.074097897233022e-06,4,0,4
24762,smartphone,4.212236358012434e-05,3.468033359375216e-05,42,20,22
24763,smash,1.278340387257504e-05,1.2250267090330355e-05,13,6,7
24764,smashed,1.9070323809907035e-05,1.052487735929791e-05,17,11,6
24765,smashing,6.496483935243052e-06,1.3975656821362803e-05,11,3,8
24766,smear,1.278340387257504e-05,1.052487735929791e-05,14,6,8
24767,smeared,6.496483935243052e-06,5.348708166200577e-06,6,3,3
24768,smell,1.278340387257504e-05,1.742643628342769e-05,18,6,12
24769,smelter,2.095639979110664e-07,1.8979287041356905e-06,3,0,3
24770,smile,2.954852370546031e-05,1.570104655239525e-05,26,16,10
24771,smiled,2.3052039770217305e-06,1.7253897310324457e-07,3,1,2
24772,smiling,8.592123914353715e-06,1.2250267090330355e-05,12,5,7
24773,smog,3.1644163684570994e-05,1.9151826014460126e-05,28,17,11
24774,smoke,4.6313643538345614e-05,3.985650278684949e-05,50,24,26
24775,smoked,2.3052039770217305e-06,1.052487735929791e-05,7,1,6
24776,smoker,2.326160376812834e-05,1.052487735929791e-05,19,12,7
24777,smoking,4.4218003559234974e-05,6.401195902130366e-05,65,23,42
24778,smooth,4.400843956132392e-06,1.052487735929791e-05,9,3,6
24779,smoothly,2.3052039770217305e-06,3.6233184351681345e-06,5,2,3
24780,smothering,2.3052039770217305e-06,3.6233184351681345e-06,3,1,2
24781,smuggle,1.6974683830796368e-05,1.570104655239525e-05,21,9,12
24782,smuggled,2.326160376812834e-05,2.9504164400654783e-05,29,11,18
24783,smuggler,2.5357243747239038e-05,2.087721574549256e-05,27,14,13
24784,smuggling,2.954852370546031e-05,4.8483451442011706e-05,48,17,31
24785,snack,6.496483935243052e-06,5.348708166200577e-06,6,3,3
24786,snag,4.400843956132392e-06,1.8979287041356905e-06,3,2,1
24787,snail,2.095639979110664e-07,3.6233184351681345e-06,3,0,3
24788,snake,1.278340387257504e-05,1.570104655239525e-05,18,8,10
24789,snap,2.116596378901769e-05,8.79948762826546e-06,16,10,6
24790,snapped,2.3052039770217305e-06,3.6233184351681345e-06,3,1,2
24791,snapper,2.095639979110664e-07,3.6233184351681345e-06,3,1,2
24792,snapshot,6.496483935243052e-06,3.6233184351681345e-06,5,3,2
24793,snatch,2.3052039770217305e-06,3.6233184351681345e-06,5,2,3
24794,snatched,2.3052039770217305e-06,1.052487735929791e-05,7,1,6
24795,snatching,2.3052039770217305e-06,3.6233184351681345e-06,3,1,2
24796,sneak,1.0687763893464371e-05,8.79948762826546e-06,11,6,5
24797,sneaker,4.400843956132392e-06,1.8979287041356905e-06,3,2,1
24798,sneaking,8.592123914353715e-06,3.6233184351681345e-06,7,5,2
24799,sniffing,4.400843956132392e-06,1.7253897310324457e-07,3,2,1
24800,sniper,3.583544364279237e-05,2.9504164400654783e-05,39,19,20
24801,snoop,1.278340387257504e-05,1.7253897310324457e-07,6,6,0
24802,snooped,6.496483935243052e-06,1.7253897310324457e-07,3,3,0
24803,snooper,2.3052039770217305e-06,3.6233184351681345e-06,4,2,2
24804,snooping,2.116596378901769e-05,1.3975656821362803e-05,18,10,8
24805,snow,1.9070323809907035e-05,2.4327995207557487e-05,25,10,15
24806,snowball,4.400843956132392e-06,5.348708166200577e-06,6,3,3
24807,snowfall,2.3052039770217305e-06,1.8979287041356905e-06,3,1,2
24808,snowmobile,4.400843956132392e-06,1.8979287041356905e-06,3,2,1
24809,snowy,2.3052039770217305e-06,3.6233184351681345e-06,3,1,2
24810,snub,1.0687763893464371e-05,8.79948762826546e-06,12,6,6
24811,snuck,2.3052039770217305e-06,1.8979287041356905e-06,3,2,1
24812,snuff,4.400843956132392e-06,1.8979287041356905e-06,4,2,2
24813,snuggle,4.400843956132392e-06,3.6233184351681345e-06,4,2,2
24814,so,2.3052039770217305e-06,3.6233184351681345e-06,4,2,2
24815,soak,4.400843956132392e-06,1.8979287041356905e-06,3,2,1
24816,soaked,4.400843956132392e-06,1.7253897310324457e-07,3,3,0
24817,soap,8.592123914353715e-06,8.79948762826546e-06,9,4,5
24818,soapbox,2.095639979110664e-07,1.8979287041356905e-06,3,1,2
24819,soar,3.1644163684570994e-05,2.777877466962238e-05,31,15,16
24820,soared,1.0687763893464371e-05,7.074097897233022e-06,10,6,4
24821,soaring,1.0687763893464371e-05,2.777877466962238e-05,24,7,17
24822,sobering,4.400843956132392e-06,7.074097897233022e-06,6,2,4
24823,socalled,4.002672360101368e-05,5.711040009717395e-05,56,20,36
24824,soccer,4.4218003559234974e-05,2.9504164400654783e-05,40,21,19
24825,social,0.00035437272046761313,0.00036250438248991657,432,195,237
24826,socialism,2.3052039770217305e-06,5.348708166200577e-06,5,1,4
24827,socialist,1.9070323809907035e-05,1.2250267090330355e-05,20,10,10
24828,socially,6.496483935243052e-06,3.6233184351681345e-06,6,4,2
24829,societal,1.0687763893464371e-05,1.052487735929791e-05,12,5,7
24830,society,0.00019929536201342395,0.0001520068353039585,212,109,103
24831,socioeconomic,8.592123914353715e-06,8.79948762826546e-06,9,4,5
24832,sociologist,4.400843956132392e-06,1.8979287041356905e-06,3,2,1
24833,sock,6.496483935243052e-06,5.348708166200577e-06,6,3,3
24834,soda,6.496483935243052e-06,8.79948762826546e-06,9,3,6
24835,sodium,4.400843956132392e-06,1.8979287041356905e-06,3,2,1
24836,sodomy,2.3052039770217305e-06,7.074097897233022e-06,5,1,4
24837,soft,1.9070323809907035e-05,2.2602605476525032e-05,23,10,13
24838,soften,2.095639979110664e-07,5.348708166200577e-06,4,0,4
24839,softened,4.400843956132392e-06,1.8979287041356905e-06,3,2,1
24840,softening,2.3052039770217305e-06,3.6233184351681345e-06,3,1,2
24841,softer,2.095639979110664e-07,5.348708166200577e-06,4,0,4
24842,software,5.6791843433898893e-05,6.573734875233614e-05,73,32,41
24843,soil,4.002672360101368e-05,3.122955413168725e-05,42,22,20
24844,solace,2.3052039770217305e-06,5.348708166200577e-06,4,1,3
24845,solar,0.0001825302421805385,0.00014165449691776373,185,93,92
24846,sold,0.00014900000251476814,0.00012267520987640663,158,80,78
24847,soldier,0.0004528677994858143,0.0004246184128070847,512,227,285
24848,sole,1.278340387257504e-05,2.087721574549256e-05,19,7,12
24849,solely,1.9070323809907035e-05,1.2250267090330355e-05,18,10,8
24850,solemn,2.3052039770217305e-06,5.348708166200577e-06,5,2,3
24851,solicitation,4.400843956132392e-06,1.8979287041356905e-06,3,2,1
24852,solicited,2.3052039770217305e-06,3.6233184351681345e-06,3,1,2
24853,soliciting,6.496483935243052e-06,3.6233184351681345e-06,5,3,2
24854,solid,1.9070323809907035e-05,2.6053384938589907e-05,27,10,17
24855,solidarity,3.583544364279237e-05,4.330728224891437e-05,45,19,26
24856,solitary,1.48790438516857e-05,2.2602605476525032e-05,21,7,14
24857,solo,6.496483935243052e-06,5.348708166200577e-06,7,3,4
24858,solstice,6.496483935243052e-06,1.8979287041356905e-06,4,3,1
24859,solution,0.00013223488268188294,0.0001485560558418934,163,70,93
24860,solve,5.260056347567764e-05,5.020884117304414e-05,56,25,31
24861,solved,1.48790438516857e-05,1.3975656821362803e-05,17,8,9
24862,solvent,2.095639979110664e-07,5.348708166200577e-06,3,0,3
24863,solver,6.496483935243052e-06,1.7253897310324457e-07,3,3,0
24864,solving,1.6974683830796368e-05,1.052487735929791e-05,16,8,8
24865,somber,2.3052039770217305e-06,8.79948762826546e-06,6,1,5
24866,somebody,2.7452883726349685e-05,1.9151826014460126e-05,27,16,11
24867,someday,2.3052039770217305e-06,5.348708166200577e-06,4,1,3
24868,somehow,1.0687763893464371e-05,2.4327995207557487e-05,22,7,15
24869,someone,0.0001783389622223174,0.00021239547589009395,223,92,131
24870,someplace,6.496483935243052e-06,1.8979287041356905e-06,4,3,1
24871,something,0.00029779044103162505,0.00031074269055894344,358,155,203
24872,sometime,7.355696326678427e-05,6.918812821440096e-05,87,41,46
24873,somewhat,1.278340387257504e-05,2.087721574549256e-05,22,7,15
24874,somewhere,2.116596378901769e-05,2.4327995207557487e-05,26,10,16
24875,son,0.0002097735619089774,0.0002400017115866128,271,113,158
24876,sonar,2.3052039770217305e-06,1.8979287041356905e-06,3,2,1
24877,song,3.1644163684570994e-05,5.020884117304414e-05,54,18,36
24878,sonic,2.3052039770217305e-06,1.8979287041356905e-06,3,1,2
24879,soninlaw,1.278340387257504e-05,2.2602605476525032e-05,19,6,13
24880,soon,0.00018672152213876006,0.00018824001965563945,220,96,124
24881,sooner,1.0687763893464371e-05,2.087721574549256e-05,19,6,13
24882,sophisticated,1.6974683830796368e-05,2.777877466962238e-05,27,9,18
24883,sophistication,2.3052039770217305e-06,3.6233184351681345e-06,4,1,3
24884,sorcery,1.48790438516857e-05,1.052487735929791e-05,13,7,6
24885,sore,2.3052039770217305e-06,1.8979287041356905e-06,3,1,2
24886,sorrow,2.095639979110664e-07,1.052487735929791e-05,7,1,6
24887,sorry,3.583544364279237e-05,3.985650278684949e-05,46,20,26
24888,sort,4.6313643538345614e-05,4.330728224891437e-05,61,29,32
24889,sought,5.4696203454788295e-05,7.436429740749831e-05,73,28,45
24890,soul,1.48790438516857e-05,1.2250267090330355e-05,14,7,7
24891,sound,9.870464301611217e-05,0.00010887209202814718,117,48,69
24892,sounded,1.48790438516857e-05,2.2602605476525032e-05,23,7,16
24893,soup,1.0687763893464371e-05,1.3975656821362803e-05,14,6,8
24894,sour,8.592123914353715e-06,3.6233184351681345e-06,7,4,3
24895,source,0.00020348664197164515,0.00019341618884873702,239,110,129
24896,sourcing,4.400843956132392e-06,5.348708166200577e-06,5,2,3
24897,soured,2.3052039770217305e-06,1.8979287041356905e-06,3,1,2
24898,south,4.6313643538345614e-05,4.6758061710979285e-05,55,26,29
24899,southeast,2.116596378901769e-05,1.052487735929791e-05,22,11,11
24900,southeastern,2.3052039770217305e-06,1.052487735929791e-05,11,4,7
24901,southern,0.00011966104280721883,0.0001347529379936339,144,62,82
24902,southwest,8.592123914353715e-06,1.570104655239525e-05,14,5,9
24903,southwestern,6.496483935243052e-06,1.052487735929791e-05,10,4,6
24904,sovereign,5.4696203454788295e-05,2.6053384938589907e-05,42,26,16
24905,sovereignty,4.002672360101368e-05,2.2602605476525032e-05,37,21,16
24906,sow,2.3052039770217305e-06,7.074097897233022e-06,6,2,4
24907,soybean,6.496483935243052e-06,1.8979287041356905e-06,5,3,2
24908,spa,4.400843956132392e-06,5.348708166200577e-06,5,2,3
24909,space,0.00018881716211787043,0.00020721930669699654,233,99,134
24910,spacecraft,2.5357243747239038e-05,1.9151826014460126e-05,27,15,12
24911,spaceship,2.3052039770217305e-06,3.6233184351681345e-06,5,2,3
24912,spacewalk,4.400843956132392e-06,5.348708166200577e-06,5,2,3
24913,spam,4.400843956132392e-06,3.6233184351681345e-06,4,2,2
24914,span,1.0687763893464371e-05,1.3975656821362803e-05,14,6,8
24915,spanish,2.095639979110664e-07,7.074097897233022e-06,4,0,4
24916,spanning,1.278340387257504e-05,1.7253897310324457e-07,7,6,1
24917,spare,2.954852370546031e-05,1.742643628342769e-05,27,16,11
24918,spared,4.400843956132392e-06,7.074097897233022e-06,10,4,6
24919,spark,4.6313643538345614e-05,6.056117955923882e-05,62,23,39
24920,sparked,6.517440335034157e-05,5.5385010366141504e-05,70,35,35
24921,sparking,1.9070323809907035e-05,2.4327995207557487e-05,26,11,15
24922,sparring,2.095639979110664e-07,3.6233184351681345e-06,3,0,3
24923,spat,6.496483935243052e-06,7.074097897233022e-06,8,4,4
24924,spate,1.278340387257504e-05,1.3975656821362803e-05,15,7,8
24925,spawned,4.400843956132392e-06,1.8979287041356905e-06,3,2,1
24926,speak,0.00015109564249387862,0.0001951415785797695,207,82,125
24927,speaker,0.00010289592297433347,9.851975364195259e-05,112,51,61
24928,speaking,9.451336305789087e-05,6.746273848336857e-05,90,48,42
24929,spear,8.592123914353715e-06,7.074097897233022e-06,8,4,4
24930,spearheading,2.3052039770217305e-06,5.348708166200577e-06,5,1,4
24931,special,0.0002181561218254202,0.00020549391696596386,252,116,136
24932,specialist,6.496483935243052e-06,7.074097897233022e-06,10,4,6
24933,specialized,4.400843956132392e-06,1.8979287041356905e-06,3,2,1
24934,specie,0.00011966104280721883,9.334358444885519e-05,116,60,56
24935,specific,4.002672360101368e-05,3.2954943862719716e-05,38,19,19
24936,specifically,3.583544364279237e-05,3.122955413168725e-05,38,18,20
24937,specify,4.400843956132392e-06,5.348708166200577e-06,5,2,3
24938,speciman,2.3052039770217305e-06,5.348708166200577e-06,4,1,3
24939,speck,4.400843956132392e-06,1.7253897310324457e-07,3,3,0
24940,spectacle,2.3052039770217305e-06,8.79948762826546e-06,6,1,5
24941,spectacular,1.0687763893464371e-05,2.2602605476525032e-05,21,6,15
24942,spectator,2.095639979110664e-07,7.074097897233022e-06,5,0,5
24943,specter,6.496483935243052e-06,3.6233184351681345e-06,7,4,3
24944,spectre,6.496483935243052e-06,1.8979287041356905e-06,4,3,1
24945,spectrum,8.592123914353715e-06,1.742643628342769e-05,14,4,10
24946,speculate,4.400843956132392e-06,1.7253897310324457e-07,5,3,2
24947,speculated,6.496483935243052e-06,7.074097897233022e-06,7,3,4
24948,speculating,8.592123914353715e-06,5.348708166200577e-06,7,4,3
24949,speculation,2.116596378901769e-05,3.122955413168725e-05,30,11,19
24950,speculative,4.400843956132392e-06,1.2250267090330355e-05,9,2,7
24951,speculator,4.400843956132392e-06,7.074097897233022e-06,6,2,4
24952,speech,0.00032503376076006407,0.0002538048294348729,345,172,173
24953,speechles,6.496483935243052e-06,1.8979287041356905e-06,4,3,1
24954,speed,6.936568330856297e-05,5.020884117304414e-05,74,38,36
24955,speedier,6.496483935243052e-06,1.8979287041356905e-06,4,3,1
24956,speeding,1.278340387257504e-05,1.052487735929791e-05,13,7,6
24957,speedy,2.095639979110664e-07,7.074097897233022e-06,4,0,4
24958,spell,1.48790438516857e-05,1.570104655239525e-05,18,7,11
24959,spelling,6.496483935243052e-06,1.052487735929791e-05,11,3,8
24960,spend,0.0001343305226609934,0.00015373222503499084,174,71,103
24961,spender,4.400843956132392e-06,8.79948762826546e-06,8,2,6
24962,spending,0.00019091280209698145,0.00019859235804183437,223,98,125
24963,spent,0.00015947820241032126,0.00020376852723493182,215,82,133
24964,sperm,8.592123914353715e-06,8.79948762826546e-06,14,6,8
24965,spew,6.496483935243052e-06,5.348708166200577e-06,8,4,4
24966,spewed,2.3052039770217305e-06,1.8979287041356905e-06,3,1,2
24967,spewing,4.400843956132392e-06,3.6233184351681345e-06,6,3,3
24968,sphere,6.496483935243052e-06,3.6233184351681345e-06,5,3,2
24969,spider,8.592123914353715e-06,1.052487735929791e-05,11,4,7
24970,spied,3.1644163684570994e-05,2.6053384938589907e-05,37,18,19
24971,spike,1.9070323809907035e-05,2.087721574549256e-05,23,9,14
24972,spiked,2.3052039770217305e-06,7.074097897233022e-06,8,2,6
24973,spill,0.00011127848289077625,9.334358444885519e-05,121,58,63
24974,spilled,1.278340387257504e-05,5.348708166200577e-06,10,7,3
24975,spilling,1.48790438516857e-05,5.348708166200577e-06,10,7,3
24976,spin,2.954852370546031e-05,1.2250267090330355e-05,24,16,8
24977,spinal,4.400843956132392e-06,5.348708166200577e-06,9,4,5
24978,spine,2.095639979110664e-07,5.348708166200577e-06,4,1,3
24979,spinning,2.3052039770217305e-06,8.79948762826546e-06,7,1,6
24980,spiral,1.0687763893464371e-05,1.742643628342769e-05,17,6,11
24981,spiraling,2.3052039770217305e-06,5.348708166200577e-06,4,1,3
24982,spirit,3.7931083621902995e-05,3.122955413168725e-05,37,19,18
24983,spiritual,1.9070323809907035e-05,1.3975656821362803e-05,19,10,9
24984,spite,1.278340387257504e-05,1.3975656821362803e-05,14,6,8
24985,spitting,2.3052039770217305e-06,3.6233184351681345e-06,4,1,3
24986,splashed,4.400843956132392e-06,1.8979287041356905e-06,3,2,1
24987,split,6.098312339212028e-05,6.746273848336857e-05,70,29,41
24988,splitting,2.3052039770217305e-06,1.052487735929791e-05,8,1,7
24989,spoil,6.496483935243052e-06,7.074097897233022e-06,7,3,4
24990,spoiled,2.095639979110664e-07,3.6233184351681345e-06,3,0,3
24991,spoiler,6.496483935243052e-06,1.8979287041356905e-06,5,4,1
24992,spoke,7.355696326678427e-05,7.954046660059569e-05,88,39,49
24993,spoken,1.0687763893464371e-05,3.122955413168725e-05,27,6,21
24994,spokesman,6.307876337123095e-05,6.918812821440096e-05,76,31,45
24995,spokesperson,1.9070323809907035e-05,1.570104655239525e-05,20,11,9
24996,spokeswoman,1.0687763893464371e-05,1.9151826014460126e-05,19,5,14
24997,sponsor,1.6974683830796368e-05,2.4327995207557487e-05,25,9,16
24998,sponsored,1.278340387257504e-05,1.052487735929791e-05,12,6,6
24999,sponsoring,4.400843956132392e-06,5.348708166200577e-06,6,3,3
25000,sponsorship,4.400843956132392e-06,8.79948762826546e-06,7,2,5
25001,spontaneou,2.3052039770217305e-06,5.348708166200577e-06,5,1,4
25002,spontaneously,4.400843956132392e-06,1.8979287041356905e-06,6,5,1
25003,spoof,6.496483935243052e-06,3.6233184351681345e-06,6,3,3
25004,spook,4.400843956132392e-06,1.7253897310324457e-07,3,2,1
25005,spoon,2.3052039770217305e-06,3.6233184351681345e-06,4,2,2
25006,sporadic,2.3052039770217305e-06,1.8979287041356905e-06,4,1,3
25007,sport,6.936568330856297e-05,3.468033359375216e-05,59,34,25
25008,sporting,6.496483935243052e-06,7.074097897233022e-06,10,3,7
25009,spot,7.146132328767358e-05,5.883578982820635e-05,76,38,38
25010,spotlight,3.7931083621902995e-05,1.9151826014460126e-05,32,19,13
25011,spotted,3.7931083621902995e-05,2.9504164400654783e-05,37,19,18
25012,spotting,4.400843956132392e-06,3.6233184351681345e-06,4,2,2
25013,spouse,1.9070323809907035e-05,1.742643628342769e-05,19,9,10
25014,spouting,2.3052039770217305e-06,3.6233184351681345e-06,3,1,2
25015,sprawl,2.3052039770217305e-06,1.8979287041356905e-06,3,2,1
25016,sprawling,4.400843956132392e-06,8.79948762826546e-06,8,2,6
25017,spray,2.116596378901769e-05,1.9151826014460126e-05,26,12,14
25018,sprayed,8.592123914353715e-06,1.2250267090330355e-05,12,5,7
25019,spraying,2.3052039770217305e-06,7.074097897233022e-06,6,2,4
25020,spraypainted,4.400843956132392e-06,3.6233184351681345e-06,4,2,2
25021,spread,0.0001552869224521,0.0001485560558418934,185,83,102
25022,spreading,5.4696203454788295e-05,5.883578982820635e-05,62,28,34
25023,spreadsheet,2.3052039770217305e-06,3.6233184351681345e-06,3,1,2
25024,spree,2.326160376812834e-05,1.3975656821362803e-05,19,11,8
25025,spring,4.212236358012434e-05,4.50326719799468e-05,51,22,29
25026,sprinkler,2.095639979110664e-07,1.8979287041356905e-06,3,1,2
25027,sprint,4.400843956132392e-06,1.8979287041356905e-06,4,2,2
25028,sprung,4.400843956132392e-06,1.8979287041356905e-06,5,2,3
25029,spun,4.400843956132392e-06,1.8979287041356905e-06,4,2,2
25030,spur,1.278340387257504e-05,1.052487735929791e-05,14,7,7
25031,spurred,8.592123914353715e-06,5.348708166200577e-06,7,4,3
25032,spy,0.00029988608101073563,0.0002192970348142235,297,156,141
25033,spying,0.00013223488268188294,0.0001347529379936339,159,68,91
25034,spyware,6.496483935243052e-06,7.074097897233022e-06,8,3,5
25035,sq,1.0687763893464371e-05,1.742643628342769e-05,15,5,10
25036,squad,1.9070323809907035e-05,5.1934230904076595e-05,43,11,32
25037,squadron,4.400843956132392e-06,3.6233184351681345e-06,4,2,2
25038,squalid,2.3052039770217305e-06,1.8979287041356905e-06,3,2,1
25039,squalor,2.3052039770217305e-06,1.8979287041356905e-06,3,1,2
25040,squandered,6.496483935243052e-06,3.6233184351681345e-06,5,3,2
25041,square,5.050492349656699e-05,5.3659620635109e-05,59,25,34
25042,squash,2.3052039770217305e-06,3.6233184351681345e-06,3,1,2
25043,squat,2.3052039770217305e-06,3.6233184351681345e-06,3,1,2
25044,squatter,6.496483935243052e-06,7.074097897233022e-06,7,3,4
25045,squeeze,1.278340387257504e-05,3.6233184351681345e-06,8,6,2
25046,squid,6.496483935243052e-06,7.074097897233022e-06,7,3,4
25047,squirming,4.400843956132392e-06,1.7253897310324457e-07,3,2,1
25048,squirrel,2.095639979110664e-07,3.6233184351681345e-06,3,0,3
25049,st,4.400843956132392e-06,3.6233184351681345e-06,5,2,3
25050,stab,8.592123914353715e-06,1.3975656821362803e-05,13,4,9
25051,stabbed,4.4218003559234974e-05,2.4327995207557487e-05,39,25,14
25052,stabber,2.3052039770217305e-06,3.6233184351681345e-06,3,1,2
25053,stabbing,2.5357243747239038e-05,1.570104655239525e-05,26,14,12
25054,stabilise,2.3052039770217305e-06,1.8979287041356905e-06,3,2,1
25055,stability,1.9070323809907035e-05,3.2954943862719716e-05,28,9,19
25056,stabilize,2.3052039770217305e-06,5.348708166200577e-06,4,1,3
25057,stabilizing,2.3052039770217305e-06,5.348708166200577e-06,4,1,3
25058,stable,3.7931083621902995e-05,3.468033359375216e-05,39,18,21
25059,stack,2.3052039770217305e-06,3.6233184351681345e-06,3,1,2
25060,stacked,6.496483935243052e-06,7.074097897233022e-06,8,4,4
25061,stadium,2.116596378901769e-05,1.570104655239525e-05,22,11,11
25062,staff,0.0001825302421805385,0.00018996540938667205,217,93,124
25063,staffer,3.1644163684570994e-05,5.5385010366141504e-05,52,17,35
25064,staffing,2.3052039770217305e-06,3.6233184351681345e-06,3,1,2
25065,stage,0.00010708720293255492,9.506897417988779e-05,119,58,61
25066,staged,1.6974683830796368e-05,1.742643628342769e-05,20,9,11
25067,staggering,1.48790438516857e-05,1.570104655239525e-05,22,9,13
25068,staggeringly,2.3052039770217305e-06,1.8979287041356905e-06,3,1,2
25069,staging,8.592123914353715e-06,8.79948762826546e-06,9,4,5
25070,stagnant,4.400843956132392e-06,3.6233184351681345e-06,5,2,3
25071,stagnating,2.3052039770217305e-06,3.6233184351681345e-06,3,1,2
25072,stagnation,2.3052039770217305e-06,7.074097897233022e-06,5,1,4
25073,stain,8.592123914353715e-06,5.348708166200577e-06,9,5,4
25074,stair,4.400843956132392e-06,1.8979287041356905e-06,3,2,1
25075,stake,5.6791843433898893e-05,5.3659620635109e-05,62,27,35
25076,stakeholder,4.400843956132392e-06,5.348708166200577e-06,5,2,3
25077,stale,2.3052039770217305e-06,5.348708166200577e-06,4,1,3
25078,stalemate,4.400843956132392e-06,5.348708166200577e-06,6,2,4
25079,stalk,6.496483935243052e-06,1.7253897310324457e-07,3,3,0
25080,stalked,2.3052039770217305e-06,3.6233184351681345e-06,3,1,2
25081,stalker,2.3052039770217305e-06,5.348708166200577e-06,4,1,3
25082,stalking,2.3052039770217305e-06,5.348708166200577e-06,5,1,4
25083,stall,1.0687763893464371e-05,1.3975656821362803e-05,13,5,8
25084,stalled,2.326160376812834e-05,1.2250267090330355e-05,19,11,8
25085,stalling,1.0687763893464371e-05,5.348708166200577e-06,9,6,3
25086,stamp,1.0687763893464371e-05,2.6053384938589907e-05,26,8,18
25087,stamped,2.3052039770217305e-06,5.348708166200577e-06,4,1,3
25088,stampede,1.0687763893464371e-05,1.3975656821362803e-05,14,6,8
25089,stance,7.565260324589493e-05,5.1934230904076595e-05,75,40,35
25090,stand,0.0002621645613867441,0.00024345249104867797,293,133,160
25091,standalone,8.592123914353715e-06,1.7253897310324457e-07,4,4,0
25092,standard,0.00010918284291166549,0.0001554576147660233,150,55,95
25093,standardbearer,4.400843956132392e-06,3.6233184351681345e-06,4,2,2
25094,standardized,4.400843956132392e-06,8.79948762826546e-06,7,2,5
25095,standing,7.565260324589493e-05,5.020884117304414e-05,72,38,34
25096,standoff,1.278340387257504e-05,3.640572332478458e-05,30,7,23
25097,standpoint,8.592123914353715e-06,3.6233184351681345e-06,6,4,2
25098,standstill,1.278340387257504e-05,2.087721574549256e-05,20,6,14
25099,standup,2.3052039770217305e-06,1.8979287041356905e-06,3,1,2
25100,staple,6.496483935243052e-06,7.074097897233022e-06,7,3,4
25101,star,0.00013223488268188294,0.00010542131256608228,138,69,69
25102,stare,1.278340387257504e-05,7.074097897233022e-06,10,6,4
25103,starfish,6.496483935243052e-06,1.8979287041356905e-06,4,3,1
25104,staring,8.592123914353715e-06,1.052487735929791e-05,11,5,6
25105,stark,2.7452883726349685e-05,1.2250267090330355e-05,22,13,9
25106,starred,2.3052039770217305e-06,5.348708166200577e-06,4,1,3
25107,start,0.0004989718790262485,0.0005350433555931611,614,268,346
25108,started,0.00016995640230587486,0.00017271151207634748,199,89,110
25109,starter,2.095639979110664e-07,5.348708166200577e-06,3,0,3
25110,starting,7.146132328767358e-05,0.00011922443041434203,116,38,78
25111,startling,4.400843956132392e-06,1.052487735929791e-05,11,4,7
25112,startup,4.212236358012434e-05,3.122955413168725e-05,44,22,22
25113,starvation,2.5357243747239038e-05,1.3975656821362803e-05,23,14,9
25114,starve,1.0687763893464371e-05,1.570104655239525e-05,15,6,9
25115,starved,8.592123914353715e-06,7.074097897233022e-06,9,4,5
25116,starving,2.5357243747239038e-05,2.2602605476525032e-05,28,14,14
25117,stash,8.592123914353715e-06,8.79948762826546e-06,10,4,6
25118,stashed,6.496483935243052e-06,1.7253897310324457e-07,4,3,1
25119,stat,6.496483935243052e-06,3.6233184351681345e-06,5,3,2
25120,state,0.0015635569884144647,0.0018929250739156951,2047,836,1211
25121,stated,1.9070323809907035e-05,1.9151826014460126e-05,21,10,11
25122,statehood,1.48790438516857e-05,2.2602605476525032e-05,23,9,14
25123,statehouse,4.400843956132392e-06,3.6233184351681345e-06,4,2,2
25124,stateles,6.496483935243052e-06,1.7253897310324457e-07,3,3,0
25125,statement,0.00015109564249387862,0.00018306385046254245,198,78,120
25126,stateowned,1.48790438516857e-05,1.3975656821362803e-05,18,8,10
25127,staterun,2.954852370546031e-05,2.6053384938589907e-05,30,14,16
25128,statesponsored,4.400843956132392e-06,7.074097897233022e-06,6,2,4
25129,statewide,2.3052039770217305e-06,1.742643628342769e-05,13,3,10
25130,stating,2.5357243747239038e-05,1.3975656821362803e-05,22,13,9
25131,station,0.00011337412286988677,0.00016408456342118544,161,59,102
25132,stationed,8.592123914353715e-06,5.348708166200577e-06,9,5,4
25133,stationing,2.095639979110664e-07,5.348708166200577e-06,4,1,3
25134,statistic,4.6313643538345614e-05,3.2954943862719716e-05,49,24,25
25135,statistical,2.3052039770217305e-06,7.074097897233022e-06,5,1,4
25136,statue,4.6313643538345614e-05,3.2954943862719716e-05,50,24,26
25137,stature,2.095639979110664e-07,3.6233184351681345e-06,3,1,2
25138,status,9.660900303700153e-05,9.506897417988779e-05,114,50,64
25139,statute,1.278340387257504e-05,5.348708166200577e-06,11,7,4
25140,statutory,2.3052039770217305e-06,3.6233184351681345e-06,3,1,2
25141,staunch,4.400843956132392e-06,8.79948762826546e-06,7,2,5
25142,staunchest,2.095639979110664e-07,5.348708166200577e-06,3,0,3
25143,staunchly,2.3052039770217305e-06,7.074097897233022e-06,6,1,5
25144,stave,4.400843956132392e-06,5.348708166200577e-06,8,5,3
25145,stay,0.00013013924270277222,0.00014337988664879628,163,68,95
25146,stayathome,2.3052039770217305e-06,3.6233184351681345e-06,3,1,2
25147,stayed,1.6974683830796368e-05,1.742643628342769e-05,21,9,12
25148,staying,2.116596378901769e-05,1.3975656821362803e-05,19,10,9
25149,steadfast,6.496483935243052e-06,1.7253897310324457e-07,3,3,0
25150,steadily,8.592123914353715e-06,1.052487735929791e-05,11,5,6
25151,steady,1.278340387257504e-05,1.2250267090330355e-05,17,8,9
25152,steak,2.095639979110664e-07,5.348708166200577e-06,3,0,3
25153,steal,4.6313643538345614e-05,2.777877466962238e-05,43,22,21
25154,stealing,6.098312339212028e-05,4.6758061710979285e-05,70,37,33
25155,stealth,1.6974683830796368e-05,2.2602605476525032e-05,21,8,13
25156,steam,6.496483935243052e-06,1.052487735929791e-05,9,3,6
25157,steel,3.3739803663681634e-05,1.052487735929791e-05,25,17,8
25158,steep,1.0687763893464371e-05,1.052487735929791e-05,12,5,7
25159,steer,6.496483935243052e-06,1.2250267090330355e-05,11,4,7
25160,steered,6.496483935243052e-06,1.8979287041356905e-06,4,3,1
25161,steering,6.496483935243052e-06,3.6233184351681345e-06,5,3,2
25162,stellar,6.496483935243052e-06,1.8979287041356905e-06,4,3,1
25163,stem,3.583544364279237e-05,1.742643628342769e-05,29,19,10
25164,stemcell,6.496483935243052e-06,1.8979287041356905e-06,4,3,1
25165,stemmed,2.095639979110664e-07,3.6233184351681345e-06,4,0,4
25166,stemming,4.400843956132392e-06,7.074097897233022e-06,7,2,5
25167,stench,4.400843956132392e-06,5.348708166200577e-06,5,2,3
25168,step,0.00031874684082273133,0.00027968567540035923,359,169,190
25169,stepped,4.002672360101368e-05,2.2602605476525032e-05,36,21,15
25170,stepping,1.9070323809907035e-05,3.122955413168725e-05,27,9,18
25171,stereotype,1.9070323809907035e-05,1.742643628342769e-05,21,10,11
25172,sterilisation,2.095639979110664e-07,7.074097897233022e-06,4,0,4
25173,sterilization,4.400843956132392e-06,1.052487735929791e-05,9,2,7
25174,steroid,6.496483935243052e-06,1.8979287041356905e-06,5,3,2
25175,stew,6.496483935243052e-06,1.8979287041356905e-06,4,3,1
25176,steward,2.3052039770217305e-06,8.79948762826546e-06,6,1,5
25177,stewardship,2.095639979110664e-07,5.348708166200577e-06,3,0,3
25178,stick,5.4696203454788295e-05,2.9504164400654783e-05,50,28,22
25179,sticker,2.3052039770217305e-06,7.074097897233022e-06,5,1,4
25180,sticking,1.48790438516857e-05,1.052487735929791e-05,15,8,7
25181,sticky,8.592123914353715e-06,3.6233184351681345e-06,6,4,2
25182,stiff,4.400843956132392e-06,1.2250267090330355e-05,9,2,7
25183,stiffed,2.3052039770217305e-06,1.8979287041356905e-06,3,1,2
25184,stifle,1.278340387257504e-05,8.79948762826546e-06,13,8,5
25185,stifled,2.095639979110664e-07,5.348708166200577e-06,3,0,3
25186,stifling,6.496483935243052e-06,1.8979287041356905e-06,5,3,2
25187,stigma,6.496483935243052e-06,7.074097897233022e-06,9,4,5
25188,still,0.0007190140768328685,0.0007696963590135735,893,376,517
25189,stimulant,2.3052039770217305e-06,3.6233184351681345e-06,3,1,2
25190,stimulate,4.400843956132392e-06,3.6233184351681345e-06,5,3,2
25191,stimulu,1.48790438516857e-05,1.570104655239525e-05,17,8,9
25192,sting,1.278340387257504e-05,1.570104655239525e-05,16,6,10
25193,stinging,6.496483935243052e-06,1.8979287041356905e-06,4,3,1
25194,stink,6.496483935243052e-06,7.074097897233022e-06,8,4,4
25195,stint,2.3052039770217305e-06,8.79948762826546e-06,7,2,5
25196,stipend,4.400843956132392e-06,1.7253897310324457e-07,3,2,1
25197,stipulate,2.3052039770217305e-06,3.6233184351681345e-06,3,1,2
25198,stir,1.48790438516857e-05,1.052487735929791e-05,14,7,7
25199,stirred,2.3052039770217305e-06,3.6233184351681345e-06,5,2,3
25200,stirring,4.400843956132392e-06,8.79948762826546e-06,9,2,7
25201,stitched,4.400843956132392e-06,1.7253897310324457e-07,3,2,1
25202,stock,0.00016786076232676425,0.00010887209202814718,159,91,68
25203,stockbroker,4.400843956132392e-06,1.7253897310324457e-07,3,2,1
25204,stocking,4.400843956132392e-06,1.8979287041356905e-06,4,3,1
25205,stockpile,1.6974683830796368e-05,2.087721574549256e-05,23,10,13
25206,stockpiled,4.400843956132392e-06,1.8979287041356905e-06,4,3,1
25207,stockpiling,4.400843956132392e-06,1.8979287041356905e-06,3,2,1
25208,stoic,2.095639979110664e-07,3.6233184351681345e-06,3,0,3
25209,stoke,8.592123914353715e-06,5.348708166200577e-06,9,5,4
25210,stoked,8.592123914353715e-06,3.6233184351681345e-06,6,4,2
25211,stoking,2.3052039770217305e-06,3.6233184351681345e-06,3,1,2
25212,stole,2.5357243747239038e-05,2.4327995207557487e-05,34,15,19
25213,stolen,0.00012175668278632962,8.816741525575797e-05,118,60,58
25214,stomach,2.7452883726349685e-05,8.79948762826546e-06,18,13,5
25215,stone,4.212236358012434e-05,3.8131113055817005e-05,47,23,24
25216,stoned,1.6974683830796368e-05,1.9151826014460126e-05,20,8,12
25217,stoning,2.954852370546031e-05,3.468033359375216e-05,35,15,20
25218,stood,3.7931083621902995e-05,3.468033359375216e-05,45,20,25
25219,stop,0.0005094500789218018,0.000573001929675875,637,272,365
25220,stopandsearch,2.3052039770217305e-06,1.8979287041356905e-06,3,1,2
25221,stopped,9.24177230787802e-05,9.679436391092026e-05,116,51,65
25222,stopping,3.3739803663681634e-05,1.9151826014460126e-05,36,19,17
25223,storage,3.7931083621902995e-05,1.9151826014460126e-05,32,18,14
25224,store,0.00012175668278632962,0.0001278513790695043,146,66,80
25225,stored,1.0687763893464371e-05,2.777877466962238e-05,24,7,17
25226,storing,4.400843956132392e-06,5.348708166200577e-06,6,2,4
25227,storm,0.00014480872255654665,0.0001295767688005365,156,77,79
25228,stormed,1.6974683830796368e-05,2.087721574549256e-05,23,11,12
25229,storming,4.400843956132392e-06,3.6233184351681345e-06,4,2,2
25230,story,0.00039838116002893705,0.00041771685388295495,492,219,273
25231,straight,4.002672360101368e-05,5.020884117304414e-05,53,19,34
25232,straightforward,2.3052039770217305e-06,7.074097897233022e-06,5,1,4
25233,strain,2.5357243747239038e-05,2.6053384938589907e-05,33,15,18
25234,strait,8.592123914353715e-06,1.8979287041356905e-06,5,4,1
25235,stranded,3.583544364279237e-05,1.742643628342769e-05,32,20,12
25236,stranding,8.592123914353715e-06,1.7253897310324457e-07,4,4,0
25237,strange,2.116596378901769e-05,2.4327995207557487e-05,30,12,18
25238,stranger,3.1644163684570994e-05,2.4327995207557487e-05,29,15,14
25239,strangle,4.400843956132392e-06,5.348708166200577e-06,5,2,3
25240,strangled,1.0687763893464371e-05,1.8979287041356905e-06,6,5,1
25241,stranglehold,4.400843956132392e-06,1.7253897310324457e-07,3,3,0
25242,strangling,2.095639979110664e-07,5.348708166200577e-06,3,0,3
25243,strapped,2.3052039770217305e-06,1.8979287041356905e-06,3,1,2
25244,strategic,3.7931083621902995e-05,4.8483451442011706e-05,51,19,32
25245,strategically,6.496483935243052e-06,7.074097897233022e-06,7,3,4
25246,strategist,1.48790438516857e-05,2.777877466962238e-05,26,7,19
25247,strategizing,2.3052039770217305e-06,3.6233184351681345e-06,3,1,2
25248,strategy,0.0001531912824729893,0.00014510527637982858,176,77,99
25249,straw,1.278340387257504e-05,8.79948762826546e-06,12,7,5
25250,strawberry,4.400843956132392e-06,1.8979287041356905e-06,4,3,1
25251,stray,8.592123914353715e-06,1.2250267090330355e-05,11,4,7
25252,streak,8.592123914353715e-06,1.7253897310324457e-07,4,4,0
25253,stream,1.0687763893464371e-05,2.4327995207557487e-05,23,9,14
25254,streamed,8.592123914353715e-06,3.6233184351681345e-06,6,4,2
25255,streaming,1.6974683830796368e-05,8.79948762826546e-06,16,11,5
25256,streamline,2.3052039770217305e-06,1.8979287041356905e-06,3,1,2
25257,street,0.0003166512008436211,0.0002934887932486187,354,165,189
25258,strength,3.7931083621902995e-05,3.640572332478458e-05,43,21,22
25259,strengthen,1.6974683830796368e-05,3.122955413168725e-05,28,8,20
25260,strengthened,4.400843956132392e-06,8.79948762826546e-06,8,2,6
25261,strengthening,2.3052039770217305e-06,8.79948762826546e-06,6,1,5
25262,stres,2.954852370546031e-05,3.2954943862719716e-05,36,14,22
25263,stressed,8.592123914353715e-06,1.052487735929791e-05,11,4,7
25264,stressful,6.496483935243052e-06,7.074097897233022e-06,9,3,6
25265,stressing,4.400843956132392e-06,1.8979287041356905e-06,3,2,1
25266,stressor,4.400843956132392e-06,1.7253897310324457e-07,3,2,1
25267,stretch,2.7452883726349685e-05,2.087721574549256e-05,29,13,16
25268,stretched,4.400843956132392e-06,3.6233184351681345e-06,5,3,2
25269,stretching,6.496483935243052e-06,5.348708166200577e-06,7,3,4
25270,stricken,1.278340387257504e-05,1.052487735929791e-05,16,7,9
25271,strict,1.6974683830796368e-05,3.122955413168725e-05,29,8,21
25272,stricter,1.278340387257504e-05,1.570104655239525e-05,18,7,11
25273,strictest,2.3052039770217305e-06,7.074097897233022e-06,5,1,4
25274,strictly,1.0687763893464371e-05,8.79948762826546e-06,11,6,5
25275,stride,2.095639979110664e-07,3.6233184351681345e-06,3,0,3
25276,strife,8.592123914353715e-06,1.8979287041356905e-06,5,4,1
25277,strike,0.0005157369988591341,0.0005367687453241936,613,263,350
25278,striker,2.3052039770217305e-06,5.348708166200577e-06,5,1,4
25279,striking,3.7931083621902995e-05,4.1581892517881935e-05,45,18,27
25280,strikingly,4.400843956132392e-06,1.8979287041356905e-06,3,2,1
25281,string,2.7452883726349685e-05,2.9504164400654783e-05,36,15,21
25282,stringent,4.400843956132392e-06,7.074097897233022e-06,6,2,4
25283,strip,7.146132328767358e-05,5.3659620635109e-05,73,39,34
25284,stripe,6.496483935243052e-06,1.8979287041356905e-06,4,3,1
25285,stripped,4.002672360101368e-05,3.8131113055817005e-05,44,20,24
25286,stripping,1.48790438516857e-05,8.79948762826546e-06,14,8,6
25287,stripsearched,2.3052039770217305e-06,3.6233184351681345e-06,3,1,2
25288,strive,2.095639979110664e-07,5.348708166200577e-06,4,0,4
25289,striving,2.3052039770217305e-06,5.348708166200577e-06,4,1,3
25290,stroke,2.326160376812834e-05,1.570104655239525e-05,22,12,10
25291,strong,0.00014061744259832545,0.00015028144557292604,173,73,100
25292,stronger,3.3739803663681634e-05,3.122955413168725e-05,43,18,25
25293,strongest,1.48790438516857e-05,3.985650278684949e-05,35,11,24
25294,stronghold,2.326160376812834e-05,2.087721574549256e-05,24,12,12
25295,strongly,5.050492349656699e-05,3.985650278684949e-05,54,27,27
25296,strongman,6.496483935243052e-06,5.348708166200577e-06,6,3,3
25297,struck,6.936568330856297e-05,7.263890767646595e-05,82,35,47
25298,structural,6.496483935243052e-06,1.052487735929791e-05,14,6,8
25299,structure,4.4218003559234974e-05,3.985650278684949e-05,47,21,26
25300,struggle,9.24177230787802e-05,0.0001019705331040174,113,48,65
25301,struggled,2.954852370546031e-05,1.3975656821362803e-05,25,15,10
25302,struggling,6.307876337123095e-05,6.918812821440096e-05,81,34,47
25303,stubborn,1.0687763893464371e-05,3.6233184351681345e-06,7,5,2
25304,stubbornly,2.3052039770217305e-06,3.6233184351681345e-06,3,1,2
25305,stuck,4.002672360101368e-05,5.3659620635109e-05,59,19,40
25306,student,0.0005890843981280072,0.0005246910172069665,652,304,348
25307,studied,1.0687763893464371e-05,5.348708166200577e-06,10,6,4
25308,studio,1.278340387257504e-05,8.79948762826546e-06,12,7,5
25309,study,0.00033132068069739577,0.00034352509544855977,398,177,221
25310,studying,2.326160376812834e-05,1.2250267090330355e-05,20,12,8
25311,stuff,5.050492349656699e-05,5.1934230904076595e-05,62,27,35
25312,stuffed,1.278340387257504e-05,1.2250267090330355e-05,14,7,7
25313,stuffing,6.496483935243052e-06,1.7253897310324457e-07,3,3,0
25314,stumble,6.496483935243052e-06,8.79948762826546e-06,11,5,6
25315,stumbled,8.592123914353715e-06,5.348708166200577e-06,8,4,4
25316,stump,1.0687763893464371e-05,1.8979287041356905e-06,6,5,1
25317,stun,1.6974683830796368e-05,2.087721574549256e-05,24,9,15
25318,stung,2.095639979110664e-07,5.348708166200577e-06,4,0,4
25319,stunned,1.9070323809907035e-05,2.087721574549256e-05,21,9,12
25320,stunning,2.954852370546031e-05,2.6053384938589907e-05,29,14,15
25321,stunningly,4.400843956132392e-06,1.8979287041356905e-06,3,2,1
25322,stunt,2.7452883726349685e-05,2.4327995207557487e-05,31,15,16
25323,stunted,2.3052039770217305e-06,3.6233184351681345e-06,3,1,2
25324,stupid,4.4218003559234974e-05,2.9504164400654783e-05,44,24,20
25325,stupidity,4.400843956132392e-06,1.570104655239525e-05,13,3,10
25326,style,3.583544364279237e-05,3.8131113055817005e-05,41,18,23
25327,sub,8.592123914353715e-06,1.2250267090330355e-05,15,5,10
25328,subSaharan,4.400843956132392e-06,3.6233184351681345e-06,6,2,4
25329,subcommittee,2.3052039770217305e-06,3.6233184351681345e-06,4,2,2
25330,subject,6.307876337123095e-05,8.4716635793693e-05,85,32,53
25331,subjected,2.326160376812834e-05,3.640572332478458e-05,35,12,23
25332,submarine,4.4218003559234974e-05,5.3659620635109e-05,60,26,34
25333,submerged,6.496483935243052e-06,1.8979287041356905e-06,6,3,3
25334,submission,4.400843956132392e-06,3.6233184351681345e-06,5,3,2
25335,submit,1.6974683830796368e-05,2.6053384938589907e-05,24,9,15
25336,submitted,2.326160376812834e-05,1.570104655239525e-05,21,11,10
25337,submitting,6.496483935243052e-06,5.348708166200577e-06,6,3,3
25338,subordinate,6.496483935243052e-06,7.074097897233022e-06,7,3,4
25339,subpoena,1.278340387257504e-05,1.9151826014460126e-05,20,7,13
25340,subpoenaed,2.3052039770217305e-06,5.348708166200577e-06,5,2,3
25341,subprime,6.496483935243052e-06,1.8979287041356905e-06,5,3,2
25342,subreddit,2.095639979110664e-07,8.79948762826546e-06,5,0,5
25343,subscriber,1.48790438516857e-05,1.3975656821362803e-05,15,7,8
25344,subscription,4.400843956132392e-06,5.348708166200577e-06,5,2,3
25345,subsequent,8.592123914353715e-06,1.570104655239525e-05,15,5,10
25346,subsequently,8.592123914353715e-06,8.79948762826546e-06,10,4,6
25347,subsidiary,1.0687763893464371e-05,7.074097897233022e-06,10,5,5
25348,subsidising,2.3052039770217305e-06,1.8979287041356905e-06,3,1,2
25349,subsidize,4.400843956132392e-06,5.348708166200577e-06,5,2,3
25350,subsidized,1.0687763893464371e-05,3.6233184351681345e-06,7,5,2
25351,subsidizing,8.592123914353715e-06,3.6233184351681345e-06,6,4,2
25352,subsidy,6.098312339212028e-05,5.1934230904076595e-05,63,29,34
25353,subspecies,4.400843956132392e-06,1.8979287041356905e-06,3,2,1
25354,substance,2.326160376812834e-05,3.985650278684949e-05,37,11,26
25355,substandard,2.3052039770217305e-06,7.074097897233022e-06,6,2,4
25356,substantial,2.5357243747239038e-05,2.777877466962238e-05,29,13,16
25357,substantially,8.592123914353715e-06,5.348708166200577e-06,9,5,4
25358,substantive,2.3052039770217305e-06,3.6233184351681345e-06,3,1,2
25359,substitute,6.496483935243052e-06,5.348708166200577e-06,6,3,3
25360,subtle,6.496483935243052e-06,8.79948762826546e-06,9,3,6
25361,suburb,3.583544364279237e-05,2.2602605476525032e-05,33,17,16
25362,suburban,8.592123914353715e-06,8.79948762826546e-06,10,4,6
25363,subversion,2.3052039770217305e-06,1.8979287041356905e-06,3,1,2
25364,subway,1.9070323809907035e-05,1.052487735929791e-05,15,9,6
25365,succeed,4.002672360101368e-05,4.8483451442011706e-05,51,22,29
25366,succeeded,1.278340387257504e-05,1.570104655239525e-05,17,7,10
25367,succes,0.00012804360272366158,0.00011749904068330962,149,68,81
25368,successful,9.660900303700153e-05,9.851975364195259e-05,113,51,62
25369,successfully,7.355696326678427e-05,6.401195902130366e-05,77,37,40
25370,succession,8.592123914353715e-06,2.087721574549256e-05,16,4,12
25371,successor,2.5357243747239038e-05,2.4327995207557487e-05,29,13,16
25372,suck,6.496483935243052e-06,1.9151826014460126e-05,15,3,12
25373,sucker,4.400843956132392e-06,1.8979287041356905e-06,3,2,1
25374,sucking,4.400843956132392e-06,5.348708166200577e-06,5,2,3
25375,sudden,8.592123914353715e-06,1.9151826014460126e-05,16,5,11
25376,suddenly,3.583544364279237e-05,4.6758061710979285e-05,50,20,30
25377,sue,0.00012385232276544028,8.4716635793693e-05,124,62,62
25378,sued,5.4696203454788295e-05,5.711040009717395e-05,65,28,37
25379,suffer,7.355696326678427e-05,7.436429740749831e-05,88,37,51
25380,suffered,5.050492349656699e-05,5.5385010366141504e-05,63,27,36
25381,sufferer,4.400843956132392e-06,3.6233184351681345e-06,5,3,2
25382,suffering,0.00010918284291166549,8.816741525575797e-05,117,59,58
25383,sufficient,8.592123914353715e-06,1.052487735929791e-05,10,4,6
25384,sufficiently,6.496483935243052e-06,3.6233184351681345e-06,5,3,2
25385,suffocated,2.095639979110664e-07,5.348708166200577e-06,3,0,3
25386,sugar,1.6974683830796368e-05,1.570104655239525e-05,19,8,11
25387,sugary,4.400843956132392e-06,1.052487735929791e-05,8,2,6
25388,suggest,0.00018881716211787043,0.00019859235804183437,229,95,134
25389,suggested,8.193952318322689e-05,7.091351794543343e-05,88,41,47
25390,suggesting,4.212236358012434e-05,5.711040009717395e-05,55,21,34
25391,suggestion,3.1644163684570994e-05,3.2954943862719716e-05,36,17,19
25392,suicidal,2.3052039770217305e-06,1.2250267090330355e-05,9,1,8
25393,suicide,0.00027054712130318646,0.00024345249104867797,302,144,158
25394,suing,3.583544364279237e-05,4.50326719799468e-05,47,21,26
25395,suit,6.72700433294523e-05,6.746273848336857e-05,76,37,39
25396,suitable,1.0687763893464371e-05,1.7253897310324457e-07,5,5,0
25397,suitcase,1.6974683830796368e-05,8.79948762826546e-06,13,8,5
25398,suited,2.3052039770217305e-06,3.6233184351681345e-06,3,1,2
25399,sum,2.116596378901769e-05,2.777877466962238e-05,27,10,17
25400,summarily,4.400843956132392e-06,3.6233184351681345e-06,4,2,2
25401,summary,1.278340387257504e-05,1.3975656821362803e-05,15,7,8
25402,summer,0.00013223488268188294,0.00012612598933847184,149,68,81
25403,summit,7.984388320411623e-05,8.4716635793693e-05,98,43,55
25404,summon,1.48790438516857e-05,1.052487735929791e-05,15,9,6
25405,summoned,1.48790438516857e-05,1.2250267090330355e-05,17,9,8
25406,summoning,4.400843956132392e-06,1.8979287041356905e-06,3,2,1
25407,sun,3.7931083621902995e-05,2.9504164400654783e-05,37,19,18
25408,sunglas,2.3052039770217305e-06,3.6233184351681345e-06,3,1,2
25409,sunk,2.326160376812834e-05,1.742643628342769e-05,22,11,11
25410,sunken,2.095639979110664e-07,7.074097897233022e-06,5,1,4
25411,sunlight,1.48790438516857e-05,8.79948762826546e-06,12,7,5
25412,sunny,4.400843956132392e-06,5.348708166200577e-06,5,2,3
25413,sunset,2.095639979110664e-07,5.348708166200577e-06,3,0,3
25414,super,7.355696326678427e-05,4.50326719799468e-05,69,40,29
25415,superbug,1.0687763893464371e-05,7.074097897233022e-06,12,8,4
25416,superficial,4.400843956132392e-06,5.348708166200577e-06,5,2,3
25417,superhero,2.3052039770217305e-06,1.3975656821362803e-05,9,1,8
25418,superhighway,6.496483935243052e-06,3.6233184351681345e-06,5,3,2
25419,superintendent,2.3052039770217305e-06,3.6233184351681345e-06,3,1,2
25420,superior,1.0687763893464371e-05,1.052487735929791e-05,12,6,6
25421,superiority,2.3052039770217305e-06,1.8979287041356905e-06,3,1,2
25422,supermarket,3.3739803663681634e-05,2.9504164400654783e-05,43,18,25
25423,supermassive,2.3052039770217305e-06,3.6233184351681345e-06,3,1,2
25424,supernovum,8.592123914353715e-06,5.348708166200577e-06,7,4,3
25425,superpower,1.6974683830796368e-05,2.6053384938589907e-05,26,8,18
25426,superrich,6.496483935243052e-06,1.2250267090330355e-05,11,4,7
25427,supersonic,4.400843956132392e-06,1.8979287041356905e-06,3,2,1
25428,supervise,6.496483935243052e-06,1.7253897310324457e-07,4,4,0
25429,supervised,6.496483935243052e-06,1.7253897310324457e-07,3,3,0
25430,supervision,1.0687763893464371e-05,5.348708166200577e-06,10,7,3
25431,supervisor,1.0687763893464371e-05,3.6233184351681345e-06,7,5,2
25432,supplement,4.400843956132392e-06,5.348708166200577e-06,5,2,3
25433,supplied,1.6974683830796368e-05,1.570104655239525e-05,19,8,11
25434,supplier,6.496483935243052e-06,2.4327995207557487e-05,18,4,14
25435,supply,0.00019929536201342395,0.00017788768126944505,224,107,117
25436,supplying,1.9070323809907035e-05,1.3975656821362803e-05,21,11,10
25437,support,0.0006414753976057738,0.0005937066064482645,732,336,396
25438,supported,4.6313643538345614e-05,5.1934230904076595e-05,59,24,35
25439,supporter,0.00019929536201342395,0.00018651462992460717,230,108,122
25440,supporting,9.03220830996695e-05,7.608968713853079e-05,95,47,48
25441,supportive,6.496483935243052e-06,1.570104655239525e-05,12,3,9
25442,suppose,1.0687763893464371e-05,1.8979287041356905e-06,6,5,1
25443,supposed,8.193952318322689e-05,7.091351794543343e-05,89,45,44
25444,supposedly,1.48790438516857e-05,1.2250267090330355e-05,16,9,7
25445,suppres,2.326160376812834e-05,1.742643628342769e-05,22,12,10
25446,suppressed,2.3052039770217305e-06,1.052487735929791e-05,8,2,6
25447,suppressing,6.496483935243052e-06,5.348708166200577e-06,7,4,3
25448,suppression,2.7452883726349685e-05,1.9151826014460126e-05,26,14,12
25449,supremacist,2.116596378901769e-05,4.6758061710979285e-05,43,14,29
25450,supremacy,1.48790438516857e-05,1.3975656821362803e-05,18,8,10
25451,supreme,3.1644163684570994e-05,3.2954943862719716e-05,35,15,20
25452,surcharge,1.278340387257504e-05,3.6233184351681345e-06,8,6,2
25453,sure,0.00016366948236854273,0.00020031774777286686,209,82,127
25454,surely,4.400843956132392e-06,7.074097897233022e-06,7,3,4
25455,surf,2.095639979110664e-07,7.074097897233022e-06,4,0,4
25456,surface,5.6791843433898893e-05,5.1934230904076595e-05,60,28,32
25457,surfaced,1.0687763893464371e-05,7.074097897233022e-06,9,5,4
25458,surfacetoair,1.0687763893464371e-05,5.348708166200577e-06,8,5,3
25459,surfer,6.496483935243052e-06,1.8979287041356905e-06,4,3,1
25460,surfing,4.400843956132392e-06,8.79948762826546e-06,7,2,5
25461,surge,5.4696203454788295e-05,6.918812821440096e-05,73,28,45
25462,surged,4.400843956132392e-06,1.2250267090330355e-05,11,4,7
25463,surgeon,4.400843956132392e-06,8.79948762826546e-06,9,2,7
25464,surgery,4.6313643538345614e-05,3.2954943862719716e-05,43,23,20
25465,surgical,2.3052039770217305e-06,1.8979287041356905e-06,3,1,2
25466,surgically,2.3052039770217305e-06,1.8979287041356905e-06,3,2,1
25467,surging,1.0687763893464371e-05,2.087721574549256e-05,17,5,12
25468,surpas,4.400843956132392e-06,1.570104655239525e-05,12,2,10
25469,surpass,6.496483935243052e-06,8.79948762826546e-06,8,3,5
25470,surpassed,8.592123914353715e-06,5.348708166200577e-06,7,4,3
25471,surplu,1.6974683830796368e-05,8.79948762826546e-06,17,8,9
25472,surprise,9.451336305789087e-05,9.334358444885519e-05,113,50,63
25473,surprised,4.212236358012434e-05,3.122955413168725e-05,46,24,22
25474,surprising,2.954852370546031e-05,3.985650278684949e-05,40,14,26
25475,surprisingly,1.6974683830796368e-05,1.742643628342769e-05,19,9,10
25476,surreal,4.400843956132392e-06,8.79948762826546e-06,7,2,5
25477,surrender,2.954852370546031e-05,2.9504164400654783e-05,36,17,19
25478,surrendered,4.400843956132392e-06,5.348708166200577e-06,5,2,3
25479,surrendering,8.592123914353715e-06,3.6233184351681345e-06,6,4,2
25480,surreptitiously,4.400843956132392e-06,3.6233184351681345e-06,4,2,2
25481,surrogate,6.496483935243052e-06,1.570104655239525e-05,12,3,9
25482,surround,1.0687763893464371e-05,1.3975656821362803e-05,13,5,8
25483,surrounded,3.3739803663681634e-05,3.468033359375216e-05,38,16,22
25484,surrounding,4.212236358012434e-05,4.1581892517881935e-05,47,21,26
25485,surveillance,0.00024120816159563723,0.00019341618884873702,253,128,125
25486,survey,0.00011127848289077625,0.0001278513790695043,144,60,84
25487,surveyed,8.592123914353715e-06,8.79948762826546e-06,11,6,5
25488,survival,2.5357243747239038e-05,2.9504164400654783e-05,32,15,17
25489,survive,7.565260324589493e-05,7.263890767646595e-05,84,38,46
25490,survived,4.4218003559234974e-05,3.8131113055817005e-05,48,24,24
25491,surviving,2.116596378901769e-05,1.9151826014460126e-05,26,13,13
25492,survivor,7.774824322500554e-05,8.816741525575797e-05,96,41,55
25493,susceptible,6.496483935243052e-06,1.8979287041356905e-06,4,3,1
25494,suspect,0.00018043460220142793,0.00017961307100047735,215,98,117
25495,suspected,0.00018043460220142793,0.0001554576147660233,201,100,101
25496,suspend,7.565260324589493e-05,7.436429740749831e-05,85,39,46
25497,suspended,6.098312339212028e-05,9.161819471782287e-05,87,31,56
25498,suspending,2.3052039770217305e-06,1.3975656821362803e-05,10,2,8
25499,suspension,1.9070323809907035e-05,2.6053384938589907e-05,26,11,15
25500,suspicion,4.4218003559234974e-05,2.6053384938589907e-05,39,22,17
25501,suspiciou,2.954852370546031e-05,2.087721574549256e-05,28,14,14
25502,sustain,1.48790438516857e-05,1.2250267090330355e-05,15,7,8
25503,sustainability,2.116596378901769e-05,5.348708166200577e-06,14,11,3
25504,sustainable,2.5357243747239038e-05,3.2954943862719716e-05,33,13,20
25505,sustained,2.116596378901769e-05,1.2250267090330355e-05,20,11,9
25506,sustaining,2.3052039770217305e-06,5.348708166200577e-06,4,1,3
25507,swallow,1.0687763893464371e-05,8.79948762826546e-06,11,5,6
25508,swallowed,6.496483935243052e-06,1.8979287041356905e-06,4,3,1
25509,swallowing,4.400843956132392e-06,1.8979287041356905e-06,3,2,1
25510,swam,1.0687763893464371e-05,1.8979287041356905e-06,6,5,1
25511,swamp,1.0687763893464371e-05,2.6053384938589907e-05,22,6,16
25512,swamped,6.496483935243052e-06,7.074097897233022e-06,8,3,5
25513,swap,1.6974683830796368e-05,1.742643628342769e-05,22,8,14
25514,swapped,2.3052039770217305e-06,5.348708166200577e-06,4,1,3
25515,swarm,6.496483935243052e-06,3.6233184351681345e-06,6,3,3
25516,swarmed,4.400843956132392e-06,1.8979287041356905e-06,3,2,1
25517,swastika,1.0687763893464371e-05,1.052487735929791e-05,13,7,6
25518,swath,1.278340387257504e-05,1.052487735929791e-05,13,7,6
25519,swathe,4.400843956132392e-06,8.79948762826546e-06,8,2,6
25520,sway,4.400843956132392e-06,1.2250267090330355e-05,11,3,8
25521,swear,1.6974683830796368e-05,1.3975656821362803e-05,17,9,8
25522,swearing,1.0687763893464371e-05,1.052487735929791e-05,14,8,6
25523,sweat,6.496483935243052e-06,5.348708166200577e-06,6,3,3
25524,sweater,2.3052039770217305e-06,3.6233184351681345e-06,3,1,2
25525,sweatshop,2.3052039770217305e-06,3.6233184351681345e-06,5,2,3
25526,sweden,2.3052039770217305e-06,1.8979287041356905e-06,3,1,2
25527,sweep,1.6974683830796368e-05,1.9151826014460126e-05,28,13,15
25528,sweeping,6.098312339212028e-05,4.50326719799468e-05,61,31,30
25529,sweet,2.954852370546031e-05,2.087721574549256e-05,31,16,15
25530,sweetest,6.496483935243052e-06,1.8979287041356905e-06,4,3,1
25531,sweetheart,2.095639979110664e-07,5.348708166200577e-06,3,0,3
25532,swell,8.592123914353715e-06,3.6233184351681345e-06,6,4,2
25533,sweltering,2.3052039770217305e-06,3.6233184351681345e-06,3,1,2
25534,swept,1.0687763893464371e-05,1.3975656821362803e-05,16,6,10
25535,swift,1.48790438516857e-05,1.3975656821362803e-05,18,7,11
25536,swiftly,1.48790438516857e-05,1.8979287041356905e-06,8,7,1
25537,swim,1.278340387257504e-05,2.6053384938589907e-05,23,7,16
25538,swimmer,1.0687763893464371e-05,8.79948762826546e-06,11,6,5
25539,swimming,1.9070323809907035e-05,1.742643628342769e-05,19,9,10
25540,swine,1.6974683830796368e-05,1.570104655239525e-05,26,16,10
25541,swing,2.116596378901769e-05,2.9504164400654783e-05,29,11,18
25542,swipe,1.48790438516857e-05,1.8979287041356905e-06,9,7,2
25543,swirl,6.496483935243052e-06,1.052487735929791e-05,9,3,6
25544,swirling,4.400843956132392e-06,1.8979287041356905e-06,3,2,1
25545,switch,3.3739803663681634e-05,2.2602605476525032e-05,33,18,15
25546,switched,1.0687763893464371e-05,8.79948762826546e-06,11,6,5
25547,switching,6.496483935243052e-06,8.79948762826546e-06,12,5,7
25548,swollen,4.400843956132392e-06,1.8979287041356905e-06,4,2,2
25549,swoop,4.400843956132392e-06,3.6233184351681345e-06,5,2,3
25550,swooped,6.496483935243052e-06,3.6233184351681345e-06,6,3,3
25551,sword,2.5357243747239038e-05,1.742643628342769e-05,24,12,12
25552,swore,2.095639979110664e-07,5.348708166200577e-06,3,0,3
25553,sworn,3.1644163684570994e-05,1.052487735929791e-05,21,15,6
25554,swung,4.400843956132392e-06,1.8979287041356905e-06,4,2,2
25555,symbol,5.050492349656699e-05,4.330728224891437e-05,53,27,26
25556,symbolic,1.48790438516857e-05,1.570104655239525e-05,18,7,11
25557,symbolism,2.3052039770217305e-06,1.8979287041356905e-06,3,1,2
25558,sympathetic,2.3052039770217305e-06,7.074097897233022e-06,6,2,4
25559,sympathiser,6.496483935243052e-06,1.7253897310324457e-07,3,3,0
25560,sympathize,6.496483935243052e-06,1.7253897310324457e-07,3,3,0
25561,sympathizer,2.3052039770217305e-06,5.348708166200577e-06,5,1,4
25562,sympathy,1.278340387257504e-05,1.052487735929791e-05,14,6,8
25563,symptom,2.7452883726349685e-05,2.087721574549256e-05,26,13,13
25564,synagogue,6.496483935243052e-06,1.742643628342769e-05,13,3,10
25565,sync,2.095639979110664e-07,5.348708166200577e-06,3,0,3
25566,syndicate,1.48790438516857e-05,5.348708166200577e-06,12,8,4
25567,syndrome,1.278340387257504e-05,1.3975656821362803e-05,18,6,12
25568,synonymou,2.3052039770217305e-06,3.6233184351681345e-06,3,1,2
25569,synthetic,8.592123914353715e-06,5.348708166200577e-06,7,4,3
25570,syphili,6.496483935243052e-06,1.8979287041356905e-06,5,3,2
25571,syrup,6.496483935243052e-06,7.074097897233022e-06,7,3,4
25572,system,0.0005513628785040153,0.0005126132890897391,629,294,335
25573,systematic,2.7452883726349685e-05,1.570104655239525e-05,28,16,12
25574,systematically,1.48790438516857e-05,1.3975656821362803e-05,18,8,10
25575,systemic,1.6974683830796368e-05,1.2250267090330355e-05,17,9,8
25576,tab,4.400843956132392e-06,5.348708166200577e-06,5,2,3
25577,table,6.098312339212028e-05,6.401195902130366e-05,68,30,38
25578,tabled,2.3052039770217305e-06,7.074097897233022e-06,6,1,5
25579,tablet,1.6974683830796368e-05,1.052487735929791e-05,15,8,7
25580,tabloid,2.116596378901769e-05,1.3975656821362803e-05,19,10,9
25581,taboo,1.48790438516857e-05,1.3975656821362803e-05,15,7,8
25582,tacit,2.3052039770217305e-06,3.6233184351681345e-06,3,1,2
25583,tack,2.3052039770217305e-06,7.074097897233022e-06,5,1,4
25584,tackle,6.307876337123095e-05,5.1934230904076595e-05,65,32,33
25585,tackled,2.3052039770217305e-06,5.348708166200577e-06,4,1,3
25586,tackling,1.278340387257504e-05,1.052487735929791e-05,13,7,6
25587,tactic,5.6791843433898893e-05,5.883578982820635e-05,70,31,39
25588,tactical,4.400843956132392e-06,8.79948762826546e-06,8,2,6
25589,tag,8.592123914353715e-06,1.3975656821362803e-05,17,4,13
25590,tagged,1.0687763893464371e-05,1.8979287041356905e-06,6,5,1
25591,tagging,2.3052039770217305e-06,3.6233184351681345e-06,3,1,2
25592,tail,1.0687763893464371e-05,7.074097897233022e-06,9,5,4
25593,taint,8.592123914353715e-06,3.6233184351681345e-06,6,4,2
25594,tainted,8.592123914353715e-06,2.087721574549256e-05,18,5,13
25595,take,0.0010082123939501395,0.0009732923472754016,1154,520,634
25596,takeaway,2.095639979110664e-07,5.348708166200577e-06,3,0,3
25597,takedown,2.3052039770217305e-06,5.348708166200577e-06,4,1,3
25598,taken,0.00027683404124051843,0.00029693957271068364,327,142,185
25599,takeoff,2.3052039770217305e-06,1.8979287041356905e-06,3,1,2
25600,takeover,2.5357243747239038e-05,1.2250267090330355e-05,24,14,10
25601,taking,0.0003522770804885024,0.0003090173008279106,386,182,204
25602,tale,4.840928351745632e-05,3.468033359375216e-05,44,23,21
25603,talent,2.116596378901769e-05,2.9504164400654783e-05,35,16,19
25604,talented,2.3052039770217305e-06,8.79948762826546e-06,8,3,5
25605,taliban,2.3052039770217305e-06,3.6233184351681345e-06,3,1,2
25606,talk,0.0004528677994858143,0.00032799658786926807,445,229,216
25607,talked,5.260056347567764e-05,2.4327995207557487e-05,43,26,17
25608,talking,0.00010289592297433347,0.0001571830044970555,158,55,103
25609,tall,1.278340387257504e-05,1.052487735929791e-05,12,6,6
25610,tallest,8.592123914353715e-06,5.348708166200577e-06,7,4,3
25611,tally,4.400843956132392e-06,1.2250267090330355e-05,11,2,9
25612,tampering,2.3052039770217305e-06,3.6233184351681345e-06,3,1,2
25613,tampon,4.400843956132392e-06,1.8979287041356905e-06,3,2,1
25614,tan,2.3052039770217305e-06,3.6233184351681345e-06,3,1,2
25615,tangible,6.496483935243052e-06,5.348708166200577e-06,6,3,3
25616,tangled,2.095639979110664e-07,7.074097897233022e-06,5,0,5
25617,tank,0.00012175668278632962,9.679436391092026e-05,130,66,64
25618,tanker,3.583544364279237e-05,1.742643628342769e-05,31,20,11
25619,tanking,1.0687763893464371e-05,5.348708166200577e-06,9,5,4
25620,tantamount,2.3052039770217305e-06,3.6233184351681345e-06,3,1,2
25621,tantrum,8.592123914353715e-06,5.348708166200577e-06,8,4,4
25622,tap,2.5357243747239038e-05,3.122955413168725e-05,32,13,19
25623,tape,4.4218003559234974e-05,4.1581892517881935e-05,51,23,28
25624,taped,6.496483935243052e-06,1.7253897310324457e-07,3,3,0
25625,tapped,2.326160376812834e-05,1.2250267090330355e-05,18,11,7
25626,tapping,1.278340387257504e-05,1.2250267090330355e-05,15,7,8
25627,tar,1.0687763893464371e-05,2.4327995207557487e-05,21,6,15
25628,target,0.00024330380157474795,0.00020376852723493182,258,127,131
25629,targeted,0.00010080028299522283,9.506897417988779e-05,114,52,62
25630,targeting,8.403516316233764e-05,7.091351794543343e-05,91,46,45
25631,tariff,1.48790438516857e-05,1.570104655239525e-05,18,8,10
25632,tarmac,2.095639979110664e-07,5.348708166200577e-06,3,0,3
25633,tarnished,2.3052039770217305e-06,3.6233184351681345e-06,4,1,3
25634,tarnishing,2.3052039770217305e-06,5.348708166200577e-06,4,1,3
25635,taser,2.3052039770217305e-06,5.348708166200577e-06,7,2,5
25636,tasered,2.3052039770217305e-06,3.6233184351681345e-06,5,2,3
25637,task,1.9070323809907035e-05,6.056117955923882e-05,46,11,35
25638,tasked,4.400843956132392e-06,1.2250267090330355e-05,10,2,8
25639,taste,2.5357243747239038e-05,2.087721574549256e-05,28,13,15
25640,tattoo,6.496483935243052e-06,8.79948762826546e-06,8,3,5
25641,tattooed,4.400843956132392e-06,3.6233184351681345e-06,5,2,3
25642,taught,4.6313643538345614e-05,2.777877466962238e-05,41,22,19
25643,taunt,4.400843956132392e-06,7.074097897233022e-06,6,2,4
25644,taunted,2.095639979110664e-07,3.6233184351681345e-06,4,0,4
25645,tax,0.0007546399564777497,0.0007593440206273787,898,395,503
25646,taxation,4.400843956132392e-06,7.074097897233022e-06,7,3,4
25647,taxed,2.095639979110664e-07,7.074097897233022e-06,5,0,5
25648,taxexempt,4.400843956132392e-06,1.8979287041356905e-06,3,2,1
25649,taxfree,4.400843956132392e-06,3.6233184351681345e-06,4,2,2
25650,taxi,3.3739803663681634e-05,1.9151826014460126e-05,31,18,13
25651,taxing,1.48790438516857e-05,5.348708166200577e-06,10,7,3
25652,taxpayer,9.660900303700153e-05,9.161819471782287e-05,110,53,57
25653,taxpayerfunded,1.48790438516857e-05,1.8979287041356905e-06,8,7,1
25654,tea,2.116596378901769e-05,1.2250267090330355e-05,17,10,7
25655,teach,5.260056347567764e-05,6.401195902130366e-05,71,29,42
25656,teachable,2.3052039770217305e-06,3.6233184351681345e-06,3,1,2
25657,teacher,0.0001552869224521,0.0001364783277246665,176,85,91
25658,teaching,6.307876337123095e-05,3.2954943862719716e-05,58,33,25
25659,team,0.00021396484186719832,0.00025725560889693777,284,117,167
25660,teamed,4.400843956132392e-06,3.6233184351681345e-06,5,2,3
25661,teaming,2.095639979110664e-07,7.074097897233022e-06,4,0,4
25662,tear,5.050492349656699e-05,0.00010887209202814718,98,27,71
25663,tearga,1.6974683830796368e-05,1.2250267090330355e-05,16,9,7
25664,tearing,4.400843956132392e-06,1.052487735929791e-05,9,2,7
25665,tech,9.870464301611217e-05,7.263890767646595e-05,95,50,45
25666,technical,1.9070323809907035e-05,1.052487735929791e-05,17,9,8
25667,technically,2.3052039770217305e-06,1.052487735929791e-05,7,1,6
25668,technician,1.0687763893464371e-05,1.052487735929791e-05,11,5,6
25669,technique,2.954852370546031e-05,2.9504164400654783e-05,34,15,19
25670,technological,1.278340387257504e-05,1.2250267090330355e-05,16,7,9
25671,technologically,2.3052039770217305e-06,7.074097897233022e-06,5,1,4
25672,technology,0.00018881716211787043,0.00018133846073150993,216,101,115
25673,tectonic,6.496483935243052e-06,1.7253897310324457e-07,4,3,1
25674,tediou,2.3052039770217305e-06,5.348708166200577e-06,4,1,3
25675,teeming,2.3052039770217305e-06,3.6233184351681345e-06,4,1,3
25676,teen,0.0001154697628489974,8.989280498679035e-05,126,63,63
25677,teenage,4.840928351745632e-05,3.8131113055817005e-05,52,25,27
25678,teenaged,2.3052039770217305e-06,5.348708166200577e-06,4,1,3
25679,teenager,0.00010499156295344414,8.644202552472544e-05,115,58,57
25680,telco,2.3052039770217305e-06,3.6233184351681345e-06,3,1,2
25681,telecom,2.116596378901769e-05,2.777877466962238e-05,27,10,17
25682,telecommunication,1.0687763893464371e-05,1.2250267090330355e-05,16,7,9
25683,telephone,2.116596378901769e-05,1.052487735929791e-05,18,11,7
25684,teleprompter,2.3052039770217305e-06,5.348708166200577e-06,4,1,3
25685,telescope,2.326160376812834e-05,2.087721574549256e-05,23,11,12
25686,televised,2.116596378901769e-05,8.79948762826546e-06,15,10,5
25687,television,7.565260324589493e-05,0.00011232287149021227,113,41,72
25688,tell,0.00048220675919336334,0.00038320905926230586,517,260,257
25689,tellall,6.496483935243052e-06,7.074097897233022e-06,9,4,5
25690,telling,8.193952318322689e-05,7.608968713853079e-05,91,43,48
25691,telltale,2.095639979110664e-07,5.348708166200577e-06,3,0,3
25692,temper,6.496483935243052e-06,3.6233184351681345e-06,6,3,3
25693,temperament,2.3052039770217305e-06,3.6233184351681345e-06,4,1,3
25694,temperature,4.6313643538345614e-05,6.228656929027126e-05,65,23,42
25695,temple,3.583544364279237e-05,2.9504164400654783e-05,38,18,20
25696,temporarily,1.9070323809907035e-05,1.570104655239525e-05,21,9,12
25697,temporary,4.840928351745632e-05,2.9504164400654783e-05,47,27,20
25698,temptation,4.400843956132392e-06,5.348708166200577e-06,7,2,5
25699,tempted,8.592123914353715e-06,7.074097897233022e-06,9,4,5
25700,tempting,2.095639979110664e-07,5.348708166200577e-06,3,0,3
25701,ten,0.00012804360272366158,0.0001036959228350498,137,65,72
25702,tenant,1.48790438516857e-05,5.348708166200577e-06,11,8,3
25703,tend,4.212236358012434e-05,3.8131113055817005e-05,47,22,25
25704,tendency,1.0687763893464371e-05,1.2250267090330355e-05,13,5,8
25705,tender,4.400843956132392e-06,5.348708166200577e-06,5,2,3
25706,tenet,4.400843956132392e-06,5.348708166200577e-06,5,2,3
25707,tenni,6.496483935243052e-06,5.348708166200577e-06,6,3,3
25708,tense,1.278340387257504e-05,8.79948762826546e-06,11,6,5
25709,tension,0.00011756540282810809,8.816741525575797e-05,117,60,57
25710,tent,6.496483935243052e-06,3.985650278684949e-05,26,3,23
25711,tentacle,4.400843956132392e-06,1.8979287041356905e-06,3,2,1
25712,tentative,6.496483935243052e-06,5.348708166200577e-06,6,3,3
25713,tenth,2.3052039770217305e-06,3.6233184351681345e-06,4,1,3
25714,tenure,1.278340387257504e-05,1.570104655239525e-05,16,6,10
25715,terabyte,2.3052039770217305e-06,5.348708166200577e-06,4,1,3
25716,term,0.00018672152213876006,0.0002020431375038992,228,100,128
25717,termed,2.3052039770217305e-06,3.6233184351681345e-06,4,1,3
25718,terminal,6.496483935243052e-06,1.570104655239525e-05,13,3,10
25719,terminally,8.592123914353715e-06,5.348708166200577e-06,7,4,3
25720,terminate,6.496483935243052e-06,1.8979287041356905e-06,4,3,1
25721,terminated,4.400843956132392e-06,1.8979287041356905e-06,3,2,1
25722,terminating,2.095639979110664e-07,7.074097897233022e-06,4,0,4
25723,termination,6.496483935243052e-06,8.79948762826546e-06,8,3,5
25724,terrain,4.400843956132392e-06,5.348708166200577e-06,5,2,3
25725,terrible,6.936568330856297e-05,6.746273848336857e-05,76,36,40
25726,terribly,6.496483935243052e-06,1.8979287041356905e-06,5,4,1
25727,terrific,8.592123914353715e-06,1.8979287041356905e-06,5,4,1
25728,terrified,6.496483935243052e-06,1.742643628342769e-05,14,3,11
25729,terrify,2.3052039770217305e-06,5.348708166200577e-06,4,1,3
25730,terrifying,1.6974683830796368e-05,1.3975656821362803e-05,18,10,8
25731,territorial,1.48790438516857e-05,2.4327995207557487e-05,24,7,17
25732,territory,0.00010289592297433347,0.00014337988664879628,149,54,95
25733,terror,0.00023072996170008382,0.00019859235804183437,255,118,137
25734,terrorise,4.400843956132392e-06,1.8979287041356905e-06,3,2,1
25735,terrorism,0.00016157384238943198,0.00016926073261428268,194,85,109
25736,terrorist,0.00036694656034227697,0.00035215204410372187,422,193,229
25737,terrorize,8.592123914353715e-06,3.6233184351681345e-06,7,4,3
25738,terrorized,1.0687763893464371e-05,1.8979287041356905e-06,6,5,1
25739,test,0.00027892968121962896,0.0002883126240555216,316,142,174
25740,testament,4.400843956132392e-06,3.6233184351681345e-06,5,3,2
25741,tested,4.212236358012434e-05,3.640572332478458e-05,44,21,23
25742,testfire,1.0687763893464371e-05,3.6233184351681345e-06,8,5,3
25743,testfired,2.095639979110664e-07,7.074097897233022e-06,5,1,4
25744,testicle,6.496483935243052e-06,8.79948762826546e-06,8,3,5
25745,testified,1.278340387257504e-05,5.348708166200577e-06,12,7,5
25746,testify,4.840928351745632e-05,4.1581892517881935e-05,51,24,27
25747,testifying,4.400843956132392e-06,1.3975656821362803e-05,10,2,8
25748,testimony,4.212236358012434e-05,5.3659620635109e-05,56,21,35
25749,testing,4.212236358012434e-05,6.228656929027126e-05,64,24,40
25750,text,0.00010918284291166549,6.918812821440096e-05,101,55,46
25751,textbook,1.48790438516857e-05,3.122955413168725e-05,28,8,20
25752,textile,2.3052039770217305e-06,7.074097897233022e-06,5,1,4
25753,thank,9.660900303700153e-05,9.161819471782287e-05,112,52,60
25754,thanked,4.400843956132392e-06,5.348708166200577e-06,5,2,3
25755,thankful,6.496483935243052e-06,1.8979287041356905e-06,4,3,1
25756,thanking,2.095639979110664e-07,5.348708166200577e-06,3,0,3
25757,that,0.00022863432172097337,0.00025898099862796983,281,121,160
25758,thaw,2.095639979110664e-07,8.79948762826546e-06,5,0,5
25759,the,1.48790438516857e-05,2.4327995207557487e-05,26,8,18
25760,theater,1.6974683830796368e-05,1.570104655239525e-05,21,9,12
25761,theatre,6.496483935243052e-06,1.8979287041356905e-06,4,3,1
25762,theft,4.840928351745632e-05,4.8483451442011706e-05,63,30,33
25763,their,2.3052039770217305e-06,3.6233184351681345e-06,3,1,2
25764,them,4.400843956132392e-06,7.074097897233022e-06,7,3,4
25765,theme,2.116596378901769e-05,2.4327995207557487e-05,29,12,17
25766,thenPresident,6.496483935243052e-06,1.7253897310324457e-07,3,3,0
25767,theocracy,4.400843956132392e-06,5.348708166200577e-06,5,2,3
25768,theologian,6.496483935243052e-06,1.8979287041356905e-06,4,3,1
25769,theorist,1.6974683830796368e-05,8.79948762826546e-06,15,9,6
25770,theory,7.984388320411623e-05,7.091351794543343e-05,87,40,47
25771,therapeutic,4.400843956132392e-06,3.6233184351681345e-06,4,2,2
25772,therapist,4.400843956132392e-06,7.074097897233022e-06,7,2,5
25773,therapy,1.0687763893464371e-05,1.742643628342769e-05,16,6,10
25774,there,0.0001741476822640959,0.00020549391696596386,223,91,132
25775,thereby,8.592123914353715e-06,1.8979287041356905e-06,6,5,1
25776,therefore,6.496483935243052e-06,2.2602605476525032e-05,17,4,13
25777,thereof,2.3052039770217305e-06,1.8979287041356905e-06,3,1,2
25778,thesi,2.3052039770217305e-06,3.6233184351681345e-06,3,1,2
25779,thestarcom,4.400843956132392e-06,3.6233184351681345e-06,5,2,3
25780,they,6.72700433294523e-05,6.401195902130366e-05,74,33,41
25781,theyll,3.583544364279237e-05,3.640572332478458e-05,40,19,21
25782,theyre,0.00019091280209698145,0.00022792398346938586,253,102,151
25783,theyve,7.565260324589493e-05,4.8483451442011706e-05,71,40,31
25784,thick,6.496483935243052e-06,1.052487735929791e-05,10,4,6
25785,thief,2.7452883726349685e-05,2.777877466962238e-05,32,14,18
25786,thin,8.592123914353715e-06,1.3975656821362803e-05,13,5,8
25787,thing,0.0005681279983369005,0.0005609242015586476,662,300,362
25788,think,0.0006372841176475525,0.0006540952470343997,785,355,430
25789,thinker,4.400843956132392e-06,3.6233184351681345e-06,4,2,2
25790,thinking,8.403516316233764e-05,0.00010887209202814718,115,44,71
25791,thinktank,8.592123914353715e-06,1.8979287041356905e-06,5,4,1
25792,thinly,4.400843956132392e-06,1.8979287041356905e-06,4,3,1
25793,thinlyveiled,4.400843956132392e-06,1.7253897310324457e-07,3,2,1
25794,third,0.0001741476822640959,0.00022619859373835345,229,91,138
25795,thirdlargest,4.400843956132392e-06,7.074097897233022e-06,6,2,4
25796,thirdparty,6.496483935243052e-06,5.348708166200577e-06,8,5,3
25797,thirst,2.095639979110664e-07,7.074097897233022e-06,4,0,4
25798,thirsty,4.400843956132392e-06,3.6233184351681345e-06,6,3,3
25799,thirty,4.400843956132392e-06,1.2250267090330355e-05,11,3,8
25800,this,2.3052039770217305e-06,8.79948762826546e-06,6,1,5
25801,thorium,2.3052039770217305e-06,7.074097897233022e-06,6,1,5
25802,thorough,2.3052039770217305e-06,5.348708166200577e-06,4,1,3
25803,thoroughly,8.592123914353715e-06,5.348708166200577e-06,7,4,3
25804,though,0.00016995640230587486,0.00018651462992460717,207,90,117
25805,thought,0.0002935991610734039,0.00025898099862796983,325,149,176
25806,thoughtful,4.400843956132392e-06,1.052487735929791e-05,9,3,6
25807,thousand,0.0004151462798618222,0.00041771685388295495,491,220,271
25808,thread,8.592123914353715e-06,5.348708166200577e-06,7,4,3
25809,threat,0.00043400703967381825,0.0004228930230760523,500,231,269
25810,threaten,0.00029988608101073563,0.00024345249104867797,318,156,162
25811,threatened,0.00016157384238943198,0.00013302754826260141,178,85,93
25812,threatening,9.660900303700153e-05,7.436429740749831e-05,97,48,49
25813,three,0.0005932756780862283,0.0005419449145172909,676,322,354
25814,threeday,8.592123914353715e-06,5.348708166200577e-06,8,4,4
25815,threehour,2.095639979110664e-07,7.074097897233022e-06,4,0,4
25816,threejudge,2.095639979110664e-07,3.6233184351681345e-06,3,1,2
25817,threemonth,2.3052039770217305e-06,1.8979287041356905e-06,3,1,2
25818,threequarter,1.48790438516857e-05,1.7253897310324457e-07,7,7,0
25819,threestrike,2.3052039770217305e-06,3.6233184351681345e-06,4,1,3
25820,threeyear,1.0687763893464371e-05,1.052487735929791e-05,11,5,6
25821,threshold,1.48790438516857e-05,8.79948762826546e-06,13,7,6
25822,threw,4.840928351745632e-05,4.330728224891437e-05,52,25,27
25823,thrill,4.400843956132392e-06,1.8979287041356905e-06,3,2,1
25824,thrilled,1.278340387257504e-05,1.2250267090330355e-05,15,8,7
25825,thrive,2.116596378901769e-05,1.570104655239525e-05,20,11,9
25826,thrived,4.400843956132392e-06,1.7253897310324457e-07,3,3,0
25827,thriving,2.3052039770217305e-06,2.6053384938589907e-05,19,1,18
25828,throat,1.6974683830796368e-05,1.570104655239525e-05,17,8,9
25829,throe,8.592123914353715e-06,3.6233184351681345e-06,6,4,2
25830,throne,4.400843956132392e-06,5.348708166200577e-06,5,2,3
25831,throttle,2.3052039770217305e-06,3.6233184351681345e-06,4,1,3
25832,throttling,4.400843956132392e-06,3.6233184351681345e-06,4,2,2
25833,throughout,6.72700433294523e-05,2.9504164400654783e-05,61,36,25
25834,throw,7.355696326678427e-05,8.989280498679035e-05,94,41,53
25835,throwaway,4.400843956132392e-06,1.8979287041356905e-06,3,2,1
25836,thrower,8.592123914353715e-06,3.6233184351681345e-06,8,5,3
25837,throwing,4.6313643538345614e-05,2.777877466962238e-05,44,23,21
25838,thrown,5.6791843433898893e-05,5.5385010366141504e-05,65,30,35
25839,thrust,2.095639979110664e-07,7.074097897233022e-06,4,0,4
25840,thu,4.400843956132392e-06,1.742643628342769e-05,15,5,10
25841,thug,2.5357243747239038e-05,1.742643628342769e-05,27,14,13
25842,thuggish,6.496483935243052e-06,1.7253897310324457e-07,3,3,0
25843,thumb,8.592123914353715e-06,1.2250267090330355e-05,12,4,8
25844,thwart,2.116596378901769e-05,1.9151826014460126e-05,23,11,12
25845,thwarted,4.400843956132392e-06,8.79948762826546e-06,7,2,5
25846,thwarting,2.3052039770217305e-06,3.6233184351681345e-06,3,1,2
25847,thyroid,6.496483935243052e-06,3.6233184351681345e-06,5,3,2
25848,ticket,6.72700433294523e-05,5.5385010366141504e-05,69,34,35
25849,ticking,6.496483935243052e-06,1.2250267090330355e-05,10,3,7
25850,tidal,2.3052039770217305e-06,5.348708166200577e-06,4,1,3
25851,tide,1.48790438516857e-05,2.2602605476525032e-05,20,7,13
25852,tie,0.00014271308257743603,0.0001520068353039585,177,74,103
25853,tied,6.72700433294523e-05,4.330728224891437e-05,62,35,27
25854,tiger,5.6791843433898893e-05,4.8483451442011706e-05,59,28,31
25855,tight,1.48790438516857e-05,1.052487735929791e-05,15,8,7
25856,tighten,2.326160376812834e-05,2.087721574549256e-05,28,13,15
25857,tightened,6.496483935243052e-06,1.8979287041356905e-06,4,3,1
25858,tightening,8.592123914353715e-06,7.074097897233022e-06,8,4,4
25859,tighter,6.496483935243052e-06,5.348708166200577e-06,10,5,5
25860,tightly,2.3052039770217305e-06,8.79948762826546e-06,6,1,5
25861,tightrope,4.400843956132392e-06,1.8979287041356905e-06,3,2,1
25862,till,6.496483935243052e-06,8.79948762826546e-06,8,3,5
25863,tilt,1.0687763893464371e-05,1.7253897310324457e-07,6,6,0
25864,tilted,2.3052039770217305e-06,5.348708166200577e-06,4,1,3
25865,timber,2.116596378901769e-05,8.79948762826546e-06,15,10,5
25866,time,0.0016913910271402154,0.0018377126025226557,2106,908,1198
25867,timed,2.3052039770217305e-06,3.6233184351681345e-06,3,1,2
25868,timehonored,2.095639979110664e-07,3.6233184351681345e-06,3,0,3
25869,timeline,6.496483935243052e-06,8.79948762826546e-06,9,3,6
25870,timely,6.496483935243052e-06,5.348708166200577e-06,6,3,3
25871,timing,2.5357243747239038e-05,1.9151826014460126e-05,28,14,14
25872,tinderbox,2.3052039770217305e-06,3.6233184351681345e-06,3,1,2
25873,tiny,5.4696203454788295e-05,3.640572332478458e-05,52,27,25
25874,tip,6.517440335034157e-05,6.401195902130366e-05,71,33,38
25875,tipped,6.496483935243052e-06,7.074097897233022e-06,7,3,4
25876,tipping,1.278340387257504e-05,8.79948762826546e-06,15,8,7
25877,tirade,4.400843956132392e-06,5.348708166200577e-06,7,3,4
25878,tire,2.3052039770217305e-06,5.348708166200577e-06,5,1,4
25879,tired,3.7931083621902995e-05,4.1581892517881935e-05,49,21,28
25880,tissue,1.6974683830796368e-05,1.9151826014460126e-05,19,8,11
25881,titan,1.278340387257504e-05,3.6233184351681345e-06,8,6,2
25882,titanium,6.496483935243052e-06,3.6233184351681345e-06,5,3,2
25883,titfortat,2.3052039770217305e-06,3.6233184351681345e-06,3,1,2
25884,title,3.3739803663681634e-05,3.8131113055817005e-05,39,16,23
25885,titled,8.592123914353715e-06,1.052487735929791e-05,10,4,6
25886,to,6.496483935243052e-06,1.8979287041356905e-06,7,3,4
25887,toast,2.3052039770217305e-06,3.6233184351681345e-06,3,1,2
25888,tobacco,4.002672360101368e-05,4.330728224891437e-05,50,22,28
25889,today,0.0004151462798618222,0.00046602776635186325,521,219,302
25890,toddler,2.116596378901769e-05,1.2250267090330355e-05,18,11,7
25891,todo,2.3052039770217305e-06,3.6233184351681345e-06,3,1,2
25892,toe,6.496483935243052e-06,3.6233184351681345e-06,5,3,2
25893,together,0.0001762433222432067,0.00019341618884873702,224,101,123
25894,toilet,4.212236358012434e-05,3.8131113055817005e-05,44,20,24
25895,told,0.0005220239187964661,0.00056955115021381,630,276,354
25896,tolerable,4.400843956132392e-06,1.8979287041356905e-06,3,2,1
25897,tolerance,2.7452883726349685e-05,1.742643628342769e-05,24,13,11
25898,tolerant,6.496483935243052e-06,8.79948762826546e-06,9,3,6
25899,tolerate,1.6974683830796368e-05,1.742643628342769e-05,22,10,12
25900,toll,0.00013642616264010403,8.816741525575797e-05,132,72,60
25901,tomato,4.400843956132392e-06,1.7253897310324457e-07,3,3,0
25902,tomb,6.098312339212028e-05,2.4327995207557487e-05,48,31,17
25903,tombstone,2.3052039770217305e-06,3.6233184351681345e-06,3,1,2
25904,tomorrow,5.4696203454788295e-05,4.330728224891437e-05,59,29,30
25905,ton,7.984388320411623e-05,8.989280498679035e-05,103,42,61
25906,tone,1.6974683830796368e-05,2.777877466962238e-05,26,9,17
25907,tonedeaf,4.400843956132392e-06,1.8979287041356905e-06,3,2,1
25908,tongue,8.592123914353715e-06,7.074097897233022e-06,8,4,4
25909,tongueincheek,2.3052039770217305e-06,3.6233184351681345e-06,3,1,2
25910,tonight,2.7452883726349685e-05,2.9504164400654783e-05,34,15,19
25911,tonne,2.7452883726349685e-05,3.640572332478458e-05,36,15,21
25912,too,2.095639979110664e-07,3.6233184351681345e-06,3,0,3
25913,took,0.0002642602013658546,0.00026588255755210003,316,140,176
25914,tool,0.0001154697628489974,7.954046660059569e-05,109,59,50
25915,tooth,2.954852370546031e-05,2.6053384938589907e-05,32,15,17
25916,toothles,6.496483935243052e-06,1.8979287041356905e-06,4,3,1
25917,toothpaste,2.3052039770217305e-06,3.6233184351681345e-06,3,1,2
25918,top,0.0005618410783995688,0.0004988101712414799,617,296,321
25919,topic,4.840928351745632e-05,2.9504164400654783e-05,44,26,18
25920,toples,6.496483935243052e-06,1.3975656821362803e-05,11,3,8
25921,topped,8.592123914353715e-06,5.348708166200577e-06,7,4,3
25922,topping,2.3052039770217305e-06,7.074097897233022e-06,6,2,4
25923,topple,1.6974683830796368e-05,2.087721574549256e-05,22,10,12
25924,toppled,1.48790438516857e-05,1.2250267090330355e-05,16,7,9
25925,toppling,2.3052039770217305e-06,7.074097897233022e-06,6,2,4
25926,topsecret,1.278340387257504e-05,8.79948762826546e-06,13,8,5
25927,torch,4.002672360101368e-05,3.468033359375216e-05,40,20,20
25928,torched,2.116596378901769e-05,1.9151826014460126e-05,23,10,13
25929,torching,2.3052039770217305e-06,1.052487735929791e-05,7,1,6
25930,tore,1.0687763893464371e-05,3.6233184351681345e-06,7,5,2
25931,torn,1.48790438516857e-05,5.348708166200577e-06,11,8,3
25932,tornado,1.0687763893464371e-05,8.79948762826546e-06,12,6,6
25933,torpedo,1.0687763893464371e-05,1.052487735929791e-05,12,5,7
25934,torrent,1.0687763893464371e-05,3.6233184351681345e-06,7,5,2
25935,torrential,2.3052039770217305e-06,5.348708166200577e-06,5,1,4
25936,tortoise,1.278340387257504e-05,3.6233184351681345e-06,9,6,3
25937,torture,0.00021396484186719832,0.00020031774777286686,251,115,136
25938,tortured,7.774824322500554e-05,9.334358444885519e-05,99,42,57
25939,torturer,8.592123914353715e-06,1.2250267090330355e-05,12,5,7
25940,torturing,1.278340387257504e-05,2.6053384938589907e-05,26,8,18
25941,torturou,2.095639979110664e-07,3.6233184351681345e-06,3,1,2
25942,tos,1.0687763893464371e-05,1.8979287041356905e-06,6,5,1
25943,tossed,1.0687763893464371e-05,8.79948762826546e-06,11,6,5
25944,total,0.00014900000251476814,9.851975364195259e-05,138,77,61
25945,totaled,4.400843956132392e-06,1.8979287041356905e-06,3,2,1
25946,totaling,8.592123914353715e-06,1.7253897310324457e-07,4,4,0
25947,totalitarian,6.496483935243052e-06,5.348708166200577e-06,7,3,4
25948,totalling,2.3052039770217305e-06,1.2250267090330355e-05,10,1,9
25949,totally,2.954852370546031e-05,5.5385010366141504e-05,55,17,38
25950,touch,3.1644163684570994e-05,3.640572332478458e-05,41,18,23
25951,touched,8.592123914353715e-06,2.2602605476525032e-05,18,5,13
25952,touching,1.278340387257504e-05,1.2250267090330355e-05,13,6,7
25953,tough,9.03220830996695e-05,8.4716635793693e-05,101,46,55
25954,toughen,2.3052039770217305e-06,3.6233184351681345e-06,3,1,2
25955,tougher,4.212236358012434e-05,2.6053384938589907e-05,40,23,17
25956,toughest,2.116596378901769e-05,1.052487735929791e-05,19,10,9
25957,tour,2.326160376812834e-05,3.468033359375216e-05,32,12,20
25958,touring,2.3052039770217305e-06,5.348708166200577e-06,4,1,3
25959,tourism,3.7931083621902995e-05,3.640572332478458e-05,40,19,21
25960,tourist,0.0001343305226609934,0.00012612598933847184,149,69,80
25961,tournament,1.48790438516857e-05,7.074097897233022e-06,12,8,4
25962,tout,1.0687763893464371e-05,1.8979287041356905e-06,7,6,1
25963,touted,1.48790438516857e-05,7.074097897233022e-06,14,7,7
25964,touting,8.592123914353715e-06,3.6233184351681345e-06,7,5,2
25965,toward,0.00023282560167919462,0.0002727841164762295,310,132,178
25966,towed,2.095639979110664e-07,3.6233184351681345e-06,3,0,3
25967,towel,4.400843956132392e-06,1.8979287041356905e-06,4,2,2
25968,tower,1.6974683830796368e-05,2.2602605476525032e-05,21,8,13
25969,towering,2.3052039770217305e-06,1.8979287041356905e-06,3,1,2
25970,town,0.00023911252161652657,0.0002538048294348729,288,129,159
25971,toxic,6.517440335034157e-05,7.954046660059569e-05,88,36,52
25972,toxin,6.496483935243052e-06,3.6233184351681345e-06,6,4,2
25973,toy,3.1644163684570994e-05,3.2954943862719716e-05,39,17,22
25974,trace,2.5357243747239038e-05,2.087721574549256e-05,27,14,13
25975,traced,1.278340387257504e-05,1.2250267090330355e-05,15,8,7
25976,track,9.24177230787802e-05,0.0001019705331040174,111,51,60
25977,tracked,2.116596378901769e-05,1.9151826014460126e-05,21,10,11
25978,tracker,4.400843956132392e-06,3.6233184351681345e-06,4,2,2
25979,tracking,3.1644163684570994e-05,3.8131113055817005e-05,38,16,22
25980,traction,6.496483935243052e-06,3.6233184351681345e-06,5,3,2
25981,tractor,8.592123914353715e-06,3.6233184351681345e-06,7,4,3
25982,trade,0.0002663558413449654,0.000286587234324489,328,139,189
25983,traded,2.116596378901769e-05,1.2250267090330355e-05,21,12,9
25984,trademark,1.48790438516857e-05,1.052487735929791e-05,14,8,6
25985,tradeoff,4.400843956132392e-06,3.6233184351681345e-06,5,2,3
25986,trader,2.954852370546031e-05,2.6053384938589907e-05,33,15,18
25987,trading,6.517440335034157e-05,4.6758061710979285e-05,62,33,29
25988,tradition,5.6791843433898893e-05,6.228656929027126e-05,68,28,40
25989,traditional,5.888748341300963e-05,7.091351794543343e-05,75,30,45
25990,traditionally,1.278340387257504e-05,2.2602605476525032e-05,22,8,14
25991,traffic,0.00010499156295344414,6.056117955923882e-05,99,53,46
25992,trafficked,1.48790438516857e-05,8.79948762826546e-06,13,8,5
25993,trafficker,2.116596378901769e-05,3.2954943862719716e-05,29,10,19
25994,trafficking,9.24177230787802e-05,8.299124606266055e-05,99,48,51
25995,tragedy,6.307876337123095e-05,5.711040009717395e-05,68,31,37
25996,tragic,2.7452883726349685e-05,2.2602605476525032e-05,28,15,13
25997,tragically,4.400843956132392e-06,3.6233184351681345e-06,5,2,3
25998,trail,5.260056347567764e-05,4.1581892517881935e-05,50,25,25
25999,trailer,2.095639979110664e-07,5.348708166200577e-06,4,0,4
26000,trailing,1.0687763893464371e-05,5.348708166200577e-06,9,6,3
26001,train,0.00014271308257743603,0.00013992910718673112,164,74,90
26002,trained,2.326160376812834e-05,4.330728224891437e-05,44,15,29
26003,trainee,6.496483935243052e-06,1.052487735929791e-05,9,3,6
26004,trainer,2.3052039770217305e-06,7.074097897233022e-06,6,1,5
26005,training,9.451336305789087e-05,0.00011059748175917965,119,48,71
26006,trait,6.496483935243052e-06,8.79948762826546e-06,8,3,5
26007,traitor,8.592123914353715e-06,8.79948762826546e-06,11,6,5
26008,trajectory,4.400843956132392e-06,3.6233184351681345e-06,4,2,2
26009,tram,1.0687763893464371e-05,3.6233184351681345e-06,7,5,2
26010,trample,6.496483935243052e-06,1.8979287041356905e-06,5,3,2
26011,trampled,4.400843956132392e-06,3.6233184351681345e-06,4,2,2
26012,trampling,2.095639979110664e-07,5.348708166200577e-06,4,1,3
26013,tran,4.400843956132392e-06,8.79948762826546e-06,8,2,6
26014,transAtlantic,2.095639979110664e-07,5.348708166200577e-06,3,0,3
26015,transaction,3.583544364279237e-05,2.6053384938589907e-05,38,18,20
26016,transatlantic,4.400843956132392e-06,1.8979287041356905e-06,4,2,2
26017,transcript,2.095639979110664e-07,2.087721574549256e-05,13,0,13
26018,transfer,4.4218003559234974e-05,4.6758061710979285e-05,53,22,31
26019,transferred,2.326160376812834e-05,2.4327995207557487e-05,27,12,15
26020,transferring,6.496483935243052e-06,1.052487735929791e-05,10,3,7
26021,transform,2.954852370546031e-05,1.9151826014460126e-05,28,14,14
26022,transformation,1.278340387257504e-05,8.79948762826546e-06,12,7,5
26023,transformative,8.592123914353715e-06,5.348708166200577e-06,7,4,3
26024,transformed,1.278340387257504e-05,8.79948762826546e-06,14,8,6
26025,transforming,6.496483935243052e-06,3.6233184351681345e-06,6,4,2
26026,transfusion,6.496483935243052e-06,1.8979287041356905e-06,5,4,1
26027,transgender,5.050492349656699e-05,4.330728224891437e-05,53,24,29
26028,transit,1.6974683830796368e-05,2.087721574549256e-05,26,11,15
26029,transition,1.9070323809907035e-05,5.5385010366141504e-05,49,12,37
26030,transitional,2.3052039770217305e-06,7.074097897233022e-06,5,1,4
26031,transitioning,2.3052039770217305e-06,3.6233184351681345e-06,3,1,2
26032,translate,1.9070323809907035e-05,1.9151826014460126e-05,25,12,13
26033,translated,6.496483935243052e-06,1.2250267090330355e-05,11,3,8
26034,translation,3.3739803663681634e-05,2.087721574549256e-05,30,18,12
26035,translator,1.278340387257504e-05,5.348708166200577e-06,9,6,3
26036,transmission,1.278340387257504e-05,1.3975656821362803e-05,18,8,10
26037,transmitted,6.496483935243052e-06,1.2250267090330355e-05,11,4,7
26038,transnational,2.095639979110664e-07,3.6233184351681345e-06,3,0,3
26039,transparency,3.583544364279237e-05,2.777877466962238e-05,40,21,19
26040,transparent,1.48790438516857e-05,1.2250267090330355e-05,18,9,9
26041,transplant,1.9070323809907035e-05,3.2954943862719716e-05,31,11,20
26042,transport,3.1644163684570994e-05,2.6053384938589907e-05,36,16,20
26043,transportation,2.954852370546031e-05,3.468033359375216e-05,38,17,21
26044,transported,1.278340387257504e-05,1.8979287041356905e-06,7,6,1
26045,transporting,6.496483935243052e-06,8.79948762826546e-06,8,3,5
26046,transsexual,4.400843956132392e-06,3.6233184351681345e-06,4,2,2
26047,trap,2.116596378901769e-05,3.640572332478458e-05,34,11,23
26048,trapped,5.260056347567764e-05,6.056117955923882e-05,65,25,40
26049,trapping,2.095639979110664e-07,1.052487735929791e-05,7,1,6
26050,trash,3.7931083621902995e-05,2.2602605476525032e-05,33,19,14
26051,trashed,4.400843956132392e-06,3.6233184351681345e-06,4,2,2
26052,trauma,2.5357243747239038e-05,1.742643628342769e-05,25,12,13
26053,traumatic,1.0687763893464371e-05,1.8979287041356905e-06,7,5,2
26054,traumatized,4.400843956132392e-06,1.8979287041356905e-06,3,2,1
26055,travel,0.0001343305226609934,0.00012612598933847184,154,69,85
26056,traveled,2.116596378901769e-05,1.9151826014460126e-05,26,13,13
26057,traveler,1.48790438516857e-05,2.087721574549256e-05,20,8,12
26058,traveling,3.583544364279237e-05,1.3975656821362803e-05,26,18,8
26059,travelled,6.496483935243052e-06,3.6233184351681345e-06,6,3,3
26060,traveller,8.592123914353715e-06,1.2250267090330355e-05,15,5,10
26061,travelling,6.496483935243052e-06,1.9151826014460126e-05,16,3,13
26062,travesty,1.0687763893464371e-05,1.8979287041356905e-06,6,5,1
26063,trawl,2.3052039770217305e-06,1.7253897310324457e-07,3,1,2
26064,trawler,6.496483935243052e-06,7.074097897233022e-06,9,3,6
26065,treacherou,6.496483935243052e-06,1.7253897310324457e-07,3,3,0
26066,tread,2.095639979110664e-07,5.348708166200577e-06,3,0,3
26067,treason,3.1644163684570994e-05,2.2602605476525032e-05,31,16,15
26068,treasonou,2.095639979110664e-07,3.6233184351681345e-06,3,0,3
26069,treasure,3.3739803663681634e-05,2.777877466962238e-05,37,16,21
26070,treasurer,2.3052039770217305e-06,5.348708166200577e-06,5,2,3
26071,treasury,4.400843956132392e-06,7.074097897233022e-06,7,2,5
26072,treat,7.565260324589493e-05,5.883578982820635e-05,84,42,42
26073,treatable,2.3052039770217305e-06,3.6233184351681345e-06,3,1,2
26074,treated,8.403516316233764e-05,6.746273848336857e-05,89,44,45
26075,treating,3.3739803663681634e-05,2.4327995207557487e-05,32,17,15
26076,treatment,0.00015738256243121094,0.00017443690180738014,204,83,121
26077,treaty,8.403516316233764e-05,6.746273848336857e-05,92,43,49
26078,tree,7.984388320411623e-05,7.263890767646595e-05,91,43,48
26079,trek,2.3052039770217305e-06,5.348708166200577e-06,4,1,3
26080,tremendou,1.6974683830796368e-05,2.4327995207557487e-05,24,9,15
26081,tremor,2.3052039770217305e-06,3.6233184351681345e-06,4,2,2
26082,trench,6.496483935243052e-06,1.052487735929791e-05,10,3,7
26083,trend,3.7931083621902995e-05,8.644202552472544e-05,76,21,55
26084,trending,2.3052039770217305e-06,1.3975656821362803e-05,9,1,8
26085,trespas,4.400843956132392e-06,1.8979287041356905e-06,3,2,1
26086,trial,0.0002956948010525145,0.0003003903521727485,345,154,191
26087,triangle,4.400843956132392e-06,5.348708166200577e-06,5,2,3
26088,tribal,2.116596378901769e-05,2.2602605476525032e-05,25,11,14
26089,tribalism,2.095639979110664e-07,7.074097897233022e-06,4,0,4
26090,tribe,5.4696203454788295e-05,5.020884117304414e-05,61,27,34
26091,tribesman,6.496483935243052e-06,3.6233184351681345e-06,6,3,3
26092,tribunal,1.9070323809907035e-05,1.3975656821362803e-05,23,9,14
26093,tribute,1.48790438516857e-05,3.122955413168725e-05,25,7,18
26094,trick,2.954852370546031e-05,3.468033359375216e-05,36,16,20
26095,tricked,1.278340387257504e-05,1.8979287041356905e-06,7,6,1
26096,trickery,4.400843956132392e-06,1.8979287041356905e-06,3,2,1
26097,tricking,6.496483935243052e-06,1.7253897310324457e-07,3,3,0
26098,trickledown,4.400843956132392e-06,7.074097897233022e-06,7,2,5
26099,tricky,6.496483935243052e-06,7.074097897233022e-06,8,3,5
26100,tried,0.00021396484186719832,0.0002020431375038992,244,115,129
26101,trigger,5.050492349656699e-05,2.6053384938589907e-05,42,24,18
26102,triggered,1.48790438516857e-05,1.742643628342769e-05,19,9,10
26103,triggering,1.9070323809907035e-05,3.6233184351681345e-06,13,9,4
26104,trillion,8.613080314144832e-05,9.851975364195259e-05,108,44,64
26105,trim,2.3052039770217305e-06,3.6233184351681345e-06,4,1,3
26106,trimmed,4.400843956132392e-06,1.8979287041356905e-06,3,2,1
26107,trio,6.496483935243052e-06,3.6233184351681345e-06,5,3,2
26108,trip,9.24177230787802e-05,0.00011404826122124471,118,47,71
26109,triple,1.278340387257504e-05,2.2602605476525032e-05,22,7,15
26110,tripled,2.095639979110664e-07,3.6233184351681345e-06,3,0,3
26111,tripped,4.400843956132392e-06,1.8979287041356905e-06,5,3,2
26112,triumph,2.326160376812834e-05,1.052487735929791e-05,17,11,6
26113,triumphant,2.3052039770217305e-06,3.6233184351681345e-06,4,2,2
26114,triumphed,2.3052039770217305e-06,3.6233184351681345e-06,4,1,3
26115,trivial,2.095639979110664e-07,7.074097897233022e-06,5,1,4
26116,troll,1.6974683830796368e-05,2.9504164400654783e-05,26,9,17
26117,trolled,2.095639979110664e-07,5.348708166200577e-06,3,0,3
26118,trolling,1.278340387257504e-05,1.2250267090330355e-05,13,6,7
26119,troop,0.0004151462798618222,0.00046602776635186325,516,212,304
26120,trooper,6.496483935243052e-06,1.8979287041356905e-06,6,4,2
26121,trophy,2.326160376812834e-05,1.742643628342769e-05,21,11,10
26122,tropical,1.9070323809907035e-05,1.3975656821362803e-05,20,12,8
26123,trot,2.095639979110664e-07,3.6233184351681345e-06,3,1,2
26124,trouble,7.774824322500554e-05,7.263890767646595e-05,85,40,45
26125,troubled,3.3739803663681634e-05,2.2602605476525032e-05,32,18,14
26126,troublesome,4.400843956132392e-06,1.7253897310324457e-07,3,2,1
26127,troubling,2.326160376812834e-05,2.4327995207557487e-05,28,11,17
26128,trouser,4.400843956132392e-06,3.6233184351681345e-06,5,3,2
26129,trove,1.0687763893464371e-05,1.3975656821362803e-05,16,6,10
26130,truce,2.7452883726349685e-05,2.9504164400654783e-05,35,13,22
26131,truck,9.03220830996695e-05,6.228656929027126e-05,88,45,43
26132,trucker,6.496483935243052e-06,1.2250267090330355e-05,10,3,7
26133,trucking,2.3052039770217305e-06,3.6233184351681345e-06,3,1,2
26134,true,0.00013223488268188294,0.00016235917369015308,173,66,107
26135,truly,6.307876337123095e-05,6.918812821440096e-05,77,34,43
26136,trump,1.48790438516857e-05,8.79948762826546e-06,14,7,7
26137,trumped,6.496483935243052e-06,1.7253897310324457e-07,3,3,0
26138,trunk,8.592123914353715e-06,5.348708166200577e-06,7,4,3
26139,trust,0.00010499156295344414,8.816741525575797e-05,110,52,58
26140,trusted,2.7452883726349685e-05,1.3975656821362803e-05,23,14,9
26141,trusting,2.095639979110664e-07,7.074097897233022e-06,5,1,4
26142,truth,0.00012175668278632962,0.0001347529379936339,154,66,88
26143,truthful,4.400843956132392e-06,3.6233184351681345e-06,4,2,2
26144,try,0.0002516863614911905,0.0002469032705107427,296,136,160
26145,trying,0.0003711378403004983,0.0004246184128070847,478,198,280
26146,tsar,4.400843956132392e-06,5.348708166200577e-06,5,2,3
26147,tshirt,6.496483935243052e-06,3.6233184351681345e-06,5,3,2
26148,tsunami,6.936568330856297e-05,6.918812821440096e-05,81,37,44
26149,tsunamihit,6.496483935243052e-06,1.7253897310324457e-07,3,3,0
26150,tube,1.0687763893464371e-05,1.2250267090330355e-05,13,6,7
26151,tuberculosi,6.496483935243052e-06,3.6233184351681345e-06,8,5,3
26152,tug,2.3052039770217305e-06,5.348708166200577e-06,4,1,3
26153,tuition,2.7452883726349685e-05,2.2602605476525032e-05,31,17,14
26154,tumble,1.278340387257504e-05,1.052487735929791e-05,13,6,7
26155,tumbled,2.3052039770217305e-06,3.6233184351681345e-06,3,1,2
26156,tumbling,1.0687763893464371e-05,5.348708166200577e-06,8,5,3
26157,tumor,6.496483935243052e-06,7.074097897233022e-06,7,3,4
26158,tumour,2.3052039770217305e-06,7.074097897233022e-06,5,1,4
26159,tumult,6.496483935243052e-06,1.7253897310324457e-07,3,3,0
26160,tuna,1.0687763893464371e-05,2.6053384938589907e-05,25,5,20
26161,tundra,2.095639979110664e-07,3.6233184351681345e-06,3,1,2
26162,tune,1.278340387257504e-05,1.570104655239525e-05,20,8,12
26163,tuned,8.592123914353715e-06,3.6233184351681345e-06,6,4,2
26164,tunnel,6.936568330856297e-05,5.3659620635109e-05,69,36,33
26165,turban,8.592123914353715e-06,1.8979287041356905e-06,7,4,3
26166,turbine,2.326160376812834e-05,2.087721574549256e-05,24,11,13
26167,turbulence,2.3052039770217305e-06,3.6233184351681345e-06,4,1,3
26168,turkey,1.0687763893464371e-05,7.074097897233022e-06,9,5,4
26169,turmoil,2.326160376812834e-05,1.570104655239525e-05,22,13,9
26170,turn,0.0003124599208853996,0.0003159188597520407,379,165,214
26171,turnaround,2.095639979110664e-07,5.348708166200577e-06,3,0,3
26172,turned,0.00017205204228498542,0.0001571830044970555,195,93,102
26173,turning,9.03220830996695e-05,8.644202552472544e-05,109,47,62
26174,turnout,1.48790438516857e-05,2.6053384938589907e-05,26,9,17
26175,turnover,6.496483935243052e-06,3.6233184351681345e-06,6,4,2
26176,turtle,4.002672360101368e-05,1.9151826014460126e-05,33,20,13
26177,tusk,2.116596378901769e-05,1.742643628342769e-05,21,10,11
26178,tweak,6.496483935243052e-06,1.8979287041356905e-06,5,3,2
26179,tweet,0.0001259479627445509,0.0001364783277246665,154,63,91
26180,tweeted,6.72700433294523e-05,7.436429740749831e-05,78,33,45
26181,tweeter,4.400843956132392e-06,1.8979287041356905e-06,3,2,1
26182,tweeting,1.0687763893464371e-05,1.3975656821362803e-05,16,5,11
26183,tweetstorm,2.095639979110664e-07,5.348708166200577e-06,3,0,3
26184,twelve,6.496483935243052e-06,1.052487735929791e-05,9,3,6
26185,twenty,8.592123914353715e-06,1.052487735929791e-05,10,4,6
26186,twice,7.355696326678427e-05,7.436429740749831e-05,89,42,47
26187,twin,2.116596378901769e-05,2.2602605476525032e-05,25,10,15
26188,twist,1.9070323809907035e-05,1.3975656821362803e-05,20,11,9
26189,twisted,8.592123914353715e-06,5.348708166200577e-06,7,4,3
26190,twisting,2.3052039770217305e-06,1.8979287041356905e-06,3,1,2
26191,twitter,1.6974683830796368e-05,5.348708166200577e-06,11,8,3
26192,two,0.0010941336330936768,0.0011665359971510356,1330,569,761
26193,twoandahalf,6.496483935243052e-06,7.074097897233022e-06,7,3,4
26194,twoday,2.3052039770217305e-06,5.348708166200577e-06,4,1,3
26195,twomonth,2.3052039770217305e-06,3.6233184351681345e-06,3,1,2
26196,twoparty,4.400843956132392e-06,3.6233184351681345e-06,4,2,2
26197,twostate,1.0687763893464371e-05,1.742643628342769e-05,17,6,11
26198,twoterm,2.3052039770217305e-06,3.6233184351681345e-06,3,1,2
26199,twothird,3.1644163684570994e-05,2.777877466962238e-05,35,16,19
26200,twoway,6.496483935243052e-06,1.8979287041356905e-06,4,3,1
26201,twoweek,2.3052039770217305e-06,3.6233184351681345e-06,4,2,2
26202,twoyear,1.278340387257504e-05,1.2250267090330355e-05,13,6,7
26203,twoyearold,2.3052039770217305e-06,7.074097897233022e-06,5,1,4
26204,tycoon,2.954852370546031e-05,1.742643628342769e-05,26,15,11
26205,tying,4.400843956132392e-06,1.7253897310324457e-07,5,5,0
26206,type,7.146132328767358e-05,5.883578982820635e-05,73,37,36
26207,typewriter,2.3052039770217305e-06,3.6233184351681345e-06,3,1,2
26208,typhoon,2.116596378901769e-05,1.3975656821362803e-05,19,11,8
26209,typical,2.326160376812834e-05,1.3975656821362803e-05,23,13,10
26210,typically,1.6974683830796368e-05,2.6053384938589907e-05,25,9,16
26211,typo,6.496483935243052e-06,7.074097897233022e-06,7,3,4
26212,tyrannical,6.496483935243052e-06,1.8979287041356905e-06,5,3,2
26213,tyranny,1.278340387257504e-05,1.9151826014460126e-05,18,7,11
26214,tyrant,6.496483935243052e-06,7.074097897233022e-06,8,3,5
26215,ubiquitou,2.3052039770217305e-06,5.348708166200577e-06,4,1,3
26216,uglier,2.3052039770217305e-06,5.348708166200577e-06,4,1,3
26217,ugly,2.5357243747239038e-05,3.122955413168725e-05,39,15,24
26218,ultimate,2.326160376812834e-05,3.640572332478458e-05,34,12,22
26219,ultimately,2.326160376812834e-05,3.468033359375216e-05,32,11,21
26220,ultimatum,1.0687763893464371e-05,1.8979287041356905e-06,7,5,2
26221,ultraOrthodox,1.48790438516857e-05,1.9151826014460126e-05,19,7,12
26222,ultraconservative,2.3052039770217305e-06,1.052487735929791e-05,7,1,6
26223,ultraorthodox,8.592123914353715e-06,1.7253897310324457e-07,4,4,0
26224,ultrasound,2.3052039770217305e-06,3.6233184351681345e-06,3,1,2
26225,umbrella,8.592123914353715e-06,1.3975656821362803e-05,14,5,9
26226,unAmerican,2.3052039770217305e-06,7.074097897233022e-06,6,2,4
26227,unIslamic,1.278340387257504e-05,1.052487735929791e-05,14,6,8
26228,unabated,8.592123914353715e-06,1.8979287041356905e-06,5,4,1
26229,unable,3.7931083621902995e-05,5.3659620635109e-05,54,21,33
26230,unacceptable,4.002672360101368e-05,3.2954943862719716e-05,45,21,24
26231,unacceptably,2.095639979110664e-07,5.348708166200577e-06,3,0,3
26232,unaccompanied,1.0687763893464371e-05,1.8979287041356905e-06,7,6,1
26233,unaccounted,4.400843956132392e-06,1.8979287041356905e-06,4,2,2
26234,unaffected,6.496483935243052e-06,1.8979287041356905e-06,4,3,1
26235,unaffordable,6.496483935243052e-06,1.7253897310324457e-07,4,3,1
26236,unanimou,1.48790438516857e-05,7.074097897233022e-06,11,7,4
26237,unanimously,1.278340387257504e-05,3.640572332478458e-05,30,7,23
26238,unanswered,2.095639979110664e-07,7.074097897233022e-06,4,0,4
26239,unapologetic,2.3052039770217305e-06,3.6233184351681345e-06,3,1,2
26240,unarmed,2.954852370546031e-05,4.50326719799468e-05,47,18,29
26241,unattended,2.3052039770217305e-06,3.6233184351681345e-06,3,1,2
26242,unauthorised,1.0687763893464371e-05,5.348708166200577e-06,9,5,4
26243,unauthorized,1.6974683830796368e-05,7.074097897233022e-06,17,9,8
26244,unavailable,6.496483935243052e-06,1.8979287041356905e-06,5,4,1
26245,unavoidable,4.400843956132392e-06,5.348708166200577e-06,5,2,3
26246,unaware,2.3052039770217305e-06,1.3975656821362803e-05,11,1,10
26247,unbearable,4.400843956132392e-06,5.348708166200577e-06,5,2,3
26248,unbelievable,4.400843956132392e-06,5.348708166200577e-06,6,3,3
26249,unbeliever,2.3052039770217305e-06,3.6233184351681345e-06,3,1,2
26250,unbiased,4.400843956132392e-06,3.6233184351681345e-06,4,2,2
26251,unblock,2.3052039770217305e-06,3.6233184351681345e-06,4,1,3
26252,unborn,2.3052039770217305e-06,1.8979287041356905e-06,3,2,1
26253,unbroken,2.095639979110664e-07,3.6233184351681345e-06,3,0,3
26254,uncertain,1.278340387257504e-05,1.9151826014460126e-05,19,7,12
26255,uncertainty,1.48790438516857e-05,2.4327995207557487e-05,24,7,17
26256,unchanged,2.3052039770217305e-06,5.348708166200577e-06,4,1,3
26257,unchecked,4.400843956132392e-06,1.2250267090330355e-05,10,2,8
26258,unclaimed,2.095639979110664e-07,5.348708166200577e-06,3,0,3
26259,uncle,1.278340387257504e-05,1.570104655239525e-05,15,6,9
26260,unclear,3.3739803663681634e-05,2.9504164400654783e-05,37,17,20
26261,uncomfortable,1.9070323809907035e-05,2.087721574549256e-05,23,10,13
26262,uncommon,4.400843956132392e-06,5.348708166200577e-06,6,2,4
26263,uncompromising,2.3052039770217305e-06,5.348708166200577e-06,4,1,3
26264,unconditional,8.592123914353715e-06,1.052487735929791e-05,10,4,6
26265,unconscionable,4.400843956132392e-06,7.074097897233022e-06,7,3,4
26266,unconsciou,8.592123914353715e-06,7.074097897233022e-06,9,4,5
26267,unconstitutional,4.840928351745632e-05,5.020884117304414e-05,57,25,32
26268,uncontacted,6.496483935243052e-06,1.052487735929791e-05,10,4,6
26269,uncontrollable,4.400843956132392e-06,5.348708166200577e-06,6,3,3
26270,uncontrolled,4.400843956132392e-06,1.8979287041356905e-06,3,2,1
26271,uncontroversial,4.400843956132392e-06,1.8979287041356905e-06,3,2,1
26272,uncover,2.7452883726349685e-05,3.640572332478458e-05,37,14,23
26273,uncovered,4.6313643538345614e-05,3.468033359375216e-05,46,24,22
26274,uncovering,6.496483935243052e-06,1.8979287041356905e-06,4,3,1
26275,undecided,1.0687763893464371e-05,1.7253897310324457e-07,6,5,1
26276,undeclared,6.496483935243052e-06,1.7253897310324457e-07,5,3,2
26277,undemocratic,6.496483935243052e-06,7.074097897233022e-06,7,3,4
26278,undeniable,2.095639979110664e-07,7.074097897233022e-06,4,0,4
26279,undeniably,2.3052039770217305e-06,7.074097897233022e-06,5,1,4
26280,underage,2.5357243747239038e-05,1.2250267090330355e-05,21,14,7
26281,underclas,2.3052039770217305e-06,3.6233184351681345e-06,3,1,2
26282,undercover,2.954852370546031e-05,4.6758061710979285e-05,46,16,30
26283,undercut,1.48790438516857e-05,8.79948762826546e-06,14,8,6
26284,underdog,4.400843956132392e-06,7.074097897233022e-06,6,2,4
26285,underemployed,4.400843956132392e-06,1.8979287041356905e-06,3,2,1
26286,underestimate,6.496483935243052e-06,1.8979287041356905e-06,5,3,2
26287,underestimated,4.400843956132392e-06,1.052487735929791e-05,9,3,6
26288,underestimating,2.3052039770217305e-06,1.8979287041356905e-06,3,1,2
26289,underfunded,2.3052039770217305e-06,3.6233184351681345e-06,3,1,2
26290,undergo,1.48790438516857e-05,1.3975656821362803e-05,17,7,10
26291,undergoing,6.496483935243052e-06,3.6233184351681345e-06,6,3,3
26292,undergraduate,2.3052039770217305e-06,7.074097897233022e-06,5,1,4
26293,underground,4.6313643538345614e-05,5.1934230904076595e-05,57,25,32
26294,underlie,6.496483935243052e-06,1.7253897310324457e-07,3,3,0
26295,underline,2.3052039770217305e-06,3.6233184351681345e-06,4,1,3
26296,underlying,1.6974683830796368e-05,1.3975656821362803e-05,16,8,8
26297,undermine,5.4696203454788295e-05,5.020884117304414e-05,62,27,35
26298,undermined,1.278340387257504e-05,8.79948762826546e-06,13,6,7
26299,undermining,1.48790438516857e-05,2.777877466962238e-05,23,7,16
26300,underneath,4.400843956132392e-06,5.348708166200577e-06,7,3,4
26301,underpay,2.095639979110664e-07,5.348708166200577e-06,3,0,3
26302,underpin,4.400843956132392e-06,1.8979287041356905e-06,3,2,1
26303,underpinning,6.496483935243052e-06,1.7253897310324457e-07,3,3,0
26304,underrepresented,2.3052039770217305e-06,3.6233184351681345e-06,3,1,2
26305,underscore,8.592123914353715e-06,1.570104655239525e-05,14,4,10
26306,underscoring,4.400843956132392e-06,3.6233184351681345e-06,4,2,2
26307,undersea,1.278340387257504e-05,7.074097897233022e-06,12,8,4
26308,underserved,4.400843956132392e-06,1.052487735929791e-05,8,2,6
26309,understand,0.0001154697628489974,0.0001347529379936339,153,65,88
26310,understandable,4.400843956132392e-06,1.052487735929791e-05,8,2,6
26311,understandably,4.400843956132392e-06,1.8979287041356905e-06,3,2,1
26312,understanding,4.840928351745632e-05,3.468033359375216e-05,56,27,29
26313,understatement,8.592123914353715e-06,3.6233184351681345e-06,6,4,2
26314,understood,1.6974683830796368e-05,1.570104655239525e-05,17,8,9
26315,undertake,2.3052039770217305e-06,1.7253897310324457e-07,3,2,1
26316,undertaken,6.496483935243052e-06,3.6233184351681345e-06,5,3,2
26317,undertaking,2.3052039770217305e-06,7.074097897233022e-06,7,2,5
26318,underwater,3.1644163684570994e-05,1.3975656821362803e-05,28,18,10
26319,underway,3.1644163684570994e-05,3.468033359375216e-05,36,16,20
26320,underwear,1.0687763893464371e-05,1.052487735929791e-05,12,6,6
26321,underworld,8.592123914353715e-06,3.6233184351681345e-06,6,4,2
26322,undesirable,2.3052039770217305e-06,3.6233184351681345e-06,3,1,2
26323,undetermined,2.3052039770217305e-06,3.6233184351681345e-06,3,1,2
26324,undisclosed,2.095639979110664e-07,3.6233184351681345e-06,5,0,5
26325,undo,1.278340387257504e-05,1.052487735929791e-05,14,8,6
26326,undocumented,5.888748341300963e-05,6.401195902130366e-05,71,30,41
26327,undoing,4.400843956132392e-06,3.6233184351681345e-06,4,2,2
26328,undone,6.496483935243052e-06,1.8979287041356905e-06,4,3,1
26329,undoubtedly,2.3052039770217305e-06,7.074097897233022e-06,5,1,4
26330,unearth,1.0687763893464371e-05,1.3975656821362803e-05,15,6,9
26331,unearthed,3.583544364279237e-05,3.2954943862719716e-05,41,17,24
26332,unease,4.400843956132392e-06,8.79948762826546e-06,8,3,5
26333,uneasy,4.400843956132392e-06,3.6233184351681345e-06,4,2,2
26334,unelected,4.400843956132392e-06,1.8979287041356905e-06,3,2,1
26335,unemployed,1.0687763893464371e-05,1.9151826014460126e-05,19,6,13
26336,unemployment,9.870464301611217e-05,8.4716635793693e-05,103,48,55
26337,unending,2.3052039770217305e-06,3.6233184351681345e-06,3,1,2
26338,unequal,6.496483935243052e-06,1.3975656821362803e-05,12,4,8
26339,unequivocal,2.3052039770217305e-06,3.6233184351681345e-06,4,2,2
26340,unethical,4.400843956132392e-06,1.8979287041356905e-06,5,3,2
26341,uneven,2.3052039770217305e-06,3.6233184351681345e-06,3,1,2
26342,unexpected,3.583544364279237e-05,2.777877466962238e-05,39,20,19
26343,unexpectedly,8.592123914353715e-06,8.79948762826546e-06,10,5,5
26344,unexplained,6.496483935243052e-06,8.79948762826546e-06,8,3,5
26345,unexploded,6.496483935243052e-06,1.8979287041356905e-06,5,4,1
26346,unfair,3.1644163684570994e-05,3.8131113055817005e-05,40,16,24
26347,unfairly,1.278340387257504e-05,1.3975656821362803e-05,14,6,8
26348,unfamiliar,8.592123914353715e-06,7.074097897233022e-06,11,6,5
26349,unfathomable,2.3052039770217305e-06,1.8979287041356905e-06,4,1,3
26350,unfavorable,4.400843956132392e-06,1.8979287041356905e-06,4,2,2
26351,unfettered,2.3052039770217305e-06,3.6233184351681345e-06,3,1,2
26352,unfiltered,2.3052039770217305e-06,1.8979287041356905e-06,3,2,1
26353,unfinished,6.496483935243052e-06,1.052487735929791e-05,9,3,6
26354,unfit,3.1644163684570994e-05,1.052487735929791e-05,21,15,6
26355,unfold,4.400843956132392e-06,1.8979287041356905e-06,4,2,2
26356,unfolded,1.0687763893464371e-05,7.074097897233022e-06,9,5,4
26357,unfolding,1.48790438516857e-05,1.052487735929791e-05,13,7,6
26358,unforeseen,6.496483935243052e-06,1.7253897310324457e-07,3,3,0
26359,unforgettable,4.400843956132392e-06,1.8979287041356905e-06,3,2,1
26360,unforgivable,2.3052039770217305e-06,3.6233184351681345e-06,3,1,2
26361,unfortunate,6.496483935243052e-06,7.074097897233022e-06,9,3,6
26362,unfortunately,8.592123914353715e-06,1.3975656821362803e-05,12,4,8
26363,unfounded,8.592123914353715e-06,5.348708166200577e-06,7,4,3
26364,unfreeze,4.400843956132392e-06,3.6233184351681345e-06,4,2,2
26365,unfurl,2.3052039770217305e-06,5.348708166200577e-06,4,1,3
26366,unglamorou,2.095639979110664e-07,5.348708166200577e-06,3,0,3
26367,unhappy,1.9070323809907035e-05,1.742643628342769e-05,20,9,11
26368,unhealthy,1.48790438516857e-05,5.348708166200577e-06,10,7,3
26369,unheard,2.3052039770217305e-06,1.8979287041356905e-06,3,1,2
26370,unhelpful,4.400843956132392e-06,5.348708166200577e-06,6,3,3
26371,unhinged,2.3052039770217305e-06,1.2250267090330355e-05,8,1,7
26372,unicorn,4.400843956132392e-06,3.6233184351681345e-06,4,2,2
26373,unidentified,1.48790438516857e-05,8.79948762826546e-06,13,8,5
26374,unification,8.592123914353715e-06,1.7253897310324457e-07,6,4,2
26375,unified,8.592123914353715e-06,1.052487735929791e-05,11,4,7
26376,uniform,2.5357243747239038e-05,2.4327995207557487e-05,28,13,15
26377,uniformed,6.496483935243052e-06,1.8979287041356905e-06,4,3,1
26378,unifying,6.496483935243052e-06,1.7253897310324457e-07,3,3,0
26379,unilateral,1.48790438516857e-05,8.79948762826546e-06,15,9,6
26380,unilaterally,4.400843956132392e-06,8.79948762826546e-06,8,3,5
26381,unimaginable,4.400843956132392e-06,7.074097897233022e-06,7,2,5
26382,uninhabitable,2.095639979110664e-07,5.348708166200577e-06,4,0,4
26383,uninhabited,2.3052039770217305e-06,3.6233184351681345e-06,4,2,2
26384,uninsured,1.6974683830796368e-05,1.570104655239525e-05,19,10,9
26385,unintended,8.592123914353715e-06,5.348708166200577e-06,7,4,3
26386,union,0.00014480872255654665,0.0001485560558418934,176,75,101
26387,unionist,2.095639979110664e-07,7.074097897233022e-06,4,0,4
26388,unionization,8.592123914353715e-06,1.7253897310324457e-07,4,4,0
26389,unionize,4.400843956132392e-06,5.348708166200577e-06,6,3,3
26390,unique,4.840928351745632e-05,4.50326719799468e-05,52,25,27
26391,uniquely,4.400843956132392e-06,3.6233184351681345e-06,6,3,3
26392,unit,9.24177230787802e-05,8.126585633162811e-05,104,51,53
26393,unite,3.7931083621902995e-05,2.6053384938589907e-05,33,18,15
26394,united,2.7452883726349685e-05,2.777877466962238e-05,32,15,17
26395,uniting,4.400843956132392e-06,3.6233184351681345e-06,4,2,2
26396,unity,2.5357243747239038e-05,3.2954943862719716e-05,35,14,21
26397,universal,2.954852370546031e-05,3.2954943862719716e-05,38,15,23
26398,universally,4.400843956132392e-06,1.8979287041356905e-06,3,2,1
26399,universe,3.3739803663681634e-05,4.330728224891437e-05,43,16,27
26400,university,0.00014690436253565753,8.989280498679035e-05,143,79,64
26401,unjust,4.400843956132392e-06,1.742643628342769e-05,13,2,11
26402,unjustified,6.496483935243052e-06,1.8979287041356905e-06,5,3,2
26403,unjustly,4.400843956132392e-06,1.8979287041356905e-06,3,2,1
26404,unknowingly,8.592123914353715e-06,1.8979287041356905e-06,5,4,1
26405,unknown,6.517440335034157e-05,3.468033359375216e-05,55,33,22
26406,unlawful,3.3739803663681634e-05,2.087721574549256e-05,29,16,13
26407,unlawfully,1.278340387257504e-05,1.9151826014460126e-05,19,6,13
26408,unleash,1.9070323809907035e-05,3.6233184351681345e-06,13,9,4
26409,unleashed,1.0687763893464371e-05,1.2250267090330355e-05,15,6,9
26410,unleashing,4.400843956132392e-06,8.79948762826546e-06,7,2,5
26411,unles,7.565260324589493e-05,7.608968713853079e-05,87,41,46
26412,unlike,2.5357243747239038e-05,1.3975656821362803e-05,25,14,11
26413,unlikely,4.212236358012434e-05,4.50326719799468e-05,54,25,29
26414,unlimited,1.48790438516857e-05,1.742643628342769e-05,21,8,13
26415,unload,4.400843956132392e-06,3.6233184351681345e-06,4,2,2
26416,unlock,1.48790438516857e-05,1.3975656821362803e-05,15,7,8
26417,unlocked,2.3052039770217305e-06,3.6233184351681345e-06,3,1,2
26418,unlucky,6.496483935243052e-06,1.7253897310324457e-07,3,3,0
26419,unmanned,1.278340387257504e-05,1.052487735929791e-05,13,7,6
26420,unmarked,2.3052039770217305e-06,1.8979287041356905e-06,3,2,1
26421,unmarried,6.496483935243052e-06,1.8979287041356905e-06,4,3,1
26422,unmask,2.3052039770217305e-06,5.348708166200577e-06,4,1,3
26423,unmasked,6.496483935243052e-06,5.348708166200577e-06,6,3,3
26424,unmatched,4.400843956132392e-06,1.8979287041356905e-06,3,2,1
26425,unmet,4.400843956132392e-06,1.8979287041356905e-06,3,2,1
26426,unnamed,1.48790438516857e-05,1.570104655239525e-05,18,8,10
26427,unnatural,2.3052039770217305e-06,7.074097897233022e-06,5,1,4
26428,unnecessarily,6.496483935243052e-06,3.6233184351681345e-06,7,5,2
26429,unnecessary,3.3739803663681634e-05,2.087721574549256e-05,31,17,14
26430,unnerving,4.400843956132392e-06,1.7253897310324457e-07,4,3,1
26431,unnoticed,2.3052039770217305e-06,7.074097897233022e-06,7,2,5
26432,unofficial,6.496483935243052e-06,1.3975656821362803e-05,11,3,8
26433,unorthodox,2.3052039770217305e-06,3.6233184351681345e-06,3,1,2
26434,unpaid,3.3739803663681634e-05,2.6053384938589907e-05,33,17,16
26435,unpatriotic,4.400843956132392e-06,1.8979287041356905e-06,3,2,1
26436,unplanned,2.3052039770217305e-06,7.074097897233022e-06,5,1,4
26437,unpleasant,8.592123914353715e-06,3.6233184351681345e-06,6,4,2
26438,unplug,2.3052039770217305e-06,3.6233184351681345e-06,3,1,2
26439,unplugged,4.400843956132392e-06,1.8979287041356905e-06,3,2,1
26440,unpopular,3.1644163684570994e-05,1.570104655239525e-05,28,17,11
26441,unpopularity,1.0687763893464371e-05,1.7253897310324457e-07,5,5,0
26442,unprecedented,7.565260324589493e-05,0.0001019705331040174,108,45,63
26443,unpredictability,2.095639979110664e-07,3.6233184351681345e-06,3,1,2
26444,unpredictable,1.278340387257504e-05,1.3975656821362803e-05,14,6,8
26445,unprepared,4.400843956132392e-06,8.79948762826546e-06,9,4,5
26446,unproductive,2.095639979110664e-07,7.074097897233022e-06,4,0,4
26447,unprofessional,4.400843956132392e-06,1.8979287041356905e-06,3,2,1
26448,unprotected,2.3052039770217305e-06,3.6233184351681345e-06,3,1,2
26449,unpublished,2.095639979110664e-07,7.074097897233022e-06,4,0,4
26450,unravel,8.592123914353715e-06,3.6233184351681345e-06,6,4,2
26451,unraveled,2.095639979110664e-07,3.6233184351681345e-06,3,0,3
26452,unraveling,8.592123914353715e-06,5.348708166200577e-06,7,4,3
26453,unravelling,2.095639979110664e-07,5.348708166200577e-06,3,0,3
26454,unrealistic,6.496483935243052e-06,5.348708166200577e-06,6,3,3
26455,unreasonable,4.400843956132392e-06,1.570104655239525e-05,11,2,9
26456,unrecognized,4.400843956132392e-06,1.8979287041356905e-06,4,2,2
26457,unregistered,6.496483935243052e-06,1.7253897310324457e-07,3,3,0
26458,unregulated,6.496483935243052e-06,3.6233184351681345e-06,6,3,3
26459,unrelated,8.592123914353715e-06,5.348708166200577e-06,7,4,3
26460,unrelenting,4.400843956132392e-06,1.7253897310324457e-07,3,3,0
26461,unreliable,4.400843956132392e-06,1.8979287041356905e-06,5,3,2
26462,unreported,1.278340387257504e-05,7.074097897233022e-06,10,6,4
26463,unresolved,2.3052039770217305e-06,3.6233184351681345e-06,3,1,2
26464,unrest,6.936568330856297e-05,5.5385010366141504e-05,68,34,34
26465,unrestricted,2.3052039770217305e-06,1.8979287041356905e-06,4,2,2
26466,unsafe,6.496483935243052e-06,1.052487735929791e-05,10,3,7
26467,unsanctioned,6.496483935243052e-06,1.7253897310324457e-07,3,3,0
26468,unsatisfactory,2.095639979110664e-07,3.6233184351681345e-06,3,0,3
26469,unscientific,2.3052039770217305e-06,3.6233184351681345e-06,3,1,2
26470,unscrupulou,4.400843956132392e-06,7.074097897233022e-06,6,2,4
26471,unsealed,6.496483935243052e-06,1.7253897310324457e-07,3,3,0
26472,unseat,4.400843956132392e-06,3.6233184351681345e-06,5,2,3
26473,unseen,6.496483935243052e-06,1.052487735929791e-05,10,3,7
26474,unsettled,6.496483935243052e-06,1.8979287041356905e-06,5,3,2
26475,unsettling,4.400843956132392e-06,1.7253897310324457e-07,3,2,1
26476,unsold,2.3052039770217305e-06,7.074097897233022e-06,6,1,5
26477,unsolicited,4.400843956132392e-06,1.8979287041356905e-06,3,2,1
26478,unsophisticated,6.496483935243052e-06,1.7253897310324457e-07,3,3,0
26479,unspeakable,2.095639979110664e-07,5.348708166200577e-06,3,0,3
26480,unspecified,6.496483935243052e-06,8.79948762826546e-06,8,3,5
26481,unspoken,2.095639979110664e-07,3.6233184351681345e-06,3,0,3
26482,unstable,1.0687763893464371e-05,3.6233184351681345e-06,8,5,3
26483,unstoppable,4.400843956132392e-06,3.6233184351681345e-06,4,2,2
26484,unsubstantiated,1.278340387257504e-05,5.348708166200577e-06,10,6,4
26485,unsuccessful,4.400843956132392e-06,5.348708166200577e-06,6,3,3
26486,unsure,8.592123914353715e-06,5.348708166200577e-06,9,5,4
26487,unsurprisingly,2.3052039770217305e-06,3.6233184351681345e-06,3,1,2
26488,unsuspecting,2.3052039770217305e-06,3.6233184351681345e-06,3,1,2
26489,unsustainable,1.278340387257504e-05,1.052487735929791e-05,12,6,6
26490,untapped,4.400843956132392e-06,8.79948762826546e-06,7,2,5
26491,untenable,6.496483935243052e-06,1.7253897310324457e-07,3,3,0
26492,untested,6.496483935243052e-06,1.8979287041356905e-06,5,4,1
26493,unthinkable,1.278340387257504e-05,1.2250267090330355e-05,15,6,9
26494,unto,6.496483935243052e-06,3.6233184351681345e-06,5,3,2
26495,untold,4.400843956132392e-06,1.8979287041356905e-06,3,2,1
26496,untouchable,1.278340387257504e-05,1.7253897310324457e-07,6,6,0
26497,untouched,1.48790438516857e-05,8.79948762826546e-06,12,7,5
26498,untreated,2.3052039770217305e-06,5.348708166200577e-06,4,1,3
26499,untrue,6.496483935243052e-06,3.6233184351681345e-06,7,4,3
26500,untrustworthy,6.496483935243052e-06,1.7253897310324457e-07,3,3,0
26501,unused,2.3052039770217305e-06,5.348708166200577e-06,5,1,4
26502,unusual,3.3739803663681634e-05,5.711040009717395e-05,54,18,36
26503,unusually,1.6974683830796368e-05,1.570104655239525e-05,19,10,9
26504,unvaccinated,4.400843956132392e-06,7.074097897233022e-06,8,3,5
26505,unveil,4.212236358012434e-05,4.1581892517881935e-05,48,22,26
26506,unveiled,4.6313643538345614e-05,4.6758061710979285e-05,51,22,29
26507,unveiling,4.400843956132392e-06,3.6233184351681345e-06,6,4,2
26508,unverified,4.400843956132392e-06,1.8979287041356905e-06,3,2,1
26509,unwanted,1.0687763893464371e-05,1.742643628342769e-05,18,5,13
26510,unwarranted,4.400843956132392e-06,3.6233184351681345e-06,4,2,2
26511,unwelcome,2.3052039770217305e-06,7.074097897233022e-06,7,1,6
26512,unwilling,1.0687763893464371e-05,3.6233184351681345e-06,7,5,2
26513,unwillingnes,4.400843956132392e-06,7.074097897233022e-06,6,2,4
26514,unwittingly,6.496483935243052e-06,5.348708166200577e-06,7,3,4
26515,up,6.496483935243052e-06,1.052487735929791e-05,11,4,7
26516,upcoming,5.6791843433898893e-05,4.330728224891437e-05,53,27,26
26517,update,4.840928351745632e-05,4.50326719799468e-05,53,23,30
26518,updated,1.278340387257504e-05,1.2250267090330355e-05,15,7,8
26519,updating,2.095639979110664e-07,7.074097897233022e-06,4,0,4
26520,upend,2.3052039770217305e-06,8.79948762826546e-06,7,1,6
26521,upended,2.3052039770217305e-06,7.074097897233022e-06,6,1,5
26522,upgrade,2.5357243747239038e-05,1.2250267090330355e-05,23,13,10
26523,upgraded,2.095639979110664e-07,8.79948762826546e-06,6,0,6
26524,upgrading,2.3052039770217305e-06,5.348708166200577e-06,5,2,3
26525,upheaval,4.400843956132392e-06,5.348708166200577e-06,7,3,4
26526,upheld,2.7452883726349685e-05,1.3975656821362803e-05,22,14,8
26527,uphill,2.3052039770217305e-06,1.3975656821362803e-05,13,3,10
26528,uphold,2.5357243747239038e-05,2.9504164400654783e-05,33,13,20
26529,upholding,4.400843956132392e-06,1.8979287041356905e-06,3,2,1
26530,upload,8.592123914353715e-06,8.79948762826546e-06,11,5,6
26531,uploaded,1.278340387257504e-05,8.79948762826546e-06,12,6,6
26532,uploading,4.400843956132392e-06,3.6233184351681345e-06,4,2,2
26533,upon,7.774824322500554e-05,7.091351794543343e-05,82,38,44
26534,upordown,6.496483935243052e-06,1.7253897310324457e-07,3,3,0
26535,upper,2.7452883726349685e-05,1.742643628342769e-05,26,14,12
26536,upping,6.496483935243052e-06,3.6233184351681345e-06,6,3,3
26537,uprising,4.840928351745632e-05,5.020884117304414e-05,64,25,39
26538,uproar,6.496483935243052e-06,2.087721574549256e-05,17,4,13
26539,uprooted,6.496483935243052e-06,1.8979287041356905e-06,4,3,1
26540,upscale,4.400843956132392e-06,1.8979287041356905e-06,3,2,1
26541,upset,4.6313643538345614e-05,3.468033359375216e-05,45,24,21
26542,upside,1.0687763893464371e-05,1.3975656821362803e-05,15,5,10
26543,upstate,4.400843956132392e-06,1.8979287041356905e-06,3,2,1
26544,uptick,8.592123914353715e-06,7.074097897233022e-06,9,4,5
26545,upto,4.400843956132392e-06,1.8979287041356905e-06,4,2,2
26546,upvote,2.3052039770217305e-06,3.6233184351681345e-06,3,1,2
26547,upward,4.400843956132392e-06,1.2250267090330355e-05,10,3,7
26548,uranium,4.212236358012434e-05,4.330728224891437e-05,48,22,26
26549,urban,4.002672360101368e-05,4.8483451442011706e-05,52,21,31
26550,urge,0.00013642616264010403,0.00016926073261428268,184,72,112
26551,urged,0.00010080028299522283,0.0001036959228350498,116,52,64
26552,urgency,8.592123914353715e-06,1.570104655239525e-05,13,4,9
26553,urgent,3.1644163684570994e-05,4.1581892517881935e-05,43,17,26
26554,urgently,6.496483935243052e-06,8.79948762826546e-06,8,3,5
26555,urging,4.212236358012434e-05,5.3659620635109e-05,58,23,35
26556,urinate,6.496483935243052e-06,3.6233184351681345e-06,5,3,2
26557,urinating,8.592123914353715e-06,3.6233184351681345e-06,7,4,3
26558,urine,1.0687763893464371e-05,7.074097897233022e-06,10,5,5
26559,us,4.400843956132392e-06,7.074097897233022e-06,9,4,5
26560,usable,2.3052039770217305e-06,3.6233184351681345e-06,3,1,2
26561,usage,2.326160376812834e-05,1.052487735929791e-05,20,13,7
26562,use,0.0007022489569999832,0.0007403647335860221,866,376,490
26563,used,0.0005492672385249046,0.0005350433555931611,658,297,361
26564,useful,1.9070323809907035e-05,1.742643628342769e-05,22,11,11
26565,useles,2.326160376812834e-05,1.3975656821362803e-05,23,12,11
26566,user,0.00027683404124051843,0.0002469032705107427,302,142,160
26567,users,2.3052039770217305e-06,5.348708166200577e-06,4,1,3
26568,usher,8.592123914353715e-06,7.074097897233022e-06,8,4,4
26569,ushered,2.095639979110664e-07,5.348708166200577e-06,3,0,3
26570,using,0.0003711378403004983,0.0004125406846898576,464,194,270
26571,usual,2.326160376812834e-05,2.777877466962238e-05,31,12,19
26572,usually,4.6313643538345614e-05,5.1934230904076595e-05,59,23,36
26573,uteru,2.3052039770217305e-06,5.348708166200577e-06,4,1,3
26574,utility,1.9070323809907035e-05,2.4327995207557487e-05,27,10,17
26575,utilize,4.400843956132392e-06,1.8979287041356905e-06,4,2,2
26576,utmost,2.3052039770217305e-06,5.348708166200577e-06,4,1,3
26577,utopia,4.400843956132392e-06,7.074097897233022e-06,6,2,4
26578,utopian,4.400843956132392e-06,1.7253897310324457e-07,3,3,0
26579,utter,1.278340387257504e-05,1.052487735929791e-05,13,6,7
26580,utterly,8.592123914353715e-06,1.2250267090330355e-05,12,5,7
26581,vacancy,4.400843956132392e-06,1.052487735929791e-05,9,2,7
26582,vacant,8.592123914353715e-06,5.348708166200577e-06,8,4,4
26583,vacated,4.400843956132392e-06,3.6233184351681345e-06,6,3,3
26584,vacation,3.1644163684570994e-05,3.2954943862719716e-05,35,15,20
26585,vacationing,2.3052039770217305e-06,1.8979287041356905e-06,3,2,1
26586,vaccinate,6.496483935243052e-06,1.8979287041356905e-06,4,3,1
26587,vaccinated,1.0687763893464371e-05,8.79948762826546e-06,11,5,6
26588,vaccination,3.1644163684570994e-05,2.9504164400654783e-05,34,16,18
26589,vaccinator,6.496483935243052e-06,5.348708166200577e-06,6,3,3
26590,vaccine,9.660900303700153e-05,6.573734875233614e-05,96,48,48
26591,vacuum,1.0687763893464371e-05,7.074097897233022e-06,11,6,5
26592,vagina,6.496483935243052e-06,5.348708166200577e-06,8,3,5
26593,vague,2.116596378901769e-05,8.79948762826546e-06,15,10,5
26594,vaguely,2.3052039770217305e-06,3.6233184351681345e-06,3,1,2
26595,vain,8.592123914353715e-06,3.6233184351681345e-06,6,4,2
26596,valiant,2.095639979110664e-07,3.6233184351681345e-06,3,0,3
26597,valid,1.278340387257504e-05,1.052487735929791e-05,15,6,9
26598,validate,6.496483935243052e-06,1.8979287041356905e-06,4,3,1
26599,validity,2.3052039770217305e-06,1.8979287041356905e-06,3,2,1
26600,valley,4.400843956132392e-06,5.348708166200577e-06,5,2,3
26601,valuable,3.583544364279237e-05,4.1581892517881935e-05,45,18,27
26602,valuation,6.496483935243052e-06,5.348708166200577e-06,6,3,3
26603,value,0.00019510408205520246,0.0002141208656211263,233,98,135
26604,valued,1.278340387257504e-05,1.052487735929791e-05,13,7,6
26605,vampire,4.400843956132392e-06,7.074097897233022e-06,7,2,5
26606,van,4.002672360101368e-05,5.348708166200577e-06,25,20,5
26607,vandal,4.400843956132392e-06,5.348708166200577e-06,6,3,3
26608,vandalised,6.496483935243052e-06,1.8979287041356905e-06,4,3,1
26609,vandalism,1.0687763893464371e-05,1.052487735929791e-05,11,5,6
26610,vandalize,4.400843956132392e-06,3.6233184351681345e-06,5,2,3
26611,vandalized,2.3052039770217305e-06,5.348708166200577e-06,5,1,4
26612,vandalizing,4.400843956132392e-06,1.8979287041356905e-06,4,2,2
26613,vanguard,2.3052039770217305e-06,1.8979287041356905e-06,3,1,2
26614,vanish,1.278340387257504e-05,1.3975656821362803e-05,15,7,8
26615,vanished,1.6974683830796368e-05,7.074097897233022e-06,13,9,4
26616,vanishing,8.592123914353715e-06,3.6233184351681345e-06,7,4,3
26617,variant,4.400843956132392e-06,5.348708166200577e-06,6,2,4
26618,variety,1.48790438516857e-05,1.9151826014460126e-05,19,8,11
26619,variou,1.48790438516857e-05,2.087721574549256e-05,26,8,18
26620,vary,2.095639979110664e-07,1.2250267090330355e-05,7,0,7
26621,varying,6.496483935243052e-06,3.6233184351681345e-06,5,3,2
26622,vasectomy,4.400843956132392e-06,1.8979287041356905e-06,3,2,1
26623,vassal,4.400843956132392e-06,1.8979287041356905e-06,3,2,1
26624,vast,6.098312339212028e-05,7.436429740749831e-05,76,30,46
26625,vastly,1.0687763893464371e-05,7.074097897233022e-06,10,6,4
26626,vault,1.0687763893464371e-05,7.074097897233022e-06,11,6,5
26627,ve,0.00012385232276544028,0.00011577365095227703,138,64,74
26628,vegetable,2.116596378901769e-05,8.79948762826546e-06,17,10,7
26629,vegetarian,2.3052039770217305e-06,7.074097897233022e-06,5,1,4
26630,vegetarianism,4.400843956132392e-06,1.8979287041356905e-06,3,2,1
26631,vegetation,2.3052039770217305e-06,3.6233184351681345e-06,3,1,2
26632,veggie,4.400843956132392e-06,3.6233184351681345e-06,4,2,2
26633,vehement,2.095639979110664e-07,5.348708166200577e-06,3,0,3
26634,vehemently,6.496483935243052e-06,1.7253897310324457e-07,4,4,0
26635,vehicle,0.00013642616264010403,0.00012094982014537423,151,73,78
26636,veil,4.4218003559234974e-05,5.1934230904076595e-05,64,26,38
26637,veiled,1.0687763893464371e-05,8.79948762826546e-06,12,6,6
26638,vein,2.095639979110664e-07,5.348708166200577e-06,3,0,3
26639,vendor,2.116596378901769e-05,8.79948762826546e-06,16,11,5
26640,vengeance,1.0687763893464371e-05,3.6233184351681345e-06,7,5,2
26641,venom,2.3052039770217305e-06,3.6233184351681345e-06,3,1,2
26642,venomou,2.3052039770217305e-06,7.074097897233022e-06,5,1,4
26643,vent,4.400843956132392e-06,1.8979287041356905e-06,3,2,1
26644,venture,2.7452883726349685e-05,1.3975656821362803e-05,23,14,9
26645,venue,2.326160376812834e-05,2.4327995207557487e-05,25,11,14
26646,verbal,4.400843956132392e-06,5.348708166200577e-06,5,2,3
26647,verbally,2.095639979110664e-07,7.074097897233022e-06,4,0,4
26648,verdict,2.7452883726349685e-05,4.1581892517881935e-05,37,13,24
26649,verge,2.954852370546031e-05,3.468033359375216e-05,40,15,25
26650,verifiable,4.400843956132392e-06,1.8979287041356905e-06,3,2,1
26651,verified,2.095639979110664e-07,7.074097897233022e-06,5,0,5
26652,verify,2.3052039770217305e-06,5.348708166200577e-06,7,1,6
26653,verse,8.592123914353715e-06,3.6233184351681345e-06,6,4,2
26654,version,7.565260324589493e-05,8.644202552472544e-05,97,41,56
26655,versu,2.326160376812834e-05,2.087721574549256e-05,24,12,12
26656,vertical,4.400843956132392e-06,7.074097897233022e-06,8,3,5
26657,vessel,5.6791843433898893e-05,8.299124606266055e-05,78,28,50
26658,vest,1.9070323809907035e-05,1.2250267090330355e-05,18,10,8
26659,vet,1.9070323809907035e-05,1.2250267090330355e-05,18,10,8
26660,veteran,0.00011756540282810809,0.0001382037174556987,155,66,89
26661,veto,4.002672360101368e-05,4.330728224891437e-05,48,21,27
26662,vetoed,1.48790438516857e-05,3.6233184351681345e-06,12,8,4
26663,vetted,8.592123914353715e-06,1.2250267090330355e-05,11,4,7
26664,vetting,6.496483935243052e-06,5.348708166200577e-06,6,3,3
26665,via,6.098312339212028e-05,6.401195902130366e-05,69,30,39
26666,viability,2.3052039770217305e-06,3.6233184351681345e-06,3,1,2
26667,viable,1.0687763893464371e-05,1.742643628342769e-05,16,6,10
26668,vibrant,8.592123914353715e-06,8.79948762826546e-06,9,4,5
26669,vice,8.613080314144832e-05,0.0001036959228350498,113,44,69
26670,vicepresident,6.496483935243052e-06,8.79948762826546e-06,8,3,5
26671,viceversa,2.3052039770217305e-06,1.8979287041356905e-06,3,1,2
26672,viciou,1.6974683830796368e-05,2.2602605476525032e-05,23,8,15
26673,viciously,6.496483935243052e-06,1.7253897310324457e-07,4,3,1
26674,victim,0.00038790296013338374,0.0003780328900692085,452,206,246
26675,victimization,2.3052039770217305e-06,1.8979287041356905e-06,3,1,2
26676,victimized,2.095639979110664e-07,5.348708166200577e-06,4,0,4
26677,victoriou,2.095639979110664e-07,5.348708166200577e-06,3,0,3
26678,victory,0.00016786076232676425,0.0001589083942280881,199,90,109
26679,vid,1.0687763893464371e-05,1.2250267090330355e-05,15,8,7
26680,video,0.000459154719423146,0.0004315199717312144,532,239,293
26681,videotape,4.400843956132392e-06,1.8979287041356905e-06,4,2,2
26682,videotaped,2.3052039770217305e-06,5.348708166200577e-06,4,1,3
26683,view,0.0002097735619089774,0.00018824001965563945,228,112,116
26684,viewed,2.326160376812834e-05,1.9151826014460126e-05,23,12,11
26685,viewer,1.48790438516857e-05,2.4327995207557487e-05,23,8,15
26686,viewing,1.0687763893464371e-05,2.087721574549256e-05,17,5,12
26687,viewpoint,8.592123914353715e-06,3.6233184351681345e-06,7,5,2
26688,vigil,4.400843956132392e-06,8.79948762826546e-06,8,3,5
26689,vigilant,1.6974683830796368e-05,5.348708166200577e-06,12,8,4
26690,vigilante,2.116596378901769e-05,2.6053384938589907e-05,27,11,16
26691,vigorou,4.400843956132392e-06,1.8979287041356905e-06,3,2,1
26692,vigorously,4.400843956132392e-06,1.8979287041356905e-06,4,2,2
26693,vile,4.400843956132392e-06,7.074097897233022e-06,6,2,4
26694,villa,4.400843956132392e-06,1.7253897310324457e-07,3,3,0
26695,village,0.00019510408205520246,0.00016753534288325053,212,102,110
26696,villager,3.7931083621902995e-05,3.985650278684949e-05,42,19,23
26697,villain,1.278340387257504e-05,1.8979287041356905e-06,7,6,1
26698,vineyard,4.400843956132392e-06,3.6233184351681345e-06,5,3,2
26699,vintage,2.3052039770217305e-06,1.8979287041356905e-06,3,1,2
26700,violate,8.403516316233764e-05,8.644202552472544e-05,103,46,57
26701,violated,5.260056347567764e-05,4.50326719799468e-05,52,25,27
26702,violating,5.050492349656699e-05,3.122955413168725e-05,48,28,20
26703,violation,0.00011966104280721883,0.00011059748175917965,135,63,72
26704,violence,0.0004486765195275927,0.0003935613976485007,498,241,257
26705,violent,0.00012385232276544028,9.851975364195259e-05,132,68,64
26706,violently,1.278340387257504e-05,1.2250267090330355e-05,14,6,8
26707,violin,6.496483935243052e-06,1.8979287041356905e-06,4,3,1
26708,viral,3.7931083621902995e-05,5.711040009717395e-05,55,19,36
26709,virgin,8.592123914353715e-06,3.6233184351681345e-06,6,4,2
26710,virginity,8.592123914353715e-06,1.570104655239525e-05,14,4,10
26711,virtual,1.48790438516857e-05,1.2250267090330355e-05,15,7,8
26712,virtually,3.583544364279237e-05,2.6053384938589907e-05,37,20,17
26713,virtue,8.592123914353715e-06,7.074097897233022e-06,9,4,5
26714,virtuou,4.400843956132392e-06,1.8979287041356905e-06,3,2,1
26715,viru,0.0001531912824729893,0.0001364783277246665,167,79,88
26716,virulent,8.592123914353715e-06,3.6233184351681345e-06,7,4,3
26717,visa,6.307876337123095e-05,5.3659620635109e-05,65,32,33
26718,visafree,4.400843956132392e-06,1.8979287041356905e-06,3,2,1
26719,visibility,2.095639979110664e-07,8.79948762826546e-06,6,0,6
26720,visible,2.5357243747239038e-05,2.2602605476525032e-05,28,13,15
26721,vision,6.098312339212028e-05,5.3659620635109e-05,62,30,32
26722,visionary,4.400843956132392e-06,8.79948762826546e-06,7,2,5
26723,visit,0.0002181561218254202,0.0002106700861590614,239,107,132
26724,visited,2.954852370546031e-05,3.640572332478458e-05,40,16,24
26725,visiting,4.002672360101368e-05,3.468033359375216e-05,41,20,21
26726,visitor,3.3739803663681634e-05,2.4327995207557487e-05,34,18,16
26727,visual,4.400843956132392e-06,3.6233184351681345e-06,4,2,2
26728,visually,4.400843956132392e-06,3.6233184351681345e-06,4,2,2
26729,vital,3.583544364279237e-05,4.330728224891437e-05,47,18,29
26730,vitally,4.400843956132392e-06,1.8979287041356905e-06,3,2,1
26731,vitamin,2.095639979110664e-07,7.074097897233022e-06,5,1,4
26732,vocabulary,6.496483935243052e-06,7.074097897233022e-06,7,3,4
26733,vocal,2.5357243747239038e-05,7.074097897233022e-06,19,12,7
26734,vodka,1.0687763893464371e-05,7.074097897233022e-06,10,5,5
26735,voice,9.660900303700153e-05,0.00011232287149021227,128,51,77
26736,voiced,6.496483935243052e-06,7.074097897233022e-06,9,3,6
26737,voicemail,8.592123914353715e-06,5.348708166200577e-06,8,5,3
26738,voicing,4.400843956132392e-06,1.8979287041356905e-06,3,2,1
26739,void,6.496483935243052e-06,1.2250267090330355e-05,10,3,7
26740,volatile,4.400843956132392e-06,1.570104655239525e-05,11,2,9
26741,volatility,2.095639979110664e-07,7.074097897233022e-06,5,1,4
26742,volcanic,6.496483935243052e-06,3.6233184351681345e-06,5,3,2
26743,volcano,4.6313643538345614e-05,7.091351794543343e-05,66,22,44
26744,volleyball,2.095639979110664e-07,5.348708166200577e-06,3,0,3
26745,volume,3.1644163684570994e-05,1.2250267090330355e-05,22,15,7
26746,voluntarily,6.496483935243052e-06,1.052487735929791e-05,10,3,7
26747,voluntary,8.592123914353715e-06,8.79948762826546e-06,11,4,7
26748,volunteer,4.002672360101368e-05,7.091351794543343e-05,65,21,44
26749,volunteered,2.3052039770217305e-06,5.348708166200577e-06,4,1,3
26750,volunteering,6.496483935243052e-06,8.79948762826546e-06,9,4,5
26751,vomit,4.400843956132392e-06,3.6233184351681345e-06,4,2,2
26752,vomiting,2.3052039770217305e-06,1.8979287041356905e-06,3,1,2
26753,von,2.3052039770217305e-06,7.074097897233022e-06,5,1,4
26754,vote,0.0006456666775639949,0.0006678983648826593,781,340,441
26755,votebuying,4.400843956132392e-06,3.6233184351681345e-06,4,2,2
26756,voted,0.00016366948236854273,0.00016926073261428268,197,88,109
26757,voter,0.00034179888059294886,0.00041771685388295495,449,186,263
26758,voting,0.0001385218026192147,0.00014337988664879628,178,76,102
26759,vouch,2.3052039770217305e-06,3.6233184351681345e-06,3,1,2
26760,voucher,4.400843956132392e-06,1.052487735929791e-05,8,2,6
26761,vow,9.870464301611217e-05,0.0001036959228350498,122,55,67
26762,vowed,4.002672360101368e-05,5.1934230904076595e-05,57,24,33
26763,vowing,1.278340387257504e-05,5.348708166200577e-06,10,7,3
26764,voyage,2.3052039770217305e-06,5.348708166200577e-06,4,1,3
26765,vulgar,6.496483935243052e-06,7.074097897233022e-06,7,3,4
26766,vulnerability,8.592123914353715e-06,1.2250267090330355e-05,11,4,7
26767,vulnerable,5.888748341300963e-05,5.020884117304414e-05,66,30,36
26768,vulture,8.592123914353715e-06,1.7253897310324457e-07,4,4,0
26769,vying,8.592123914353715e-06,1.7253897310324457e-07,5,4,1
26770,wacky,2.095639979110664e-07,5.348708166200577e-06,3,0,3
26771,wade,4.400843956132392e-06,3.6233184351681345e-06,4,2,2
26772,waded,2.3052039770217305e-06,7.074097897233022e-06,6,2,4
26773,wage,0.0001385218026192147,0.0001278513790695043,159,72,87
26774,waged,8.592123914353715e-06,8.79948762826546e-06,10,4,6
26775,wager,2.3052039770217305e-06,3.6233184351681345e-06,3,1,2
26776,waging,1.9070323809907035e-05,2.2602605476525032e-05,25,11,14
26777,waist,4.400843956132392e-06,1.8979287041356905e-06,3,2,1
26778,wait,6.517440335034157e-05,7.781507686956326e-05,89,36,53
26779,waited,1.0687763893464371e-05,1.2250267090330355e-05,14,6,8
26780,waiting,6.517440335034157e-05,8.644202552472544e-05,90,32,58
26781,waitres,8.592123914353715e-06,7.074097897233022e-06,8,4,4
26782,waive,2.3052039770217305e-06,3.6233184351681345e-06,4,2,2
26783,waiver,4.400843956132392e-06,8.79948762826546e-06,8,2,6
26784,wake,8.822644312055891e-05,9.851975364195259e-05,110,48,62
26785,wakeup,6.496483935243052e-06,7.074097897233022e-06,8,3,5
26786,waking,2.3052039770217305e-06,5.348708166200577e-06,4,1,3
26787,walk,0.00012385232276544028,7.781507686956326e-05,114,64,50
26788,walked,3.3739803663681634e-05,3.640572332478458e-05,44,21,23
26789,walker,2.095639979110664e-07,5.348708166200577e-06,4,0,4
26790,walking,2.954852370546031e-05,4.1581892517881935e-05,38,14,24
26791,walkout,1.6974683830796368e-05,1.052487735929791e-05,15,8,7
26792,wall,0.00010918284291166549,0.00012094982014537423,130,56,74
26793,walled,2.3052039770217305e-06,3.6233184351681345e-06,3,1,2
26794,wallet,2.954852370546031e-05,2.2602605476525032e-05,30,16,14
26795,wand,2.3052039770217305e-06,3.6233184351681345e-06,3,1,2
26796,wander,4.400843956132392e-06,1.7253897310324457e-07,3,2,1
26797,wandering,4.400843956132392e-06,3.6233184351681345e-06,6,2,4
26798,wane,8.592123914353715e-06,1.7253897310324457e-07,4,4,0
26799,waning,6.496483935243052e-06,1.7253897310324457e-07,3,3,0
26800,wanna,6.496483935243052e-06,1.8979287041356905e-06,4,3,1
26801,wannabe,4.400843956132392e-06,1.8979287041356905e-06,4,3,1
26802,want,0.0012911237911300791,0.0012251992480061388,1492,672,820
26803,wanted,0.0002160604818463093,0.00018824001965563945,234,116,118
26804,wanting,1.9070323809907035e-05,2.6053384938589907e-05,25,9,16
26805,wanton,2.3052039770217305e-06,1.8979287041356905e-06,3,1,2
26806,war,0.001171672312320771,0.0011182250846821277,1351,609,742
26807,ward,1.0687763893464371e-05,8.79948762826546e-06,10,5,5
26808,wardrobe,2.3052039770217305e-06,7.074097897233022e-06,5,1,4
26809,warehouse,1.0687763893464371e-05,1.052487735929791e-05,15,7,8
26810,warfare,2.7452883726349685e-05,2.2602605476525032e-05,30,16,14
26811,warhead,2.326160376812834e-05,2.777877466962238e-05,29,12,17
26812,warlord,1.278340387257504e-05,8.79948762826546e-06,12,6,6
26813,warm,2.954852370546031e-05,3.122955413168725e-05,36,16,20
26814,warmer,6.496483935243052e-06,1.2250267090330355e-05,10,3,7
26815,warmest,4.400843956132392e-06,8.79948762826546e-06,9,2,7
26816,warming,8.822644312055891e-05,0.0001036959228350498,112,49,63
26817,warmongering,2.095639979110664e-07,5.348708166200577e-06,3,0,3
26818,warmth,6.496483935243052e-06,3.6233184351681345e-06,5,3,2
26819,warn,0.0004130506398827114,0.000333172757062365,439,214,225
26820,warned,0.0002160604818463093,0.00016926073261428268,220,109,111
26821,warning,0.00022863432172097337,0.00022619859373835345,265,118,147
26822,warplane,4.6313643538345614e-05,3.8131113055817005e-05,46,22,24
26823,warrant,7.984388320411623e-05,7.091351794543343e-05,83,40,43
26824,warranted,2.095639979110664e-07,5.348708166200577e-06,4,0,4
26825,warrantles,8.592123914353715e-06,5.348708166200577e-06,8,4,4
26826,warrior,2.5357243747239038e-05,1.2250267090330355e-05,21,14,7
26827,warship,7.355696326678427e-05,7.608968713853079e-05,84,37,47
26828,wartime,2.5357243747239038e-05,1.570104655239525e-05,21,12,9
26829,wartorn,1.48790438516857e-05,1.8979287041356905e-06,8,7,1
26830,wary,1.0687763893464371e-05,1.052487735929791e-05,11,5,6
26831,wash,1.9070323809907035e-05,2.087721574549256e-05,23,10,13
26832,washed,2.326160376812834e-05,7.074097897233022e-06,15,11,4
26833,washing,1.278340387257504e-05,1.052487735929791e-05,14,6,8
26834,washingtonpostcom,4.400843956132392e-06,1.8979287041356905e-06,3,2,1
26835,wasn,2.326160376812834e-05,1.570104655239525e-05,20,11,9
26836,waste,0.00010289592297433347,9.506897417988779e-05,120,58,62
26837,wasted,3.3739803663681634e-05,7.074097897233022e-06,22,16,6
26838,wasteful,2.3052039770217305e-06,5.348708166200577e-06,4,1,3
26839,wasteland,4.400843956132392e-06,1.8979287041356905e-06,3,2,1
26840,wastewater,6.496483935243052e-06,8.79948762826546e-06,8,3,5
26841,wasting,6.496483935243052e-06,1.052487735929791e-05,12,4,8
26842,watch,0.00011966104280721883,8.989280498679035e-05,116,61,55
26843,watchdog,7.146132328767358e-05,5.5385010366141504e-05,75,35,40
26844,watched,4.212236358012434e-05,4.330728224891437e-05,50,23,27
26845,watcher,2.3052039770217305e-06,3.6233184351681345e-06,3,1,2
26846,watching,5.4696203454788295e-05,8.644202552472544e-05,85,31,54
26847,watchlist,6.496483935243052e-06,1.8979287041356905e-06,5,4,1
26848,water,0.0005953713180653392,0.000628214401068913,724,321,403
26849,waterboarded,2.3052039770217305e-06,1.8979287041356905e-06,3,2,1
26850,waterboarding,1.0687763893464371e-05,1.2250267090330355e-05,13,6,7
26851,watereddown,2.3052039770217305e-06,3.6233184351681345e-06,3,1,2
26852,watering,6.496483935243052e-06,3.6233184351681345e-06,6,4,2
26853,watershed,4.400843956132392e-06,5.348708166200577e-06,5,2,3
26854,waterstressed,2.3052039770217305e-06,7.074097897233022e-06,5,1,4
26855,wave,0.00011966104280721883,0.00010714670229711469,132,61,71
26856,waving,8.592123914353715e-06,5.348708166200577e-06,8,4,4
26857,way,0.0008258917157675121,0.0009163544861513312,1023,437,586
26858,we,7.565260324589493e-05,6.056117955923882e-05,79,38,41
26859,weak,4.4218003559234974e-05,2.9504164400654783e-05,41,23,18
26860,weaken,1.6974683830796368e-05,1.570104655239525e-05,19,9,10
26861,weakened,2.3052039770217305e-06,7.074097897233022e-06,6,1,5
26862,weakening,1.278340387257504e-05,5.348708166200577e-06,9,6,3
26863,weaker,6.496483935243052e-06,5.348708166200577e-06,7,3,4
26864,weakest,2.3052039770217305e-06,3.6233184351681345e-06,3,1,2
26865,weaknes,1.0687763893464371e-05,1.742643628342769e-05,17,6,11
26866,wealth,0.00011127848289077625,9.506897417988779e-05,125,59,66
26867,wealthier,4.400843956132392e-06,8.79948762826546e-06,8,3,5
26868,wealthiest,2.326160376812834e-05,1.570104655239525e-05,21,11,10
26869,wealthy,5.050492349656699e-05,6.746273848336857e-05,73,26,47
26870,weapon,0.00043610267965292894,0.0003711313311450788,478,240,238
26871,weaponize,2.3052039770217305e-06,3.6233184351681345e-06,3,1,2
26872,weaponry,1.0687763893464371e-05,7.074097897233022e-06,9,5,4
26873,weaponsgrade,2.3052039770217305e-06,3.6233184351681345e-06,3,1,2
26874,wear,6.307876337123095e-05,5.1934230904076595e-05,64,32,32
26875,wearer,4.400843956132392e-06,1.7253897310324457e-07,3,3,0
26876,wearing,8.613080314144832e-05,9.506897417988779e-05,116,50,66
26877,weary,4.400843956132392e-06,1.7253897310324457e-07,3,3,0
26878,weather,6.517440335034157e-05,6.401195902130366e-05,72,32,40
26879,weave,2.3052039770217305e-06,3.6233184351681345e-06,3,1,2
26880,web,7.774824322500554e-05,7.091351794543343e-05,84,40,44
26881,webcam,4.400843956132392e-06,5.348708166200577e-06,6,2,4
26882,webinar,2.3052039770217305e-06,3.6233184351681345e-06,3,1,2
26883,webpage,2.095639979110664e-07,3.6233184351681345e-06,3,1,2
26884,website,0.00024120816159563723,0.00019341618884873702,256,124,132
26885,wed,1.9070323809907035e-05,2.9504164400654783e-05,30,10,20
26886,wedding,3.7931083621902995e-05,5.5385010366141504e-05,58,21,37
26887,wedge,2.3052039770217305e-06,7.074097897233022e-06,5,1,4
26888,wedlock,2.3052039770217305e-06,1.8979287041356905e-06,3,1,2
26889,weed,2.954852370546031e-05,2.4327995207557487e-05,31,14,17
26890,weedkiller,2.3052039770217305e-06,1.8979287041356905e-06,4,1,3
26891,week,0.000987255994159033,0.001009525531627083,1163,511,652
26892,weekday,6.496483935243052e-06,5.348708166200577e-06,7,3,4
26893,weekend,0.00011127848289077625,0.0001382037174556987,149,56,93
26894,weeklong,4.400843956132392e-06,1.8979287041356905e-06,3,2,1
26895,weekly,1.0687763893464371e-05,2.2602605476525032e-05,20,6,14
26896,weeping,2.095639979110664e-07,5.348708166200577e-06,3,0,3
26897,weigh,3.7931083621902995e-05,3.122955413168725e-05,38,18,20
26898,weighed,1.6974683830796368e-05,1.2250267090330355e-05,17,9,8
26899,weighing,1.0687763893464371e-05,1.9151826014460126e-05,17,6,11
26900,weight,3.7931083621902995e-05,3.2954943862719716e-05,38,19,19
26901,weird,3.3739803663681634e-05,2.2602605476525032e-05,31,17,14
26902,weirder,2.3052039770217305e-06,3.6233184351681345e-06,3,1,2
26903,welcome,6.936568330856297e-05,6.228656929027126e-05,82,40,42
26904,welcomed,1.48790438516857e-05,1.742643628342769e-05,17,7,10
26905,welcoming,6.496483935243052e-06,1.3975656821362803e-05,13,4,9
26906,welfare,5.050492349656699e-05,7.436429740749831e-05,70,27,43
26907,well,0.0003837116801751621,0.00044187231011740913,485,201,284
26908,wellbeing,2.116596378901769e-05,2.777877466962238e-05,28,11,17
26909,wellestablished,2.095639979110664e-07,5.348708166200577e-06,3,0,3
26910,wellfunded,2.3052039770217305e-06,3.6233184351681345e-06,3,1,2
26911,wellinformed,4.400843956132392e-06,3.6233184351681345e-06,4,2,2
26912,wellknown,1.278340387257504e-05,1.052487735929791e-05,13,7,6
26913,wellnes,2.095639979110664e-07,7.074097897233022e-06,5,1,4
26914,went,0.00020348664197164515,0.0002089446964280291,236,107,129
26915,wept,4.400843956132392e-06,3.6233184351681345e-06,4,2,2
26916,weren,4.400843956132392e-06,1.8979287041356905e-06,3,2,1
26917,west,7.355696326678427e-05,5.3659620635109e-05,70,37,33
26918,western,9.451336305789087e-05,7.608968713853079e-05,96,48,48
26919,westerner,2.3052039770217305e-06,3.6233184351681345e-06,4,1,3
26920,westward,2.095639979110664e-07,5.348708166200577e-06,3,0,3
26921,wet,1.0687763893464371e-05,8.79948762826546e-06,11,5,6
26922,wetland,8.592123914353715e-06,1.7253897310324457e-07,6,6,0
26923,weve,5.6791843433898893e-05,5.5385010366141504e-05,62,30,32
26924,whale,7.774824322500554e-05,5.1934230904076595e-05,79,40,39
26925,whaler,6.496483935243052e-06,7.074097897233022e-06,11,3,8
26926,whaling,3.3739803663681634e-05,4.50326719799468e-05,48,16,32
26927,what,0.00011127848289077625,0.0001019705331040174,118,54,64
26928,whatever,2.954852370546031e-05,5.1934230904076595e-05,49,17,32
26929,whatsoever,8.592123914353715e-06,3.6233184351681345e-06,6,4,2
26930,wheat,1.278340387257504e-05,1.742643628342769e-05,21,8,13
26931,wheel,1.278340387257504e-05,2.4327995207557487e-05,20,6,14
26932,wheelchair,1.0687763893464371e-05,1.742643628342769e-05,20,7,13
26933,whenever,4.400843956132392e-06,1.3975656821362803e-05,11,2,9
26934,wherea,6.496483935243052e-06,7.074097897233022e-06,8,4,4
26935,whereabout,1.0687763893464371e-05,7.074097897233022e-06,11,5,6
26936,wherever,1.48790438516857e-05,1.3975656821362803e-05,17,7,10
26937,whether,0.0003438945205720597,0.00034870126464165704,403,177,226
26938,whilst,6.496483935243052e-06,5.348708166200577e-06,6,3,3
26939,whim,2.095639979110664e-07,5.348708166200577e-06,3,0,3
26940,whining,2.095639979110664e-07,7.074097897233022e-06,4,0,4
26941,whip,6.496483935243052e-06,7.074097897233022e-06,8,3,5
26942,whipped,6.496483935243052e-06,7.074097897233022e-06,7,3,4
26943,whipping,1.0687763893464371e-05,1.8979287041356905e-06,6,5,1
26944,whirlwind,2.095639979110664e-07,5.348708166200577e-06,3,0,3
26945,whiskey,6.496483935243052e-06,5.348708166200577e-06,6,3,3
26946,whisky,4.400843956132392e-06,5.348708166200577e-06,5,2,3
26947,whisper,2.095639979110664e-07,5.348708166200577e-06,3,0,3
26948,whistle,1.48790438516857e-05,2.6053384938589907e-05,24,9,15
26949,whistleblower,9.24177230787802e-05,9.851975364195259e-05,110,46,64
26950,whistleblowing,1.278340387257504e-05,3.6233184351681345e-06,9,7,2
26951,white,0.00022234740178364096,0.0002382763218555804,281,126,155
26952,whitecollar,2.3052039770217305e-06,3.6233184351681345e-06,4,2,2
26953,whitewash,4.400843956132392e-06,1.3975656821362803e-05,10,2,8
26954,who,3.7931083621902995e-05,5.711040009717395e-05,56,21,35
26955,whoever,1.0687763893464371e-05,1.2250267090330355e-05,12,5,7
26956,whole,0.00012385232276544028,0.00011922443041434203,148,69,79
26957,wholesale,6.496483935243052e-06,1.7253897310324457e-07,4,4,0
26958,wholly,2.3052039770217305e-06,3.6233184351681345e-06,3,1,2
26959,whooping,2.3052039770217305e-06,3.6233184351681345e-06,4,2,2
26960,whopping,1.0687763893464371e-05,7.074097897233022e-06,9,5,4
26961,whore,4.400843956132392e-06,5.348708166200577e-06,5,2,3
26962,whose,0.00014900000251476814,0.00012094982014537423,153,77,76
26963,whove,1.48790438516857e-05,1.052487735929791e-05,13,7,6
26964,wide,3.7931083621902995e-05,2.777877466962238e-05,36,19,17
26965,widely,6.098312339212028e-05,6.746273848336857e-05,74,31,43
26966,widen,1.9070323809907035e-05,7.074097897233022e-06,14,10,4
26967,widened,4.400843956132392e-06,5.348708166200577e-06,5,2,3
26968,widening,4.400843956132392e-06,5.348708166200577e-06,7,2,5
26969,wider,1.6974683830796368e-05,2.087721574549256e-05,22,9,13
26970,wideranging,1.0687763893464371e-05,1.7253897310324457e-07,6,5,1
26971,widespread,5.888748341300963e-05,7.954046660059569e-05,83,33,50
26972,widow,1.6974683830796368e-05,1.3975656821362803e-05,18,9,9
26973,wield,4.400843956132392e-06,8.79948762826546e-06,9,3,6
26974,wielding,4.400843956132392e-06,3.6233184351681345e-06,4,2,2
26975,wife,0.0001762433222432067,0.00018306385046254245,213,91,122
26976,wifi,2.3052039770217305e-06,5.348708166200577e-06,6,1,5
26977,wig,2.095639979110664e-07,7.074097897233022e-06,4,0,4
26978,wikileak,1.278340387257504e-05,1.052487735929791e-05,13,7,6
26979,wild,9.03220830996695e-05,6.401195902130366e-05,83,45,38
26980,wildcat,2.3052039770217305e-06,3.6233184351681345e-06,3,1,2
26981,wildernes,4.400843956132392e-06,1.8979287041356905e-06,4,2,2
26982,wildfire,2.326160376812834e-05,2.4327995207557487e-05,28,12,16
26983,wildlife,5.260056347567764e-05,3.8131113055817005e-05,51,26,25
26984,wildly,8.592123914353715e-06,1.2250267090330355e-05,12,4,8
26985,will,6.496483935243052e-06,1.8979287041356905e-06,4,3,1
26986,willful,2.095639979110664e-07,7.074097897233022e-06,5,1,4
26987,willing,9.24177230787802e-05,9.506897417988779e-05,108,47,61
26988,willingnes,8.592123914353715e-06,1.742643628342769e-05,15,5,10
26989,win,0.0003732334802796091,0.00041771685388295495,471,198,273
26990,wind,9.451336305789087e-05,9.334358444885519e-05,116,48,68
26991,windfall,6.496483935243052e-06,1.052487735929791e-05,9,3,6
26992,windfarm,1.0687763893464371e-05,5.348708166200577e-06,8,5,3
26993,winding,4.400843956132392e-06,1.8979287041356905e-06,3,2,1
26994,window,5.050492349656699e-05,4.1581892517881935e-05,52,26,26
26995,windpipe,2.3052039770217305e-06,1.8979287041356905e-06,3,2,1
26996,windshield,6.496483935243052e-06,1.7253897310324457e-07,3,3,0
26997,wine,2.326160376812834e-05,2.4327995207557487e-05,30,14,16
26998,wing,3.583544364279237e-05,4.6758061710979285e-05,52,22,30
26999,winner,7.774824322500554e-05,8.816741525575797e-05,95,41,54
27000,winning,7.774824322500554e-05,8.299124606266055e-05,99,44,55
27001,winter,4.6313643538345614e-05,3.8131113055817005e-05,47,23,24
27002,winwin,4.400843956132392e-06,3.6233184351681345e-06,5,3,2
27003,wipe,3.7931083621902995e-05,2.2602605476525032e-05,35,20,15
27004,wiped,4.4218003559234974e-05,2.2602605476525032e-05,37,21,16
27005,wiping,1.48790438516857e-05,1.3975656821362803e-05,15,7,8
27006,wire,8.592123914353715e-06,2.087721574549256e-05,18,4,14
27007,wireles,6.496483935243052e-06,5.348708166200577e-06,6,3,3
27008,wiretap,1.0687763893464371e-05,7.074097897233022e-06,9,5,4
27009,wiretapped,2.095639979110664e-07,3.6233184351681345e-06,4,2,2
27010,wiretapping,1.278340387257504e-05,5.348708166200577e-06,9,6,3
27011,wisdom,2.5357243747239038e-05,2.777877466962238e-05,30,12,18
27012,wise,6.496483935243052e-06,1.3975656821362803e-05,11,3,8
27013,wisely,6.496483935243052e-06,3.6233184351681345e-06,6,4,2
27014,wiser,2.095639979110664e-07,5.348708166200577e-06,3,0,3
27015,wish,5.4696203454788295e-05,7.608968713853079e-05,85,33,52
27016,wished,4.400843956132392e-06,3.6233184351681345e-06,6,3,3
27017,wishful,2.3052039770217305e-06,5.348708166200577e-06,5,2,3
27018,wishing,4.400843956132392e-06,7.074097897233022e-06,6,2,4
27019,wit,2.3052039770217305e-06,5.348708166200577e-06,4,1,3
27020,witch,3.7931083621902995e-05,3.122955413168725e-05,41,20,21
27021,witchcraft,1.6974683830796368e-05,2.087721574549256e-05,23,9,14
27022,withdraw,7.355696326678427e-05,5.5385010366141504e-05,75,41,34
27023,withdrawal,3.3739803663681634e-05,3.122955413168725e-05,41,21,20
27024,withdrawing,1.6974683830796368e-05,1.570104655239525e-05,18,8,10
27025,withdrawn,1.9070323809907035e-05,1.3975656821362803e-05,18,9,9
27026,withdrew,6.496483935243052e-06,1.3975656821362803e-05,12,4,8
27027,withering,2.095639979110664e-07,5.348708166200577e-06,3,0,3
27028,withheld,8.592123914353715e-06,1.8979287041356905e-06,6,5,1
27029,withhold,6.496483935243052e-06,1.052487735929791e-05,12,5,7
27030,withholding,1.0687763893464371e-05,7.074097897233022e-06,9,5,4
27031,within,0.00024959072151208,0.00025898099862796983,299,138,161
27032,without,0.0006268059177519991,0.0005505718631724532,681,332,349
27033,withstand,8.592123914353715e-06,5.348708166200577e-06,7,4,3
27034,witnes,8.613080314144832e-05,7.608968713853079e-05,94,45,49
27035,witnessed,1.6974683830796368e-05,2.4327995207557487e-05,24,9,15
27036,witnessing,8.592123914353715e-06,1.3975656821362803e-05,14,5,9
27037,wizard,4.400843956132392e-06,3.6233184351681345e-06,4,2,2
27038,woe,1.278340387257504e-05,1.742643628342769e-05,17,6,11
27039,woefully,4.400843956132392e-06,1.7253897310324457e-07,3,3,0
27040,woke,1.9070323809907035e-05,1.570104655239525e-05,18,9,9
27041,wolf,1.6974683830796368e-05,3.8131113055817005e-05,33,10,23
27042,woman,0.0015677482683726866,0.0016323912245297953,1905,842,1063
27043,womb,2.095639979110664e-07,7.074097897233022e-06,4,0,4
27044,women,1.6974683830796368e-05,2.087721574549256e-05,21,9,12
27045,won,4.4218003559234974e-05,2.777877466962238e-05,40,22,18
27046,wonder,5.260056347567764e-05,7.781507686956326e-05,78,26,52
27047,wondered,1.0687763893464371e-05,3.2954943862719716e-05,26,6,20
27048,wonderful,8.592123914353715e-06,3.122955413168725e-05,22,4,18
27049,wondering,1.9070323809907035e-05,2.6053384938589907e-05,25,10,15
27050,wonk,6.496483935243052e-06,1.7253897310324457e-07,3,3,0
27051,wood,1.0687763893464371e-05,1.3975656821362803e-05,15,5,10
27052,wooden,1.278340387257504e-05,7.074097897233022e-06,11,6,5
27053,woodland,4.400843956132392e-06,3.6233184351681345e-06,4,2,2
27054,wooing,2.3052039770217305e-06,3.6233184351681345e-06,3,1,2
27055,woolly,2.095639979110664e-07,5.348708166200577e-06,4,0,4
27056,word,0.00023282560167919462,0.00026415716782106726,304,126,178
27057,worded,2.3052039770217305e-06,3.6233184351681345e-06,3,1,2
27058,wording,2.3052039770217305e-06,5.348708166200577e-06,4,1,3
27059,wore,6.496483935243052e-06,1.2250267090330355e-05,13,4,9
27060,work,0.000758831236435971,0.000805929543365255,933,405,528
27061,workday,2.095639979110664e-07,8.79948762826546e-06,5,0,5
27062,worked,0.00011127848289077625,8.4716635793693e-05,114,60,54
27063,worker,0.0005807018382115645,0.0005868050475241346,703,312,391
27064,workforce,3.583544364279237e-05,3.468033359375216e-05,42,18,24
27065,working,0.00035856400042583424,0.00033662353652443006,408,193,215
27066,workingclas,6.496483935243052e-06,1.052487735929791e-05,10,3,7
27067,worklife,2.095639979110664e-07,5.348708166200577e-06,3,0,3
27068,workout,2.3052039770217305e-06,5.348708166200577e-06,4,1,3
27069,workplace,4.212236358012434e-05,6.746273848336857e-05,63,21,42
27070,workrelated,2.3052039770217305e-06,3.6233184351681345e-06,4,1,3
27071,workshop,1.9070323809907035e-05,8.79948762826546e-06,15,9,6
27072,world,0.0017856948262001953,0.0017324638289296776,2069,946,1123
27073,worldclas,2.3052039770217305e-06,8.79948762826546e-06,7,1,6
27074,worldfamou,4.400843956132392e-06,3.6233184351681345e-06,4,2,2
27075,worldfirst,2.3052039770217305e-06,3.6233184351681345e-06,3,1,2
27076,worldnew,2.095639979110664e-07,5.348708166200577e-06,3,0,3
27077,worldview,1.48790438516857e-05,3.6233184351681345e-06,9,7,2
27078,worldwide,0.00012804360272366158,0.00010542131256608228,140,70,70
27079,worm,2.116596378901769e-05,1.570104655239525e-05,20,10,10
27080,worn,1.0687763893464371e-05,1.052487735929791e-05,11,5,6
27081,worried,5.4696203454788295e-05,8.126585633162811e-05,77,28,49
27082,worrisome,2.3052039770217305e-06,5.348708166200577e-06,4,1,3
27083,worry,5.6791843433898893e-05,0.00010887209202814718,107,37,70
27084,worrying,1.9070323809907035e-05,1.3975656821362803e-05,18,9,9
27085,worse,0.00016157384238943198,0.00014165449691776373,175,84,91
27086,worsen,8.592123914353715e-06,1.9151826014460126e-05,17,5,12
27087,worsened,8.592123914353715e-06,3.6233184351681345e-06,7,4,3
27088,worsening,6.496483935243052e-06,1.570104655239525e-05,14,3,11
27089,worship,4.400843956132392e-06,8.79948762826546e-06,8,2,6
27090,worshiper,4.400843956132392e-06,3.6233184351681345e-06,4,2,2
27091,worshipper,2.3052039770217305e-06,1.8979287041356905e-06,3,1,2
27092,worst,0.0002097735619089774,0.00018996540938667205,233,110,123
27093,worstever,4.400843956132392e-06,3.6233184351681345e-06,4,2,2
27094,worth,0.00020348664197164515,0.00018133846073150993,220,103,117
27095,worthles,6.496483935243052e-06,7.074097897233022e-06,9,3,6
27096,worthy,1.9070323809907035e-05,1.9151826014460126e-05,20,9,11
27097,would,0.001745877666597093,0.0017376399981227752,2039,906,1133
27098,wouldbe,2.954852370546031e-05,1.3975656821362803e-05,26,16,10
27099,wouldn,8.592123914353715e-06,1.9151826014460126e-05,16,4,12
27100,wouldve,8.592123914353715e-06,5.348708166200577e-06,8,5,3
27101,wound,3.7931083621902995e-05,4.6758061710979285e-05,52,19,33
27102,wounded,9.870464301611217e-05,9.506897417988779e-05,116,52,64
27103,wounding,2.116596378901769e-05,8.79948762826546e-06,17,11,6
27104,wow,4.400843956132392e-06,7.074097897233022e-06,6,2,4
27105,wpic,4.400843956132392e-06,1.8979287041356905e-06,3,2,1
27106,wracking,4.400843956132392e-06,1.8979287041356905e-06,3,2,1
27107,wrangling,2.3052039770217305e-06,1.8979287041356905e-06,3,1,2
27108,wrap,4.400843956132392e-06,1.8979287041356905e-06,4,2,2
27109,wrapped,2.3052039770217305e-06,1.052487735929791e-05,9,1,8
27110,wrapping,2.3052039770217305e-06,8.79948762826546e-06,6,1,5
27111,wrapup,0.00016157384238943198,0.00015373222503499084,190,89,101
27112,wrath,1.0687763893464371e-05,5.348708166200577e-06,8,5,3
27113,wreak,4.400843956132392e-06,5.348708166200577e-06,5,2,3
27114,wreck,6.496483935243052e-06,2.6053384938589907e-05,19,3,16
27115,wreckage,1.278340387257504e-05,1.742643628342769e-05,22,8,14
27116,wrecked,4.400843956132392e-06,1.052487735929791e-05,10,3,7
27117,wrecking,1.0687763893464371e-05,8.79948762826546e-06,12,5,7
27118,wrest,4.400843956132392e-06,3.6233184351681345e-06,4,2,2
27119,wrestler,2.095639979110664e-07,7.074097897233022e-06,5,0,5
27120,wrestling,2.3052039770217305e-06,3.6233184351681345e-06,3,1,2
27121,wretched,2.3052039770217305e-06,3.6233184351681345e-06,5,1,4
27122,wrist,2.3052039770217305e-06,8.79948762826546e-06,6,1,5
27123,write,9.451336305789087e-05,0.0001036959228350498,118,51,67
27124,writer,4.4218003559234974e-05,5.020884117304414e-05,57,22,35
27125,writing,5.6791843433898893e-05,5.020884117304414e-05,66,32,34
27126,written,6.936568330856297e-05,6.056117955923882e-05,74,35,39
27127,wrong,0.00023072996170008382,0.0002106700861590614,260,123,137
27128,wrongdoing,2.326160376812834e-05,1.3975656821362803e-05,21,11,10
27129,wrongful,6.496483935243052e-06,7.074097897233022e-06,8,3,5
27130,wrongfully,1.0687763893464371e-05,5.348708166200577e-06,9,6,3
27131,wrongly,1.6974683830796368e-05,1.052487735929791e-05,16,8,8
27132,wrote,0.00016786076232676425,0.0001554576147660233,193,86,107
27133,wrought,6.496483935243052e-06,3.6233184351681345e-06,5,3,2
27134,wtf,4.400843956132392e-06,3.6233184351681345e-06,4,2,2
27135,xenophobia,1.9070323809907035e-05,7.074097897233022e-06,16,9,7
27136,xenophobic,1.0687763893464371e-05,3.6233184351681345e-06,9,6,3
27137,xpost,2.116596378901769e-05,4.1581892517881935e-05,41,13,28
27138,xray,2.095639979110664e-07,5.348708166200577e-06,3,0,3
27139,ya,4.400843956132392e-06,3.6233184351681345e-06,5,2,3
27140,yacht,1.48790438516857e-05,8.79948762826546e-06,12,7,5
27141,yall,4.400843956132392e-06,5.348708166200577e-06,5,2,3
27142,yard,4.400843956132392e-06,8.79948762826546e-06,8,2,6
27143,yawning,2.095639979110664e-07,5.348708166200577e-06,3,0,3
27144,ye,6.72700433294523e-05,5.711040009717395e-05,69,33,36
27145,yeah,1.278340387257504e-05,8.79948762826546e-06,11,6,5
27146,year,0.003139478252705683,0.0031748896440728022,3751,1672,2079
27147,yearend,4.400843956132392e-06,1.8979287041356905e-06,3,2,1
27148,yearlong,8.592123914353715e-06,3.6233184351681345e-06,7,5,2
27149,yearly,6.496483935243052e-06,8.79948762826546e-06,9,3,6
27150,yearold,1.6974683830796368e-05,2.777877466962238e-05,28,10,18
27151,yearround,2.095639979110664e-07,5.348708166200577e-06,3,0,3
27152,years,2.3052039770217305e-06,3.6233184351681345e-06,3,1,2
27153,yell,4.400843956132392e-06,5.348708166200577e-06,5,2,3
27154,yelled,1.278340387257504e-05,7.074097897233022e-06,11,6,5
27155,yelling,2.095639979110664e-07,5.348708166200577e-06,3,0,3
27156,yellow,4.400843956132392e-06,1.052487735929791e-05,8,2,6
27157,yen,1.278340387257504e-05,1.2250267090330355e-05,15,8,7
27158,yesterday,5.4696203454788295e-05,8.299124606266055e-05,84,30,54
27159,yet,0.00031036428090628937,0.00025553021916590484,322,156,166
27160,yield,1.6974683830796368e-05,2.777877466962238e-05,25,9,16
27161,yielded,6.496483935243052e-06,8.79948762826546e-06,9,3,6
27162,yoga,8.592123914353715e-06,2.087721574549256e-05,16,4,12
27163,yogurt,2.095639979110664e-07,7.074097897233022e-06,4,0,4
27164,you,8.613080314144832e-05,7.091351794543343e-05,89,43,46
27165,young,0.0004151462798618222,0.0003711313311450788,456,214,242
27166,younger,4.002672360101368e-05,2.9504164400654783e-05,38,20,18
27167,youngest,2.116596378901769e-05,2.2602605476525032e-05,25,10,15
27168,youngster,2.095639979110664e-07,5.348708166200577e-06,3,0,3
27169,youth,9.870464301611217e-05,0.00010887209202814718,125,55,70
27170,youtube,4.400843956132392e-06,7.074097897233022e-06,7,3,4
27171,yr,7.355696326678427e-05,6.056117955923882e-05,78,36,42
27172,yuan,1.9070323809907035e-05,8.79948762826546e-06,16,10,6
27173,zebra,2.095639979110664e-07,7.074097897233022e-06,5,0,5
27174,zero,2.7452883726349685e-05,3.8131113055817005e-05,38,13,25
27175,zeroed,4.400843956132392e-06,5.348708166200577e-06,5,2,3
27176,zillion,4.400843956132392e-06,1.8979287041356905e-06,3,2,1
27177,zinc,2.095639979110664e-07,1.8979287041356905e-06,3,1,2
27178,zip,2.3052039770217305e-06,3.6233184351681345e-06,4,1,3
27179,zombie,1.48790438516857e-05,1.2250267090330355e-05,18,9,9
27180,zone,0.0001259479627445509,0.0001295767688005365,147,66,81
27181,zoo,4.840928351745632e-05,1.742643628342769e-05,39,24,15
